FILEID,FILETYPE,STATE,CHARITER,SEQUENCE,LOGRECNO,SUMMARY_LEVEL,STATE_FIPS,COUNTY,GEO_ID,GEO_NAME,Total:,Married-couple family:,With own children under 18 years:,Under 6 years only,Under 6 years and 6 to 17 years,6 to 17 years only,No own children under 18 years,Other family:,"Male householder, no wife present:",With own children under 18 years:,Under 6 years only,Under 6 years and 6 to 17 years,6 to 17 years only,No own children under 18 years,"Female householder, no husband present:",With own children under 18 years:,Under 6 years only,Under 6 years and 6 to 17 years,6 to 17 years only,No own children under 18 years
ACSSF,2010e5,wv,000,0034,0000001,040,54,   ,04000US54,West Virginia,489983,380637,131917,27668,25153,79096,248720,109346,29955,14468,4137,1395,8936,15487,79391,41883,9900,6557,25426,37508
ACSSF,2010e5,wv,000,0034,0000002,040,54,   ,04001US54,West Virginia -- Urban,211361,154849,53617,12505,10797,30315,101232,56512,13782,7471,2172,698,4601,6311,42730,23325,5977,3639,13709,19405
ACSSF,2010e5,wv,000,0034,0000003,040,54,   ,04043US54,West Virginia -- Rural,278622,225788,78300,15163,14356,48781,147488,52834,16173,6997,1965,697,4335,9176,36661,18558,3923,2918,11717,18103
ACSSF,2010e5,wv,000,0034,0000004,040,54,   ,040A0US54,West Virginia -- In metropolitan or micropolitan statistical area,366234,282559,100009,21441,19165,59403,182550,83675,22317,10984,3067,1129,6788,11333,61358,33169,7991,4985,20193,28189
ACSSF,2010e5,wv,000,0034,0000005,040,54,   ,040C0US54,West Virginia -- In metropolitan statistical area,268689,208594,74739,16371,14515,43853,133855,60095,16221,8213,2370,871,4972,8008,43874,24186,5837,3841,14508,19688
ACSSF,2010e5,wv,000,0034,0000006,040,54,   ,040C1US54,West Virginia -- In metropolitan statistical area -- in principal city,55606,38773,13126,3134,2391,7601,25647,16833,3784,2131,625,359,1147,1653,13049,7168,2028,1254,3886,5881
ACSSF,2010e5,wv,000,0034,0000007,040,54,   ,040C2US54,West Virginia -- In metropolitan statistical area -- not in principal city,213083,169821,61613,13237,12124,36252,108208,43262,12437,6082,1745,512,3825,6355,30825,17018,3809,2587,10622,13807
ACSSF,2010e5,wv,000,0034,0000008,040,54,   ,040E0US54,West Virginia -- In micropolitan statistical area,97545,73965,25270,5070,4650,15550,48695,23580,6096,2771,697,258,1816,3325,17484,8983,2154,1144,5685,8501
ACSSF,2010e5,wv,000,0034,0000009,040,54,   ,040E1US54,West Virginia -- In micropolitan statistical area -- in principal city,18900,13064,4383,937,896,2550,8681,5836,1290,697,152,78,467,593,4546,2369,663,329,1377,2177
ACSSF,2010e5,wv,000,0034,0000010,040,54,   ,040E2US54,West Virginia -- In micropolitan statistical area -- not in principal city,78645,60901,20887,4133,3754,13000,40014,17744,4806,2074,545,180,1349,2732,12938,6614,1491,815,4308,6324
ACSSF,2010e5,wv,000,0034,0000011,040,54,   ,040G0US54,West Virginia -- Not in metropolitan or micropolitan statistical area,123749,98078,31908,6227,5988,19693,66170,25671,7638,3484,1070,266,2148,4154,18033,8714,1909,1572,5233,9319
ACSSF,2010e5,wv,000,0034,0000012,040,54,   ,040H0US54,West Virginia -- Not in metropolitan statistical area,221294,172043,57178,11297,10638,35243,114865,49251,13734,6255,1767,524,3964,7479,35517,17697,4063,2716,10918,17820
ACSSF,2010e5,wv,000,0034,0000013,050,54,001,05000US54001,"Barbour County, West Virginia",4245,3304,904,174,163,567,2400,941,341,128,21,35,72,213,600,342,34,106,202,258
ACSSF,2010e5,wv,000,0034,0000014,050,54,003,05000US54003,"Berkeley County, West Virginia",26475,20223,7980,1978,1632,4370,12243,6252,2018,1239,338,273,628,779,4234,2363,823,303,1237,1871
ACSSF,2010e5,wv,000,0034,0000015,050,54,005,05000US54005,"Boone County, West Virginia",7180,5697,2137,367,433,1337,3560,1483,491,156,44,0,112,335,992,416,72,58,286,576
ACSSF,2010e5,wv,000,0034,0000016,050,54,007,05000US54007,"Braxton County, West Virginia",3904,3198,881,120,172,589,2317,706,213,88,0,4,84,125,493,297,81,46,170,196
ACSSF,2010e5,wv,000,0034,0000017,050,54,009,05000US54009,"Brooke County, West Virginia",6578,4979,1442,182,426,834,3537,1599,497,241,56,20,165,256,1102,724,166,138,420,378
ACSSF,2010e5,wv,000,0034,0000018,050,54,011,05000US54011,"Cabell County, West Virginia",24695,18320,6152,1507,1177,3468,12168,6375,1395,719,192,10,517,676,4980,2856,612,498,1746,2124
ACSSF,2010e5,wv,000,0034,0000019,050,54,013,05000US54013,"Calhoun County, West Virginia",2063,1537,464,8,106,350,1073,526,238,120,63,44,13,118,288,97,23,0,74,191
ACSSF,2010e5,wv,000,0034,0000020,050,54,015,05000US54015,"Clay County, West Virginia",2428,1930,771,99,154,518,1159,498,174,52,14,0,38,122,324,148,10,43,95,176
ACSSF,2010e5,wv,000,0034,0000021,050,54,017,05000US54017,"Doddridge County, West Virginia",1999,1482,441,34,69,338,1041,517,178,126,94,3,29,52,339,158,0,37,121,181
ACSSF,2010e5,wv,000,0034,0000022,050,54,019,05000US54019,"Fayette County, West Virginia",12344,9215,2911,521,574,1816,6304,3129,911,407,189,20,198,504,2218,977,126,159,692,1241
ACSSF,2010e5,wv,000,0034,0000023,050,54,021,05000US54021,"Gilmer County, West Virginia",1549,1155,395,70,50,275,760,394,88,19,0,5,14,69,306,141,21,28,92,165
ACSSF,2010e5,wv,000,0034,0000024,050,54,023,05000US54023,"Grant County, West Virginia",3451,2789,908,283,172,453,1881,662,184,108,50,0,58,76,478,321,111,14,196,157
ACSSF,2010e5,wv,000,0034,0000025,050,54,025,05000US54025,"Greenbrier County, West Virginia",9977,7505,2479,658,518,1303,5026,2472,717,310,93,24,193,407,1755,905,194,124,587,850
ACSSF,2010e5,wv,000,0034,0000026,050,54,027,05000US54027,"Hampshire County, West Virginia",5804,4350,1441,218,310,913,2909,1454,379,191,16,0,175,188,1075,630,57,94,479,445
ACSSF,2010e5,wv,000,0034,0000027,050,54,029,05000US54029,"Hancock County, West Virginia",8882,6766,2246,524,498,1224,4520,2116,640,354,126,16,212,286,1476,730,75,180,475,746
ACSSF,2010e5,wv,000,0034,0000028,050,54,031,05000US54031,"Hardy County, West Virginia",3016,2437,495,68,115,312,1942,579,148,59,17,0,42,89,431,262,55,79,128,169
ACSSF,2010e5,wv,000,0034,0000029,050,54,033,05000US54033,"Harrison County, West Virginia",18968,14266,5062,963,930,3169,9204,4702,1006,453,68,20,365,553,3696,1911,482,213,1216,1785
ACSSF,2010e5,wv,000,0034,0000030,050,54,035,05000US54035,"Jackson County, West Virginia",8414,6722,2446,542,535,1369,4276,1692,545,393,119,36,238,152,1147,613,110,50,453,534
ACSSF,2010e5,wv,000,0034,0000031,050,54,037,05000US54037,"Jefferson County, West Virginia",13590,11147,4733,1175,1033,2525,6414,2443,850,354,147,17,190,496,1593,840,182,137,521,753
ACSSF,2010e5,wv,000,0034,0000032,050,54,039,05000US54039,"Kanawha County, West Virginia",51064,38518,12743,2751,2413,7579,25775,12546,2944,1488,359,123,1006,1456,9602,5244,1366,827,3051,4358
ACSSF,2010e5,wv,000,0034,0000033,050,54,041,05000US54041,"Lewis County, West Virginia",4243,3446,1044,118,237,689,2402,797,225,106,49,10,47,119,572,409,103,60,246,163
ACSSF,2010e5,wv,000,0034,0000034,050,54,043,05000US54043,"Lincoln County, West Virginia",6552,4941,2022,571,233,1218,2919,1611,464,201,49,38,114,263,1147,628,165,138,325,519
ACSSF,2010e5,wv,000,0034,0000035,050,54,045,05000US54045,"Logan County, West Virginia",10514,7853,2800,500,612,1688,5053,2661,618,307,127,0,180,311,2043,692,176,105,411,1351
ACSSF,2010e5,wv,000,0034,0000036,050,54,047,05000US54047,"McDowell County, West Virginia",5490,4142,1201,171,226,804,2941,1348,334,101,2,20,79,233,1014,521,30,90,401,493
ACSSF,2010e5,wv,000,0034,0000037,050,54,049,05000US54049,"Marion County, West Virginia",15027,11349,4111,919,657,2535,7238,3678,990,473,44,29,400,517,2688,1453,321,155,977,1235
ACSSF,2010e5,wv,000,0034,0000038,050,54,051,05000US54051,"Marshall County, West Virginia",9385,7314,2474,441,497,1536,4840,2071,614,307,134,0,173,307,1457,764,223,71,470,693
ACSSF,2010e5,wv,000,0034,0000039,050,54,053,05000US54053,"Mason County, West Virginia",7594,5757,1950,291,481,1178,3807,1837,442,255,36,9,210,187,1395,814,297,71,446,581
ACSSF,2010e5,wv,000,0034,0000040,050,54,055,05000US54055,"Mercer County, West Virginia",16011,12278,3779,815,667,2297,8499,3733,1014,478,163,74,241,536,2719,1449,448,127,874,1270
ACSSF,2010e5,wv,000,0034,0000041,050,54,057,05000US54057,"Mineral County, West Virginia",7710,6020,1847,396,375,1076,4173,1690,446,296,104,74,118,150,1244,861,116,83,662,383
ACSSF,2010e5,wv,000,0034,0000042,050,54,059,05000US54059,"Mingo County, West Virginia",7487,5598,1917,467,237,1213,3681,1889,574,196,61,34,101,378,1315,560,127,101,332,755
ACSSF,2010e5,wv,000,0034,0000043,050,54,061,05000US54061,"Monongalia County, West Virginia",18785,15061,5783,1566,1168,3049,9278,3724,1190,518,194,72,252,672,2534,1356,375,153,828,1178
ACSSF,2010e5,wv,000,0034,0000044,050,54,063,05000US54063,"Monroe County, West Virginia",3922,3297,965,299,163,503,2332,625,198,71,0,0,71,127,427,151,61,11,79,276
ACSSF,2010e5,wv,000,0034,0000045,050,54,065,05000US54065,"Morgan County, West Virginia",4082,3219,965,126,230,609,2254,863,270,150,59,10,81,120,593,335,6,34,295,258
ACSSF,2010e5,wv,000,0034,0000046,050,54,067,05000US54067,"Nicholas County, West Virginia",7671,6363,2153,392,325,1436,4210,1308,535,300,76,0,224,235,773,237,37,51,149,536
ACSSF,2010e5,wv,000,0034,0000047,050,54,069,05000US54069,"Ohio County, West Virginia",11486,8888,3045,488,568,1989,5843,2598,450,217,96,0,121,233,2148,1146,299,252,595,1002
ACSSF,2010e5,wv,000,0034,0000048,050,54,071,05000US54071,"Pendleton County, West Virginia",2211,1841,528,70,155,303,1313,370,99,48,21,0,27,51,271,137,40,34,63,134
ACSSF,2010e5,wv,000,0034,0000049,050,54,073,05000US54073,"Pleasants County, West Virginia",1674,1394,488,71,52,365,906,280,81,45,0,7,38,36,199,109,19,7,83,90
ACSSF,2010e5,wv,000,0034,0000050,050,54,075,05000US54075,"Pocahontas County, West Virginia",2703,2274,757,131,121,505,1517,429,159,73,17,0,56,86,270,193,67,18,108,77
ACSSF,2010e5,wv,000,0034,0000051,050,54,077,05000US54077,"Preston County, West Virginia",9003,7359,2605,691,336,1578,4754,1644,434,214,89,20,105,220,1210,640,157,146,337,570
ACSSF,2010e5,wv,000,0034,0000052,050,54,079,05000US54079,"Putnam County, West Virginia",15929,13121,5418,1092,1000,3326,7703,2808,783,350,20,37,293,433,2025,1178,248,298,632,847
ACSSF,2010e5,wv,000,0034,0000053,050,54,081,05000US54081,"Raleigh County, West Virginia",21014,16081,5693,1226,1011,3456,10388,4933,1305,530,103,88,339,775,3628,1746,437,294,1015,1882
ACSSF,2010e5,wv,000,0034,0000054,050,54,083,05000US54083,"Randolph County, West Virginia",7691,6295,2034,278,390,1366,4261,1396,393,171,78,5,88,222,1003,575,84,164,327,428
ACSSF,2010e5,wv,000,0034,0000055,050,54,085,05000US54085,"Ritchie County, West Virginia",2924,2254,693,123,183,387,1561,670,230,93,48,2,43,137,440,243,39,27,177,197
ACSSF,2010e5,wv,000,0034,0000056,050,54,087,05000US54087,"Roane County, West Virginia",4008,3273,1056,256,150,650,2217,735,139,33,0,0,33,106,596,222,62,116,44,374
ACSSF,2010e5,wv,000,0034,0000057,050,54,089,05000US54089,"Summers County, West Virginia",3196,2443,716,162,122,432,1727,753,266,116,19,0,97,150,487,183,0,14,169,304
ACSSF,2010e5,wv,000,0034,0000058,050,54,091,05000US54091,"Taylor County, West Virginia",4588,3537,1323,301,261,761,2214,1051,250,49,0,15,34,201,801,475,43,88,344,326
ACSSF,2010e5,wv,000,0034,0000059,050,54,093,05000US54093,"Tucker County, West Virginia",2072,1673,550,99,71,380,1123,399,134,58,22,0,36,76,265,90,50,27,13,175
ACSSF,2010e5,wv,000,0034,0000060,050,54,095,05000US54095,"Tyler County, West Virginia",2585,2074,664,128,121,415,1410,511,178,96,55,3,38,82,333,144,12,6,126,189
ACSSF,2010e5,wv,000,0034,0000061,050,54,097,05000US54097,"Upshur County, West Virginia",6196,5107,1856,368,353,1135,3251,1089,349,130,44,31,55,219,740,349,36,177,136,391
ACSSF,2010e5,wv,000,0034,0000062,050,54,099,05000US54099,"Wayne County, West Virginia",11756,9259,3340,778,661,1901,5919,2497,637,302,66,47,189,335,1860,921,199,91,631,939
ACSSF,2010e5,wv,000,0034,0000063,050,54,101,05000US54101,"Webster County, West Virginia",2927,2365,884,149,178,557,1481,562,216,123,57,0,66,93,346,182,119,10,53,164
ACSSF,2010e5,wv,000,0034,0000064,050,54,103,05000US54103,"Wetzel County, West Virginia",4725,3845,1275,247,225,803,2570,880,198,104,31,13,60,94,682,349,80,74,195,333
ACSSF,2010e5,wv,000,0034,0000065,050,54,105,05000US54105,"Wirt County, West Virginia",1697,1447,441,112,102,227,1006,250,64,31,14,0,17,33,186,129,17,12,100,57
ACSSF,2010e5,wv,000,0034,0000066,050,54,107,05000US54107,"Wood County, West Virginia",23934,18641,6666,1238,1217,4211,11975,5293,1400,788,253,107,428,612,3893,2168,650,278,1240,1725
ACSSF,2010e5,wv,000,0034,0000067,050,54,109,05000US54109,"Wyoming County, West Virginia",6565,5288,1843,346,288,1209,3445,1277,319,133,0,0,133,186,958,499,157,40,302,459
ACSSF,2010e5,wv,000,0034,0000068,060,54,001,06000US5400192328,"North district, Barbour County, West Virginia",1704,1323,309,56,72,181,1014,381,138,55,9,32,14,83,243,153,31,51,71,90
ACSSF,2010e5,wv,000,0034,0000069,060,54,001,06000US5400192892,"South district, Barbour County, West Virginia",1523,1184,405,57,73,275,779,339,117,37,12,3,22,80,222,86,3,5,78,136
ACSSF,2010e5,wv,000,0034,0000070,060,54,001,06000US5400193588,"West district, Barbour County, West Virginia",1018,797,190,61,18,111,607,221,86,36,0,0,36,50,135,103,0,50,53,32
ACSSF,2010e5,wv,000,0034,0000071,060,54,003,06000US5400390006,"Adam Stephens district, Berkeley County, West Virginia",3516,2270,707,204,183,320,1563,1246,386,296,73,109,114,90,860,509,235,58,216,351
ACSSF,2010e5,wv,000,0034,0000072,060,54,003,06000US5400392322,"Norborne district, Berkeley County, West Virginia",2758,2182,972,190,163,619,1210,576,200,135,5,43,87,65,376,302,120,16,166,74
ACSSF,2010e5,wv,000,0034,0000073,060,54,003,06000US5400392526,"Potomac district, Berkeley County, West Virginia",4218,3457,1327,305,280,742,2130,761,219,194,71,41,82,25,542,241,86,65,90,301
ACSSF,2010e5,wv,000,0034,0000074,060,54,003,06000US5400392754,"Shenandoah district, Berkeley County, West Virginia",5068,3774,1614,394,248,972,2160,1294,516,290,66,42,182,226,778,388,75,5,308,390
ACSSF,2010e5,wv,000,0034,0000075,060,54,003,06000US5400393171,"Tuscarora district, Berkeley County, West Virginia",5219,4033,1763,577,370,816,2270,1186,234,74,24,0,50,160,952,635,206,135,294,317
ACSSF,2010e5,wv,000,0034,0000076,060,54,003,06000US5400393388,"Valley district, Berkeley County, West Virginia",5696,4507,1597,308,388,901,2910,1189,463,250,99,38,113,213,726,288,101,24,163,438
ACSSF,2010e5,wv,000,0034,0000077,060,54,005,06000US5400590762,"District 1, Boone County, West Virginia",2534,1910,850,115,162,573,1060,624,201,27,0,0,27,174,423,161,33,49,79,262
ACSSF,2010e5,wv,000,0034,0000078,060,54,005,06000US5400590796,"District 2, Boone County, West Virginia",2018,1634,614,107,150,357,1020,384,173,105,37,0,68,68,211,82,32,0,50,129
ACSSF,2010e5,wv,000,0034,0000079,060,54,005,06000US5400590832,"District 3, Boone County, West Virginia",2628,2153,673,145,121,407,1480,475,117,24,7,0,17,93,358,173,7,9,157,185
ACSSF,2010e5,wv,000,0034,0000080,060,54,007,06000US5400790968,"Eastern district, Braxton County, West Virginia",759,619,180,20,61,99,439,140,29,9,0,4,5,20,111,69,20,18,31,42
ACSSF,2010e5,wv,000,0034,0000081,060,54,007,06000US5400792346,"Northern district, Braxton County, West Virginia",931,775,214,52,22,140,561,156,39,8,0,0,8,31,117,33,11,4,18,84
ACSSF,2010e5,wv,000,0034,0000082,060,54,007,06000US5400792922,"Southern district, Braxton County, West Virginia",1162,901,307,26,76,205,594,261,106,60,0,0,60,46,155,101,22,21,58,54
ACSSF,2010e5,wv,000,0034,0000083,060,54,007,06000US5400793597,"Western district, Braxton County, West Virginia",1052,903,180,22,13,145,723,149,39,11,0,0,11,28,110,94,28,3,63,16
ACSSF,2010e5,wv,000,0034,0000084,060,54,009,06000US5400991104,"Follansbee district, Brooke County, West Virginia",2547,2011,652,138,141,373,1359,536,129,55,29,0,26,74,407,209,97,9,103,198
ACSSF,2010e5,wv,000,0034,0000085,060,54,009,06000US5400993552,"Weirton district, Brooke County, West Virginia",2083,1443,369,11,178,180,1074,640,203,62,0,0,62,141,437,326,45,126,155,111
ACSSF,2010e5,wv,000,0034,0000086,060,54,009,06000US5400993564,"Wellsburg district, Brooke County, West Virginia",1948,1525,421,33,107,281,1104,423,165,124,27,20,77,41,258,189,24,3,162,69
ACSSF,2010e5,wv,000,0034,0000087,060,54,011,06000US5401190764,"District 1, Cabell County, West Virginia",4890,3525,1173,280,158,735,2352,1365,281,175,103,0,72,106,1084,602,95,113,394,482
ACSSF,2010e5,wv,000,0034,0000088,060,54,011,06000US5401190798,"District 2, Cabell County, West Virginia",3136,1862,687,192,155,340,1175,1274,316,168,11,0,157,148,958,499,115,52,332,459
ACSSF,2010e5,wv,000,0034,0000089,060,54,011,06000US5401190834,"District 3, Cabell County, West Virginia",4315,2840,881,324,177,380,1959,1475,340,193,45,0,148,147,1135,675,162,174,339,460
ACSSF,2010e5,wv,000,0034,0000090,060,54,011,06000US5401190870,"District 4, Cabell County, West Virginia",6759,5588,1848,354,386,1108,3740,1171,190,90,0,10,80,100,981,630,158,149,323,351
ACSSF,2010e5,wv,000,0034,0000091,060,54,011,06000US5401190882,"District 5, Cabell County, West Virginia",5595,4505,1563,357,301,905,2942,1090,268,93,33,0,60,175,822,450,82,10,358,372
ACSSF,2010e5,wv,000,0034,0000092,060,54,013,06000US5401390766,"District 1, Calhoun County, West Virginia",324,268,9,0,0,9,259,56,27,0,0,0,0,27,29,19,0,0,19,10
ACSSF,2010e5,wv,000,0034,0000093,060,54,013,06000US5401390800,"District 2, Calhoun County, West Virginia",384,261,70,0,18,52,191,123,76,63,24,26,13,13,47,13,0,0,13,34
ACSSF,2010e5,wv,000,0034,0000094,060,54,013,06000US5401390836,"District 3, Calhoun County, West Virginia",363,275,93,8,39,46,182,88,43,12,12,0,0,31,45,25,3,0,22,20
ACSSF,2010e5,wv,000,0034,0000095,060,54,013,06000US5401390873,"District 4, Calhoun County, West Virginia",499,326,105,0,0,105,221,173,54,45,27,18,0,9,119,20,0,0,20,99
ACSSF,2010e5,wv,000,0034,0000096,060,54,013,06000US5401390885,"District 5, Calhoun County, West Virginia",493,407,187,0,49,138,220,86,38,0,0,0,0,38,48,20,20,0,0,28
ACSSF,2010e5,wv,000,0034,0000097,060,54,015,06000US5401590891,"District A, Clay County, West Virginia",765,529,188,14,75,99,341,236,80,18,0,0,18,62,156,78,10,0,68,78
ACSSF,2010e5,wv,000,0034,0000098,060,54,015,06000US5401590893,"District B, Clay County, West Virginia",893,708,326,85,37,204,382,185,70,34,14,0,20,36,115,42,0,35,7,73
ACSSF,2010e5,wv,000,0034,0000099,060,54,015,06000US5401590895,"District C, Clay County, West Virginia",770,693,257,0,42,215,436,77,24,0,0,0,0,24,53,28,0,8,20,25
ACSSF,2010e5,wv,000,0034,0000100,060,54,017,06000US5401790138,"Beech district, Doddridge County, West Virginia",690,526,173,0,29,144,353,164,76,57,36,0,21,19,88,37,0,37,0,51
ACSSF,2010e5,wv,000,0034,0000101,060,54,017,06000US5401792094,"Maple district, Doddridge County, West Virginia",339,236,73,4,17,52,163,103,7,3,0,3,0,4,96,23,0,0,23,73
ACSSF,2010e5,wv,000,0034,0000102,060,54,017,06000US5401792374,"Oak district, Doddridge County, West Virginia",459,404,73,0,21,52,331,55,23,23,15,0,8,0,32,22,0,0,22,10
ACSSF,2010e5,wv,000,0034,0000103,060,54,017,06000US5401792466,"Pine district, Doddridge County, West Virginia",511,316,122,30,2,90,194,195,72,43,43,0,0,29,123,76,0,0,76,47
ACSSF,2010e5,wv,000,0034,0000104,060,54,019,06000US5401992280,"New Haven district, Fayette County, West Virginia",4166,3336,1118,228,201,689,2218,830,236,92,40,5,47,144,594,303,36,86,181,291
ACSSF,2010e5,wv,000,0034,0000105,060,54,019,06000US5401992472,"Plateau district, Fayette County, West Virginia",4608,3361,1032,201,201,630,2329,1247,342,140,91,0,49,202,905,466,65,33,368,439
ACSSF,2010e5,wv,000,0034,0000106,060,54,019,06000US5401993396,"Valley district, Fayette County, West Virginia",3570,2518,761,92,172,497,1757,1052,333,175,58,15,102,158,719,208,25,40,143,511
ACSSF,2010e5,wv,000,0034,0000107,060,54,021,06000US5402190408,"Center district, Gilmer County, West Virginia",409,282,28,0,0,28,254,127,15,0,0,0,0,15,112,76,10,0,66,36
ACSSF,2010e5,wv,000,0034,0000108,060,54,021,06000US5402190534,"City district, Gilmer County, West Virginia",392,256,136,13,17,106,120,136,25,8,0,0,8,17,111,41,3,23,15,70
ACSSF,2010e5,wv,000,0034,0000109,060,54,021,06000US5402190758,"De Kalb-Troy district, Gilmer County, West Virginia",457,385,175,32,19,124,210,72,43,6,0,0,6,37,29,11,0,0,11,18
ACSSF,2010e5,wv,000,0034,0000110,060,54,021,06000US5402191236,"Glenville district, Gilmer County, West Virginia",291,232,56,25,14,17,176,59,5,5,0,5,0,0,54,13,8,5,0,41
ACSSF,2010e5,wv,000,0034,0000111,060,54,023,06000US5402391296,"Grant district, Grant County, West Virginia",1116,958,366,157,33,176,592,158,0,0,0,0,0,0,158,105,60,14,31,53
ACSSF,2010e5,wv,000,0034,0000112,060,54,023,06000US5402392208,"Milroy district, Grant County, West Virginia",1248,875,249,62,46,141,626,373,148,104,50,0,54,44,225,167,30,0,137,58
ACSSF,2010e5,wv,000,0034,0000113,060,54,023,06000US5402393216,"Union district, Grant County, West Virginia",1087,956,293,64,93,136,663,131,36,4,0,0,4,32,95,49,21,0,28,46
ACSSF,2010e5,wv,000,0034,0000114,060,54,025,06000US5402590449,"Central district, Greenbrier County, West Virginia",3561,2818,1012,250,241,521,1806,743,162,38,35,0,3,124,581,281,74,42,165,300
ACSSF,2010e5,wv,000,0034,0000115,060,54,025,06000US5402590972,"Eastern district, Greenbrier County, West Virginia",3307,2341,653,173,120,360,1688,966,288,165,41,24,100,123,678,353,94,59,200,325
ACSSF,2010e5,wv,000,0034,0000116,060,54,025,06000US5402593601,"Western district, Greenbrier County, West Virginia",3109,2346,814,235,157,422,1532,763,267,107,17,0,90,160,496,271,26,23,222,225
ACSSF,2010e5,wv,000,0034,0000117,060,54,027,06000US5402790204,"Bloomery district, Hampshire County, West Virginia",737,592,184,26,17,141,408,145,131,115,0,0,115,16,14,0,0,0,0,14
ACSSF,2010e5,wv,000,0034,0000118,060,54,027,06000US5402790360,"Capon district, Hampshire County, West Virginia",604,458,138,7,27,104,320,146,26,14,0,0,14,12,120,79,0,0,79,41
ACSSF,2010e5,wv,000,0034,0000119,060,54,027,06000US5402791248,"Gore district, Hampshire County, West Virginia",1157,867,231,18,26,187,636,290,77,54,16,0,38,23,213,76,0,0,76,137
ACSSF,2010e5,wv,000,0034,0000120,060,54,027,06000US5402792184,"Mill Creek district, Hampshire County, West Virginia",348,294,76,30,0,46,218,54,6,0,0,0,0,6,48,31,13,18,0,17
ACSSF,2010e5,wv,000,0034,0000121,060,54,027,06000US5402792676,"Romney district, Hampshire County, West Virginia",890,620,187,26,35,126,433,270,29,8,0,0,8,21,241,136,11,21,104,105
ACSSF,2010e5,wv,000,0034,0000122,060,54,027,06000US5402792820,"Sherman district, Hampshire County, West Virginia",1275,941,421,73,177,171,520,334,92,0,0,0,0,92,242,193,33,36,124,49
ACSSF,2010e5,wv,000,0034,0000123,060,54,027,06000US5402792988,"Springfield district, Hampshire County, West Virginia",793,578,204,38,28,138,374,215,18,0,0,0,0,18,197,115,0,19,96,82
ACSSF,2010e5,wv,000,0034,0000124,060,54,029,06000US5402990312,"Butler district, Hancock County, West Virginia",3043,2296,683,138,148,397,1613,747,174,66,17,0,49,108,573,338,0,112,226,235
ACSSF,2010e5,wv,000,0034,0000125,060,54,029,06000US5402990540,"Clay district, Hancock County, West Virginia",2836,2005,744,182,183,379,1261,831,311,150,66,16,68,161,520,215,70,32,113,305
ACSSF,2010e5,wv,000,0034,0000126,060,54,029,06000US5402991308,"Grant district, Hancock County, West Virginia",3003,2465,819,204,167,448,1646,538,155,138,43,0,95,17,383,177,5,36,136,206
ACSSF,2010e5,wv,000,0034,0000127,060,54,031,06000US5403190372,"Capon district, Hardy County, West Virginia",679,573,114,14,14,86,459,106,28,28,4,0,24,0,78,49,17,23,9,29
ACSSF,2010e5,wv,000,0034,0000128,060,54,031,06000US5403191968,"Lost River district, Hardy County, West Virginia",595,471,40,10,0,30,431,124,36,13,13,0,0,23,88,25,0,0,25,63
ACSSF,2010e5,wv,000,0034,0000129,060,54,031,06000US5403192232,"Moorefield district, Hardy County, West Virginia",452,303,71,7,16,48,232,149,38,0,0,0,0,38,111,64,6,8,50,47
ACSSF,2010e5,wv,000,0034,0000130,060,54,031,06000US5403192382,"Old Fields district, Hardy County, West Virginia",663,521,75,0,44,31,446,142,19,0,0,0,0,19,123,93,16,48,29,30
ACSSF,2010e5,wv,000,0034,0000131,060,54,031,06000US5403192928,"South Fork district, Hardy County, West Virginia",627,569,195,37,41,117,374,58,27,18,0,0,18,9,31,31,16,0,15,0
ACSSF,2010e5,wv,000,0034,0000132,060,54,033,06000US5403390975,"Eastern district, Harrison County, West Virginia",3507,2705,980,160,214,606,1725,802,176,115,30,0,85,61,626,276,0,29,247,350
ACSSF,2010e5,wv,000,0034,0000133,060,54,033,06000US5403392352,"Northern district, Harrison County, West Virginia",3160,2467,797,135,169,493,1670,693,173,62,0,5,57,111,520,215,72,22,121,305
ACSSF,2010e5,wv,000,0034,0000134,060,54,033,06000US5403392368,"North Urban district, Harrison County, West Virginia",2806,1803,612,169,139,304,1191,1003,206,51,27,0,24,155,797,471,105,136,230,326
ACSSF,2010e5,wv,000,0034,0000135,060,54,033,06000US5403392923,"Southern district, Harrison County, West Virginia",3871,2954,1017,239,142,636,1937,917,221,85,4,0,81,136,696,418,85,7,326,278
ACSSF,2010e5,wv,000,0034,0000136,060,54,033,06000US5403392932,"South Urban district, Harrison County, West Virginia",2904,2142,881,147,153,581,1261,762,131,98,0,15,83,33,631,268,123,14,131,363
ACSSF,2010e5,wv,000,0034,0000137,060,54,033,06000US5403392952,"Southwest district, Harrison County, West Virginia",2720,2195,775,113,113,549,1420,525,99,42,7,0,35,57,426,263,97,5,161,163
ACSSF,2010e5,wv,000,0034,0000138,060,54,035,06000US5403590976,"Eastern district, Jackson County, West Virginia",2767,2239,940,224,154,562,1299,528,202,137,66,36,35,65,326,176,46,24,106,150
ACSSF,2010e5,wv,000,0034,0000139,060,54,035,06000US5403592353,"Northern district, Jackson County, West Virginia",2565,2067,641,107,161,373,1426,498,151,93,53,0,40,58,347,269,64,0,205,78
ACSSF,2010e5,wv,000,0034,0000140,060,54,035,06000US5403593605,"Western district, Jackson County, West Virginia",3082,2416,865,211,220,434,1551,666,192,163,0,0,163,29,474,168,0,26,142,306
ACSSF,2010e5,wv,000,0034,0000141,060,54,037,06000US5403790504,"Charles Town district, Jefferson County, West Virginia",2870,2046,1041,279,294,468,1005,824,270,117,22,0,95,153,554,288,77,37,174,266
ACSSF,2010e5,wv,000,0034,0000142,060,54,037,06000US5403791548,"Harpers Ferry district, Jefferson County, West Virginia",2545,2233,876,232,217,427,1357,312,88,14,0,0,14,74,224,128,3,10,115,96
ACSSF,2010e5,wv,000,0034,0000143,060,54,037,06000US5403791740,"Kabletown district, Jefferson County, West Virginia",3283,2762,1304,327,220,757,1458,521,193,128,101,17,10,65,328,204,64,9,131,124
ACSSF,2010e5,wv,000,0034,0000144,060,54,037,06000US5403792160,"Middleway district, Jefferson County, West Virginia",2680,2073,739,150,87,502,1334,607,190,68,0,0,68,122,417,185,34,70,81,232
ACSSF,2010e5,wv,000,0034,0000145,060,54,037,06000US5403792760,"Shepherdstown district, Jefferson County, West Virginia",2212,2033,773,187,215,371,1260,179,109,27,24,0,3,82,70,35,4,11,20,35
ACSSF,2010e5,wv,000,0034,0000146,060,54,039,06000US5403990768,"District 1, Kanawha County, West Virginia",11007,8059,2552,489,433,1630,5507,2948,662,222,85,0,137,440,2286,1206,290,262,654,1080
ACSSF,2010e5,wv,000,0034,0000147,060,54,039,06000US5403990804,"District 2, Kanawha County, West Virginia",13533,10017,3567,833,609,2125,6450,3516,743,382,78,52,252,361,2773,1508,414,210,884,1265
ACSSF,2010e5,wv,000,0034,0000148,060,54,039,06000US5403990840,"District 3, Kanawha County, West Virginia",13533,10414,3614,742,786,2086,6800,3119,916,517,144,0,373,399,2203,1247,261,211,775,956
ACSSF,2010e5,wv,000,0034,0000149,060,54,039,06000US5403990876,"District 4, Kanawha County, West Virginia",12991,10028,3010,687,585,1738,7018,2963,623,367,52,71,244,256,2340,1283,401,144,738,1057
ACSSF,2010e5,wv,000,0034,0000150,060,54,041,06000US5404190676,"Courthouse-Collins Settlement district, Lewis County, West Virginia",1351,1038,324,66,34,224,714,313,85,61,13,10,38,24,228,166,31,11,124,62
ACSSF,2010e5,wv,000,0034,0000151,060,54,041,06000US5404191176,"Freemans Creek district, Lewis County, West Virginia",1392,1227,364,10,100,254,863,165,61,26,17,0,9,35,104,97,13,20,64,7
ACSSF,2010e5,wv,000,0034,0000152,060,54,041,06000US5404191480,"Hackers Creek-Skin Creek district, Lewis County, West Virginia",1500,1181,356,42,103,211,825,319,79,19,19,0,0,60,240,146,59,29,58,94
ACSSF,2010e5,wv,000,0034,0000153,060,54,043,06000US5404390384,"Carroll district, Lincoln County, West Virginia",1092,809,275,49,33,193,534,283,85,53,8,0,45,32,198,155,29,28,98,43
ACSSF,2010e5,wv,000,0034,0000154,060,54,043,06000US5404390960,"Duval district, Lincoln County, West Virginia",1192,1013,485,127,55,303,528,179,37,0,0,0,0,37,142,110,16,74,20,32
ACSSF,2010e5,wv,000,0034,0000155,060,54,043,06000US5404391572,"Harts Creek district, Lincoln County, West Virginia",1103,778,281,48,28,205,497,325,53,16,16,0,0,37,272,123,24,23,76,149
ACSSF,2010e5,wv,000,0034,0000156,060,54,043,06000US5404391704,"Jefferson district, Lincoln County, West Virginia",350,286,163,56,20,87,123,64,20,0,0,0,0,20,44,28,0,0,28,16
ACSSF,2010e5,wv,000,0034,0000157,060,54,043,06000US5404391812,"Laurel Hill district, Lincoln County, West Virginia",670,502,241,118,25,98,261,168,96,54,0,38,16,42,72,44,18,0,26,28
ACSSF,2010e5,wv,000,0034,0000158,060,54,043,06000US5404392784,"Sheridan district, Lincoln County, West Virginia",1350,917,279,40,52,187,638,433,173,78,25,0,53,95,260,142,78,0,64,118
ACSSF,2010e5,wv,000,0034,0000159,060,54,043,06000US5404393240,"Union district, Lincoln County, West Virginia",65,52,0,0,0,0,52,13,0,0,0,0,0,0,13,13,0,0,13,0
ACSSF,2010e5,wv,000,0034,0000160,060,54,043,06000US5404393516,"Washington district, Lincoln County, West Virginia",730,584,298,133,20,145,286,146,0,0,0,0,0,0,146,13,0,13,0,133
ACSSF,2010e5,wv,000,0034,0000161,060,54,045,06000US5404590453,"Central district, Logan County, West Virginia",3353,2430,831,149,202,480,1599,923,299,168,90,0,78,131,624,255,23,59,173,369
ACSSF,2010e5,wv,000,0034,0000162,060,54,045,06000US5404590979,"Eastern district, Logan County, West Virginia",3910,2996,1048,256,181,611,1948,914,187,66,5,0,61,121,727,206,93,0,113,521
ACSSF,2010e5,wv,000,0034,0000163,060,54,045,06000US5404593608,"Western district, Logan County, West Virginia",3251,2427,921,95,229,597,1506,824,132,73,32,0,41,59,692,231,60,46,125,461
ACSSF,2010e5,wv,000,0034,0000164,060,54,047,06000US5404790168,"Big Creek district, McDowell County, West Virginia",1426,1028,215,43,39,133,813,398,103,39,0,20,19,64,295,207,16,46,145,88
ACSSF,2010e5,wv,000,0034,0000165,060,54,047,06000US5404790240,"Browns Creek district, McDowell County, West Virginia",1240,960,356,26,25,305,604,280,85,24,2,0,22,61,195,84,0,4,80,111
ACSSF,2010e5,wv,000,0034,0000166,060,54,047,06000US5404792345,"North Elkin district, McDowell County, West Virginia",1331,930,326,28,51,247,604,401,45,13,0,0,13,32,356,136,8,40,88,220
ACSSF,2010e5,wv,000,0034,0000167,060,54,047,06000US5404792712,"Sandy River district, McDowell County, West Virginia",1493,1224,304,74,111,119,920,269,101,25,0,0,25,76,168,94,6,0,88,74
ACSSF,2010e5,wv,000,0034,0000168,060,54,049,06000US5404992154,"Middletown district, Marion County, West Virginia",4063,2818,957,164,135,658,1861,1245,239,130,18,0,112,109,1006,512,198,88,226,494
ACSSF,2010e5,wv,000,0034,0000169,060,54,049,06000US5404992418,"Palatine district, Marion County, West Virginia",5992,4550,1711,437,319,955,2839,1442,436,227,8,0,219,209,1006,541,69,37,435,465
ACSSF,2010e5,wv,000,0034,0000170,060,54,049,06000US5404993594,"West Augusta district, Marion County, West Virginia",4972,3981,1443,318,203,922,2538,991,315,116,18,29,69,199,676,400,54,30,316,276
ACSSF,2010e5,wv,000,0034,0000171,060,54,051,06000US5405190780,"District 1, Marshall County, West Virginia",3040,2408,921,141,150,630,1487,632,186,100,18,0,82,86,446,210,54,32,124,236
ACSSF,2010e5,wv,000,0034,0000172,060,54,051,06000US5405190816,"District 2, Marshall County, West Virginia",2696,1959,500,41,120,339,1459,737,181,103,38,0,65,78,556,287,96,27,164,269
ACSSF,2010e5,wv,000,0034,0000173,060,54,051,06000US5405190852,"District 3, Marshall County, West Virginia",3649,2947,1053,259,227,567,1894,702,247,104,78,0,26,143,455,267,73,12,182,188
ACSSF,2010e5,wv,000,0034,0000174,060,54,053,06000US5405390048,"Arbuckle district, Mason County, West Virginia",310,256,60,11,36,13,196,54,19,17,0,0,17,2,35,0,0,0,0,35
ACSSF,2010e5,wv,000,0034,0000175,060,54,053,06000US5405390612,"Clendenin district, Mason County, West Virginia",1091,847,254,31,65,158,593,244,73,31,0,3,28,42,171,65,6,38,21,106
ACSSF,2010e5,wv,000,0034,0000176,060,54,053,06000US5405390648,"Cologne district, Mason County, West Virginia",284,250,74,0,18,56,176,34,32,5,0,0,5,27,2,0,0,0,0,2
ACSSF,2010e5,wv,000,0034,0000177,060,54,053,06000US5405390660,"Cooper district, Mason County, West Virginia",541,465,125,27,27,71,340,76,15,15,0,0,15,0,61,11,0,0,11,50
ACSSF,2010e5,wv,000,0034,0000178,060,54,053,06000US5405391260,"Graham district, Mason County, West Virginia",981,739,311,80,74,157,428,242,70,30,24,6,0,40,172,110,12,0,98,62
ACSSF,2010e5,wv,000,0034,0000179,060,54,053,06000US5405391512,"Hannan district, Mason County, West Virginia",848,670,243,35,69,139,427,178,46,23,0,0,23,23,132,83,41,0,42,49
ACSSF,2010e5,wv,000,0034,0000180,060,54,053,06000US5405391860,"Lewis district, Mason County, West Virginia",1564,1164,437,80,107,250,727,400,95,82,9,0,73,13,305,149,57,0,92,156
ACSSF,2010e5,wv,000,0034,0000181,060,54,053,06000US5405392652,"Robinson district, Mason County, West Virginia",724,472,151,0,48,103,321,252,0,0,0,0,0,0,252,238,162,10,66,14
ACSSF,2010e5,wv,000,0034,0000182,060,54,053,06000US5405393264,"Union district, Mason County, West Virginia",452,370,127,0,19,108,243,82,34,0,0,0,0,34,48,23,0,0,23,25
ACSSF,2010e5,wv,000,0034,0000183,060,54,053,06000US5405393432,"Waggener district, Mason County, West Virginia",799,524,168,27,18,123,356,275,58,52,3,0,49,6,217,135,19,23,93,82
ACSSF,2010e5,wv,000,0034,0000184,060,54,055,06000US5405590900,"District I, Mercer County, West Virginia",4642,3459,1024,199,190,635,2435,1183,164,56,42,0,14,108,1019,588,158,71,359,431
ACSSF,2010e5,wv,000,0034,0000185,060,54,055,06000US5405590912,"District II, Mercer County, West Virginia",6106,4507,1414,444,181,789,3093,1599,606,296,73,57,166,310,993,524,182,0,342,469
ACSSF,2010e5,wv,000,0034,0000186,060,54,055,06000US5405590924,"District III, Mercer County, West Virginia",5263,4312,1341,172,296,873,2971,951,244,126,48,17,61,118,707,337,108,56,173,370
ACSSF,2010e5,wv,000,0034,0000187,060,54,057,06000US5405790784,"District 1, Mineral County, West Virginia",2588,2070,647,162,111,374,1423,518,145,92,20,53,19,53,373,294,28,34,232,79
ACSSF,2010e5,wv,000,0034,0000188,060,54,057,06000US5405790820,"District 2, Mineral County, West Virginia",2392,1763,540,128,126,286,1223,629,113,82,14,0,68,31,516,348,60,23,265,168
ACSSF,2010e5,wv,000,0034,0000189,060,54,057,06000US5405790856,"District 3, Mineral County, West Virginia",2730,2187,660,106,138,416,1527,543,188,122,70,21,31,66,355,219,28,26,165,136
ACSSF,2010e5,wv,000,0034,0000190,060,54,059,06000US5405990141,"Beech Ben Mate district, Mingo County, West Virginia",1025,757,293,79,42,172,464,268,66,30,30,0,0,36,202,147,30,34,83,55
ACSSF,2010e5,wv,000,0034,0000191,060,54,059,06000US5405991770,"Kermit Harvey district, Mingo County, West Virginia",1102,883,255,44,25,186,628,219,66,34,0,34,0,32,153,12,0,4,8,141
ACSSF,2010e5,wv,000,0034,0000192,060,54,059,06000US5405991848,"Lee district, Mingo County, West Virginia",1166,917,348,53,73,222,569,249,129,31,31,0,0,98,120,39,0,32,7,81
ACSSF,2010e5,wv,000,0034,0000193,060,54,059,06000US5405992064,"Magnolia district, Mingo County, West Virginia",822,502,209,55,15,139,293,320,109,62,0,0,62,47,211,116,5,16,95,95
ACSSF,2010e5,wv,000,0034,0000194,060,54,059,06000US5405993012,"Stafford district, Mingo County, West Virginia",1243,1012,290,90,0,200,722,231,51,26,0,0,26,25,180,74,35,0,39,106
ACSSF,2010e5,wv,000,0034,0000195,060,54,059,06000US5405993162,"Tug Hardee district, Mingo County, West Virginia",1075,838,296,111,34,151,542,237,121,13,0,0,13,108,116,35,0,0,35,81
ACSSF,2010e5,wv,000,0034,0000196,060,54,059,06000US5405993696,"Williamson district, Mingo County, West Virginia",1054,689,226,35,48,143,463,365,32,0,0,0,0,32,333,137,57,15,65,196
ACSSF,2010e5,wv,000,0034,0000197,060,54,061,06000US5406190456,"Central district, Monongalia County, West Virginia",3786,2816,923,230,215,478,1893,970,265,158,56,67,35,107,705,341,92,39,210,364
ACSSF,2010e5,wv,000,0034,0000198,060,54,061,06000US5406190983,"Eastern district, Monongalia County, West Virginia",7869,6297,2633,806,537,1290,3664,1572,586,223,106,0,117,363,986,551,180,41,330,435
ACSSF,2010e5,wv,000,0034,0000199,060,54,061,06000US5406193612,"Western district, Monongalia County, West Virginia",7130,5948,2227,530,416,1281,3721,1182,339,137,32,5,100,202,843,464,103,73,288,379
ACSSF,2010e5,wv,000,0034,0000200,060,54,063,06000US5406390457,"Central district, Monroe County, West Virginia",1382,1157,298,128,10,160,859,225,101,44,0,0,44,57,124,91,61,8,22,33
ACSSF,2010e5,wv,000,0034,0000201,060,54,063,06000US5406390984,"Eastern district, Monroe County, West Virginia",1251,1066,337,75,96,166,729,185,64,27,0,0,27,37,121,16,0,0,16,105
ACSSF,2010e5,wv,000,0034,0000202,060,54,063,06000US5406393613,"Western district, Monroe County, West Virginia",1289,1074,330,96,57,177,744,215,33,0,0,0,0,33,182,44,0,3,41,138
ACSSF,2010e5,wv,000,0034,0000203,060,54,065,06000US5406590786,"District 1, Morgan County, West Virginia",1214,879,219,0,37,182,660,335,53,5,0,0,5,48,282,150,6,0,144,132
ACSSF,2010e5,wv,000,0034,0000204,060,54,065,06000US5406590822,"District 2, Morgan County, West Virginia",1239,1000,239,63,82,94,761,239,36,9,0,0,9,27,203,122,0,34,88,81
ACSSF,2010e5,wv,000,0034,0000205,060,54,065,06000US5406590858,"District 3, Morgan County, West Virginia",1629,1340,507,63,111,333,833,289,181,136,59,10,67,45,108,63,0,0,63,45
ACSSF,2010e5,wv,000,0034,0000206,060,54,067,06000US5406790132,"Beaver district, Nicholas County, West Virginia",2255,1803,588,174,139,275,1215,452,159,88,38,0,50,71,293,131,37,51,43,162
ACSSF,2010e5,wv,000,0034,0000207,060,54,067,06000US5406791344,"Grant district, Nicholas County, West Virginia",393,253,94,0,0,94,159,140,84,65,0,0,65,19,56,0,0,0,0,56
ACSSF,2010e5,wv,000,0034,0000208,060,54,067,06000US5406791500,"Hamilton district, Nicholas County, West Virginia",835,740,211,40,43,128,529,95,76,38,12,0,26,38,19,0,0,0,0,19
ACSSF,2010e5,wv,000,0034,0000209,060,54,067,06000US5406791716,"Jefferson district, Nicholas County, West Virginia",463,364,140,0,22,118,224,99,62,20,0,0,20,42,37,23,0,0,23,14
ACSSF,2010e5,wv,000,0034,0000210,060,54,067,06000US5406791752,"Kentucky district, Nicholas County, West Virginia",1302,1100,419,100,65,254,681,202,97,78,15,0,63,19,105,0,0,0,0,105
ACSSF,2010e5,wv,000,0034,0000211,060,54,067,06000US5406793072,"Summersville district, Nicholas County, West Virginia",1523,1302,458,29,0,429,844,221,39,0,0,0,0,39,182,68,0,0,68,114
ACSSF,2010e5,wv,000,0034,0000212,060,54,067,06000US5406793660,"Wilderness district, Nicholas County, West Virginia",900,801,243,49,56,138,558,99,18,11,11,0,0,7,81,15,0,0,15,66
ACSSF,2010e5,wv,000,0034,0000213,060,54,069,06000US5406990788,"District 1, Ohio County, West Virginia",4462,3812,1374,182,323,869,2438,650,103,51,19,0,32,52,547,330,90,37,203,217
ACSSF,2010e5,wv,000,0034,0000214,060,54,069,06000US5406990824,"District 2, Ohio County, West Virginia",3105,1934,622,155,84,383,1312,1171,255,133,67,0,66,122,916,543,182,139,222,373
ACSSF,2010e5,wv,000,0034,0000215,060,54,069,06000US5406990862,"District 3, Ohio County, West Virginia",3919,3142,1049,151,161,737,2093,777,92,33,10,0,23,59,685,273,27,76,170,412
ACSSF,2010e5,wv,000,0034,0000216,060,54,071,06000US5407190462,"Central district, Pendleton County, West Virginia",754,638,209,16,49,144,429,116,17,0,0,0,0,17,99,25,9,0,16,74
ACSSF,2010e5,wv,000,0034,0000217,060,54,071,06000US5407190987,"Eastern district, Pendleton County, West Virginia",720,587,170,40,86,44,417,133,48,48,21,0,27,0,85,47,0,34,13,38
ACSSF,2010e5,wv,000,0034,0000218,060,54,071,06000US5407193615,"Western district, Pendleton County, West Virginia",737,616,149,14,20,115,467,121,34,0,0,0,0,34,87,65,31,0,34,22
ACSSF,2010e5,wv,000,0034,0000219,060,54,073,06000US5407390892,"District A, Pleasants County, West Virginia",427,378,169,25,44,100,209,49,14,4,0,0,4,10,35,15,0,0,15,20
ACSSF,2010e5,wv,000,0034,0000220,060,54,073,06000US5407390894,"District B, Pleasants County, West Virginia",345,276,40,0,0,40,236,69,26,26,0,0,26,0,43,30,0,0,30,13
ACSSF,2010e5,wv,000,0034,0000221,060,54,073,06000US5407390896,"District C, Pleasants County, West Virginia",444,330,118,14,8,96,212,114,23,7,0,7,0,16,91,64,19,7,38,27
ACSSF,2010e5,wv,000,0034,0000222,060,54,073,06000US5407390898,"District D, Pleasants County, West Virginia",458,410,161,32,0,129,249,48,18,8,0,0,8,10,30,0,0,0,0,30
ACSSF,2010e5,wv,000,0034,0000223,060,54,075,06000US5407590996,"Edray district, Pocahontas County, West Virginia",1064,771,137,21,10,106,634,293,125,50,0,0,50,75,168,135,56,18,61,33
ACSSF,2010e5,wv,000,0034,0000224,060,54,075,06000US5407591416,"Greenbank district, Pocahontas County, West Virginia",803,769,342,41,64,237,427,34,8,6,0,0,6,2,26,11,11,0,0,15
ACSSF,2010e5,wv,000,0034,0000225,060,54,075,06000US5407591656,"Huntersville district, Pocahontas County, West Virginia",318,301,119,0,26,93,182,17,0,0,0,0,0,0,17,14,0,0,14,3
ACSSF,2010e5,wv,000,0034,0000226,060,54,075,06000US5407591944,"Little Levels district, Pocahontas County, West Virginia",518,433,159,69,21,69,274,85,26,17,17,0,0,9,59,33,0,0,33,26
ACSSF,2010e5,wv,000,0034,0000227,060,54,077,06000US5407791096,"Fifth district, Preston County, West Virginia",1678,1455,561,104,87,370,894,223,37,17,13,0,4,20,186,87,26,13,48,99
ACSSF,2010e5,wv,000,0034,0000228,060,54,077,06000US5407791100,"First district, Preston County, West Virginia",1910,1577,625,158,66,401,952,333,52,34,0,7,27,18,281,151,56,28,67,130
ACSSF,2010e5,wv,000,0034,0000229,060,54,077,06000US5407791134,"Fourth district, Preston County, West Virginia",1750,1382,517,116,77,324,865,368,63,27,22,0,5,36,305,103,5,21,77,202
ACSSF,2010e5,wv,000,0034,0000230,060,54,077,06000US5407792742,"Second district, Preston County, West Virginia",1749,1480,400,71,55,274,1080,269,75,11,0,0,11,64,194,102,31,15,56,92
ACSSF,2010e5,wv,000,0034,0000231,060,54,077,06000US5407793102,"Third district, Preston County, West Virginia",1916,1465,502,242,51,209,963,451,207,125,54,13,58,82,244,197,39,69,89,47
ACSSF,2010e5,wv,000,0034,0000232,060,54,079,06000US5407990292,"Buffalo-Union district, Putnam County, West Virginia",3130,2399,737,78,97,562,1662,731,158,73,6,6,61,85,573,221,49,6,166,352
ACSSF,2010e5,wv,000,0034,0000233,060,54,079,06000US5407990720,"Curry district, Putnam County, West Virginia",2754,2314,918,233,264,421,1396,440,47,34,8,0,26,13,393,233,27,100,106,160
ACSSF,2010e5,wv,000,0034,0000234,060,54,079,06000US5407992508,"Pocatalico district, Putnam County, West Virginia",2436,1821,718,186,113,419,1103,615,205,114,0,0,114,91,410,319,68,125,126,91
ACSSF,2010e5,wv,000,0034,0000235,060,54,079,06000US5407992736,"Scott district, Putnam County, West Virginia",3239,2813,1371,213,169,989,1442,426,130,65,6,31,28,65,296,122,71,0,51,174
ACSSF,2010e5,wv,000,0034,0000236,060,54,079,06000US5407993090,"Teays district, Putnam County, West Virginia",4370,3774,1674,382,357,935,2100,596,243,64,0,0,64,179,353,283,33,67,183,70
ACSSF,2010e5,wv,000,0034,0000237,060,54,081,06000US5408190792,"District 1, Raleigh County, West Virginia",6870,5553,1993,368,303,1322,3560,1317,364,141,27,25,89,223,953,437,124,128,185,516
ACSSF,2010e5,wv,000,0034,0000238,060,54,081,06000US5408190828,"District 2, Raleigh County, West Virginia",6903,5052,1840,482,285,1073,3212,1851,357,87,12,0,75,270,1494,783,174,127,482,711
ACSSF,2010e5,wv,000,0034,0000239,060,54,081,06000US5408190864,"District 3, Raleigh County, West Virginia",7241,5476,1860,376,423,1061,3616,1765,584,302,64,63,175,282,1181,526,139,39,348,655
ACSSF,2010e5,wv,000,0034,0000240,060,54,083,06000US5408390156,"Beverly district, Randolph County, West Virginia",1226,893,260,18,39,203,633,333,133,37,0,0,37,96,200,167,40,50,77,33
ACSSF,2010e5,wv,000,0034,0000241,060,54,083,06000US5408390936,"Dry Fork district, Randolph County, West Virginia",579,488,79,56,0,23,409,91,13,4,0,0,4,9,78,44,5,0,39,34
ACSSF,2010e5,wv,000,0034,0000242,060,54,083,06000US5408391668,"Huttonsville district, Randolph County, West Virginia",578,538,145,22,33,90,393,40,3,3,0,0,3,0,37,16,0,0,16,21
ACSSF,2010e5,wv,000,0034,0000243,060,54,083,06000US5408391824,"Leadsville district, Randolph County, West Virginia",3296,2622,937,127,139,671,1685,674,153,85,54,5,26,68,521,293,39,82,172,228
ACSSF,2010e5,wv,000,0034,0000244,060,54,083,06000US5408392148,"Middle Fork district, Randolph County, West Virginia",217,183,59,0,26,33,124,34,18,18,0,0,18,0,16,15,0,0,15,1
ACSSF,2010e5,wv,000,0034,0000245,060,54,083,06000US5408392220,"Mingo district, Randolph County, West Virginia",396,350,139,26,11,102,211,46,0,0,0,0,0,0,46,0,0,0,0,46
ACSSF,2010e5,wv,000,0034,0000246,060,54,083,06000US5408392292,"New Interest district, Randolph County, West Virginia",395,346,76,7,14,55,270,49,24,20,20,0,0,4,25,4,0,0,4,21
ACSSF,2010e5,wv,000,0034,0000247,060,54,083,06000US5408392640,"Roaring Creek district, Randolph County, West Virginia",546,476,171,0,50,121,305,70,37,4,4,0,0,33,33,4,0,0,4,29
ACSSF,2010e5,wv,000,0034,0000248,060,54,083,06000US5408393420,"Valley Bend district, Randolph County, West Virginia",458,399,168,22,78,68,231,59,12,0,0,0,0,12,47,32,0,32,0,15
ACSSF,2010e5,wv,000,0034,0000249,060,54,085,06000US5408590552,"Clay district, Ritchie County, West Virginia",1061,797,280,38,122,120,517,264,93,53,42,0,11,40,171,77,10,3,64,94
ACSSF,2010e5,wv,000,0034,0000250,060,54,085,06000US5408591380,"Grant district, Ritchie County, West Virginia",530,446,114,53,0,61,332,84,40,5,0,0,5,35,44,44,0,13,31,0
ACSSF,2010e5,wv,000,0034,0000251,060,54,085,06000US5408592244,"Murphy district, Ritchie County, West Virginia",339,255,50,0,0,50,205,84,21,0,0,0,0,21,63,21,0,0,21,42
ACSSF,2010e5,wv,000,0034,0000252,060,54,085,06000US5408593336,"Union district, Ritchie County, West Virginia",994,756,249,32,61,156,507,238,76,35,6,2,27,41,162,101,29,11,61,61
ACSSF,2010e5,wv,000,0034,0000253,060,54,087,06000US5408790793,"District I, Roane County, West Virginia",1254,1026,377,134,82,161,649,228,53,13,0,0,13,40,175,59,31,0,28,116
ACSSF,2010e5,wv,000,0034,0000254,060,54,087,06000US5408790829,"District II, Roane County, West Virginia",1228,978,346,5,56,285,632,250,41,20,0,0,20,21,209,43,7,20,16,166
ACSSF,2010e5,wv,000,0034,0000255,060,54,087,06000US5408790865,"District III, Roane County, West Virginia",1526,1269,333,117,12,204,936,257,45,0,0,0,0,45,212,120,24,96,0,92
ACSSF,2010e5,wv,000,0034,0000256,060,54,089,06000US5408990216,"Bluestone River district, Summers County, West Virginia",1262,952,348,104,51,193,604,310,87,50,0,0,50,37,223,103,0,0,103,120
ACSSF,2010e5,wv,000,0034,0000257,060,54,089,06000US5408991440,"Greenbrier River district, Summers County, West Virginia",1046,885,253,36,34,183,632,161,71,28,0,0,28,43,90,27,0,0,27,63
ACSSF,2010e5,wv,000,0034,0000258,060,54,089,06000US5408992316,"New River district, Summers County, West Virginia",888,606,115,22,37,56,491,282,108,38,19,0,19,70,174,53,0,14,39,121
ACSSF,2010e5,wv,000,0034,0000259,060,54,091,06000US5409190993,"Eastern district, Taylor County, West Virginia",1469,1156,337,73,49,215,819,313,70,0,0,0,0,70,243,148,0,53,95,95
ACSSF,2010e5,wv,000,0034,0000260,060,54,091,06000US5409193175,"Tygart district, Taylor County, West Virginia",1185,819,367,45,123,199,452,366,73,19,0,0,19,54,293,172,22,35,115,121
ACSSF,2010e5,wv,000,0034,0000261,060,54,091,06000US5409193621,"Western district, Taylor County, West Virginia",1934,1562,619,183,89,347,943,372,107,30,0,15,15,77,265,155,21,0,134,110
ACSSF,2010e5,wv,000,0034,0000262,060,54,093,06000US5409390192,"Black Fork district, Tucker County, West Virginia",1155,946,405,82,67,256,541,209,71,25,8,0,17,46,138,72,43,21,8,66
ACSSF,2010e5,wv,000,0034,0000263,060,54,093,06000US5409390624,"Clover district, Tucker County, West Virginia",99,99,24,0,0,24,75,0,0,0,0,0,0,0,0,0,0,0,0,0
ACSSF,2010e5,wv,000,0034,0000264,060,54,093,06000US5409390744,"Davis district, Tucker County, West Virginia",146,116,35,14,4,17,81,30,10,5,0,0,5,5,20,0,0,0,0,20
ACSSF,2010e5,wv,000,0034,0000265,060,54,093,06000US5409390948,"Dry Fork district, Tucker County, West Virginia",201,174,3,0,0,3,171,27,0,0,0,0,0,0,27,0,0,0,0,27
ACSSF,2010e5,wv,000,0034,0000266,060,54,093,06000US5409391056,"Fairfax district, Tucker County, West Virginia",175,142,21,3,0,18,121,33,10,0,0,0,0,10,23,18,7,6,5,5
ACSSF,2010e5,wv,000,0034,0000267,060,54,093,06000US5409391896,"Licking district, Tucker County, West Virginia",44,14,0,0,0,0,14,30,0,0,0,0,0,0,30,0,0,0,0,30
ACSSF,2010e5,wv,000,0034,0000268,060,54,093,06000US5409392688,"St. George district, Tucker County, West Virginia",252,182,62,0,0,62,120,70,43,28,14,0,14,15,27,0,0,0,0,27
ACSSF,2010e5,wv,000,0034,0000269,060,54,095,06000US5409590469,"Central district, Tyler County, West Virginia",597,517,162,59,11,92,355,80,17,8,8,0,0,9,63,21,5,6,10,42
ACSSF,2010e5,wv,000,0034,0000270,060,54,095,06000US5409592334,"North district, Tyler County, West Virginia",693,547,182,32,48,102,365,146,39,23,23,0,0,16,107,55,0,0,55,52
ACSSF,2010e5,wv,000,0034,0000271,060,54,095,06000US5409592898,"South district, Tyler County, West Virginia",748,554,182,17,36,129,372,194,111,57,24,0,33,54,83,10,0,0,10,73
ACSSF,2010e5,wv,000,0034,0000272,060,54,095,06000US5409593592,"West district, Tyler County, West Virginia",547,456,138,20,26,92,318,91,11,8,0,3,5,3,80,58,7,0,51,22
ACSSF,2010e5,wv,000,0034,0000273,060,54,097,06000US5409791102,"First district, Upshur County, West Virginia",1596,1151,496,114,61,321,655,445,112,32,6,0,26,80,333,163,21,58,84,170
ACSSF,2010e5,wv,000,0034,0000274,060,54,097,06000US5409792745,"Second district, Upshur County, West Virginia",2374,2080,791,175,189,427,1289,294,111,16,16,0,0,95,183,114,15,64,35,69
ACSSF,2010e5,wv,000,0034,0000275,060,54,097,06000US5409793105,"Third district, Upshur County, West Virginia",2226,1876,569,79,103,387,1307,350,126,82,22,31,29,44,224,72,0,55,17,152
ACSSF,2010e5,wv,000,0034,0000276,060,54,099,06000US5409990324,"Butler district, Wayne County, West Virginia",2490,1966,799,211,140,448,1167,524,130,42,0,34,8,88,394,99,0,15,84,295
ACSSF,2010e5,wv,000,0034,0000277,060,54,099,06000US5409990492,"Ceredo district, Wayne County, West Virginia",2050,1587,455,153,75,227,1132,463,171,133,28,0,105,38,292,168,53,23,92,124
ACSSF,2010e5,wv,000,0034,0000278,060,54,099,06000US5409993036,"Stonewall district, Wayne County, West Virginia",2287,1809,587,63,130,394,1222,478,198,83,25,13,45,115,280,87,12,32,43,193
ACSSF,2010e5,wv,000,0034,0000279,060,54,099,06000US5409993372,"Union district, Wayne County, West Virginia",2660,2232,963,279,143,541,1269,428,63,0,0,0,0,63,365,221,37,0,184,144
ACSSF,2010e5,wv,000,0034,0000280,060,54,099,06000US5409993624,"Westmoreland district, Wayne County, West Virginia",2269,1665,536,72,173,291,1129,604,75,44,13,0,31,31,529,346,97,21,228,183
ACSSF,2010e5,wv,000,0034,0000281,060,54,101,06000US5410190471,"Central district, Webster County, West Virginia",912,699,325,17,54,254,374,213,26,4,4,0,0,22,187,81,65,3,13,106
ACSSF,2010e5,wv,000,0034,0000282,060,54,101,06000US5410192360,"Northern district, Webster County, West Virginia",816,704,198,37,53,108,506,112,73,30,17,0,13,43,39,15,0,0,15,24
ACSSF,2010e5,wv,000,0034,0000283,060,54,101,06000US5410192925,"Southern district, Webster County, West Virginia",1199,962,361,95,71,195,601,237,117,89,36,0,53,28,120,86,54,7,25,34
ACSSF,2010e5,wv,000,0034,0000284,060,54,103,06000US5410390794,"District 1, Wetzel County, West Virginia",1763,1493,544,111,68,365,949,270,131,81,15,13,53,50,139,102,29,2,71,37
ACSSF,2010e5,wv,000,0034,0000285,060,54,103,06000US5410390830,"District 2, Wetzel County, West Virginia",1595,1230,412,79,95,238,818,365,51,23,16,0,7,28,314,173,34,72,67,141
ACSSF,2010e5,wv,000,0034,0000286,060,54,103,06000US5410390867,"District 3, Wetzel County, West Virginia",1367,1122,319,57,62,200,803,245,16,0,0,0,0,16,229,74,17,0,57,155
ACSSF,2010e5,wv,000,0034,0000287,060,54,105,06000US5410590473,"Central district, Wirt County, West Virginia",648,476,106,0,57,49,370,172,64,31,14,0,17,33,108,79,17,12,50,29
ACSSF,2010e5,wv,000,0034,0000288,060,54,105,06000US5410592344,"Northeast district, Wirt County, West Virginia",545,467,155,0,24,131,312,78,0,0,0,0,0,0,78,50,0,0,50,28
ACSSF,2010e5,wv,000,0034,0000289,060,54,105,06000US5410592958,"Southwest district, Wirt County, West Virginia",504,504,180,112,21,47,324,0,0,0,0,0,0,0,0,0,0,0,0,0
ACSSF,2010e5,wv,000,0034,0000290,060,54,107,06000US5410790588,"Clay district, Wood County, West Virginia",1732,1457,535,115,165,255,922,275,36,5,5,0,0,31,239,166,46,25,95,73
ACSSF,2010e5,wv,000,0034,0000291,060,54,107,06000US5410791560,"Harris district, Wood County, West Virginia",540,501,173,28,12,133,328,39,15,15,0,0,15,0,24,24,0,0,24,0
ACSSF,2010e5,wv,000,0034,0000292,060,54,107,06000US5410791980,"Lubeck district, Wood County, West Virginia",3117,2570,924,192,155,577,1646,547,209,121,54,0,67,88,338,199,76,26,97,139
ACSSF,2010e5,wv,000,0034,0000293,060,54,107,06000US5410792424,"Parkersburg district, Wood County, West Virginia",7219,4945,1634,308,287,1039,3311,2274,565,366,66,107,193,199,1709,819,250,74,495,890
ACSSF,2010e5,wv,000,0034,0000294,060,54,107,06000US5410792856,"Slate district, Wood County, West Virginia",1308,1113,543,83,116,344,570,195,68,14,0,0,14,54,127,100,28,34,38,27
ACSSF,2010e5,wv,000,0034,0000295,060,54,107,06000US5410793024,"Steele district, Wood County, West Virginia",339,288,130,0,9,121,158,51,10,10,0,0,10,0,41,19,19,0,0,22
ACSSF,2010e5,wv,000,0034,0000296,060,54,107,06000US5410793180,"Tygart district, Wood County, West Virginia",3672,2708,768,166,152,450,1940,964,143,70,50,0,20,73,821,457,138,49,270,364
ACSSF,2010e5,wv,000,0034,0000297,060,54,107,06000US5410793384,"Union district, Wood County, West Virginia",1473,1298,412,59,41,312,886,175,105,30,22,0,8,75,70,60,0,26,34,10
ACSSF,2010e5,wv,000,0034,0000298,060,54,107,06000US5410793444,"Walker district, Wood County, West Virginia",308,237,81,29,14,38,156,71,46,0,0,0,0,46,25,18,18,0,0,7
ACSSF,2010e5,wv,000,0034,0000299,060,54,107,06000US5410793672,"Williams district, Wood County, West Virginia",4226,3524,1466,258,266,942,2058,702,203,157,56,0,101,46,499,306,75,44,187,193
ACSSF,2010e5,wv,000,0034,0000300,060,54,109,06000US5410990795,"District 1, Wyoming County, West Virginia",1952,1524,426,89,46,291,1098,428,87,57,0,0,57,30,341,234,122,0,112,107
ACSSF,2010e5,wv,000,0034,0000301,060,54,109,06000US5410990831,"District 2, Wyoming County, West Virginia",2107,1788,751,142,117,492,1037,319,87,24,0,0,24,63,232,67,6,0,61,165
ACSSF,2010e5,wv,000,0034,0000302,060,54,109,06000US5410990868,"District 3, Wyoming County, West Virginia",2506,1976,666,115,125,426,1310,530,145,52,0,0,52,93,385,198,29,40,129,187
ACSSF,2010e5,wv,000,0034,0000303,070,54,001,07000US540019232863292,"Philippi city (part), North district, Barbour County, West Virginia",459,302,39,0,20,19,263,157,25,0,0,0,0,25,132,97,31,0,66,35
ACSSF,2010e5,wv,000,0034,0000304,070,54,001,07000US540019232899999,"Remainder of North district, North district, Barbour County, West Virginia",1245,1021,270,56,52,162,751,224,113,55,9,32,14,58,111,56,0,51,5,55
ACSSF,2010e5,wv,000,0034,0000305,070,54,001,07000US540019289205788,"Belington town, South district, Barbour County, West Virginia",570,409,129,26,22,81,280,161,45,28,9,3,16,17,116,59,3,5,51,57
ACSSF,2010e5,wv,000,0034,0000306,070,54,001,07000US540019289242244,"Junior town, South district, Barbour County, West Virginia",93,63,22,0,6,16,41,30,16,9,3,0,6,7,14,4,0,0,4,10
ACSSF,2010e5,wv,000,0034,0000307,070,54,001,07000US540019289299999,"Remainder of South district, South district, Barbour County, West Virginia",860,712,254,31,45,178,458,148,56,0,0,0,0,56,92,23,0,0,23,69
ACSSF,2010e5,wv,000,0034,0000308,070,54,001,07000US540019358814212,"Century CDP, West district, Barbour County, West Virginia",21,21,13,0,0,13,8,0,0,0,0,0,0,0,0,0,0,0,0,0
ACSSF,2010e5,wv,000,0034,0000309,070,54,001,07000US540019358829740,"Galloway CDP, West district, Barbour County, West Virginia",51,28,0,0,0,0,28,23,0,0,0,0,0,0,23,23,0,0,23,0
ACSSF,2010e5,wv,000,0034,0000310,070,54,001,07000US540019358863292,"Philippi city (part), West district, Barbour County, West Virginia",235,181,38,28,0,10,143,54,18,18,0,0,18,0,36,30,0,0,30,6
ACSSF,2010e5,wv,000,0034,0000311,070,54,001,07000US540019358899999,"Remainder of West district, West district, Barbour County, West Virginia",711,567,139,33,18,88,428,144,68,18,0,0,18,50,76,50,0,50,0,26
ACSSF,2010e5,wv,000,0034,0000312,070,54,003,07000US540039000652060,"Martinsburg city (part), Adam Stephens district, Berkeley County, West Virginia",3329,2111,661,204,183,274,1450,1218,374,284,73,109,102,90,844,509,235,58,216,335
ACSSF,2010e5,wv,000,0034,0000313,070,54,003,07000US540039000699999,"Remainder of Adam Stephens district, Adam Stephens district, Berkeley County, West Virginia",187,159,46,0,0,46,113,28,12,12,0,0,12,0,16,0,0,0,0,16
ACSSF,2010e5,wv,000,0034,0000314,070,54,003,07000US540039232236220,"Hedgesville town (part), Norborne district, Berkeley County, West Virginia",63,47,26,2,3,21,21,16,3,0,0,0,0,3,13,10,4,2,4,3
ACSSF,2010e5,wv,000,0034,0000315,070,54,003,07000US540039232252060,"Martinsburg city (part), Norborne district, Berkeley County, West Virginia",630,463,235,43,25,167,228,167,29,29,0,0,29,0,138,138,89,0,49,0
ACSSF,2010e5,wv,000,0034,0000316,070,54,003,07000US540039232299999,"Remainder of Norborne district, Norborne district, Berkeley County, West Virginia",2065,1672,711,145,135,431,961,393,168,106,5,43,58,62,225,154,27,14,113,71
ACSSF,2010e5,wv,000,0034,0000317,070,54,003,07000US540039252626716,"Falling Waters CDP, Potomac district, Berkeley County, West Virginia",233,216,84,0,64,20,132,17,2,0,0,0,0,2,15,8,0,0,8,7
ACSSF,2010e5,wv,000,0034,0000318,070,54,003,07000US540039252652060,"Martinsburg city (part), Potomac district, Berkeley County, West Virginia",0,0,0,0,0,0,0,0,0,0,0,0,0,0,0,0,0,0,0,0
ACSSF,2010e5,wv,000,0034,0000319,070,54,003,07000US540039252699999,"Remainder of Potomac district, Potomac district, Berkeley County, West Virginia",3985,3241,1243,305,216,722,1998,744,217,194,71,41,82,23,527,233,86,65,82,294
ACSSF,2010e5,wv,000,0034,0000320,070,54,003,07000US540039275440204,"Inwood CDP, Shenandoah district, Berkeley County, West Virginia",819,668,217,36,75,106,451,151,87,38,19,19,0,49,64,11,0,0,11,53
ACSSF,2010e5,wv,000,0034,0000321,070,54,003,07000US540039275499999,"Remainder of Shenandoah district, Shenandoah district, Berkeley County, West Virginia",4249,3106,1397,358,173,866,1709,1143,429,252,47,23,182,177,714,377,75,5,297,337
ACSSF,2010e5,wv,000,0034,0000322,070,54,003,07000US540039317152060,"Martinsburg city (part), Tuscarora district, Berkeley County, West Virginia",247,165,83,32,18,33,82,82,14,14,14,0,0,0,68,34,13,0,21,34
ACSSF,2010e5,wv,000,0034,0000323,070,54,003,07000US540039317199999,"Remainder of Tuscarora district, Tuscarora district, Berkeley County, West Virginia",4972,3868,1680,545,352,783,2188,1104,220,60,10,0,50,160,884,601,193,135,273,283
ACSSF,2010e5,wv,000,0034,0000324,070,54,003,07000US540039338836220,"Hedgesville town (part), Valley district, Berkeley County, West Virginia",0,0,0,0,0,0,0,0,0,0,0,0,0,0,0,0,0,0,0,0
ACSSF,2010e5,wv,000,0034,0000325,070,54,003,07000US540039338899999,"Remainder of Valley district, Valley district, Berkeley County, West Virginia",5696,4507,1597,308,388,901,2910,1189,463,250,99,38,113,213,726,288,101,24,163,438
ACSSF,2010e5,wv,000,0034,0000326,070,54,005,07000US540059076217380,"Comfort CDP, District 1, Boone County, West Virginia",133,122,85,0,0,85,37,11,0,0,0,0,0,0,11,0,0,0,0,11
ACSSF,2010e5,wv,000,0034,0000327,070,54,005,07000US540059076266484,"Racine CDP, District 1, Boone County, West Virginia",86,86,32,32,0,0,54,0,0,0,0,0,0,0,0,0,0,0,0,0
ACSSF,2010e5,wv,000,0034,0000328,070,54,005,07000US540059076278964,"Sylvester town, District 1, Boone County, West Virginia",42,42,14,8,0,6,28,0,0,0,0,0,0,0,0,0,0,0,0,0
ACSSF,2010e5,wv,000,0034,0000329,070,54,005,07000US540059076286836,"Whitesville town, District 1, Boone County, West Virginia",141,116,59,8,4,47,57,25,0,0,0,0,0,0,25,11,5,0,6,14
ACSSF,2010e5,wv,000,0034,0000330,070,54,005,07000US540059076299999,"District Remainder of 1, District 1, Boone County, West Virginia",2132,1544,660,67,158,435,884,588,201,27,0,0,27,174,387,150,28,49,73,237
ACSSF,2010e5,wv,000,0034,0000331,070,54,005,07000US540059079633580,"Greenview CDP, District 2, Boone County, West Virginia",117,81,32,0,32,0,49,36,0,0,0,0,0,0,36,36,0,0,36,0
ACSSF,2010e5,wv,000,0034,0000332,070,54,005,07000US540059079650524,"Madison city (part), District 2, Boone County, West Virginia",180,122,51,0,43,8,71,58,33,14,0,0,14,19,25,0,0,0,0,25
ACSSF,2010e5,wv,000,0034,0000333,070,54,005,07000US540059079681484,"Twilight CDP, District 2, Boone County, West Virginia",0,0,0,0,0,0,0,0,0,0,0,0,0,0,0,0,0,0,0,0
ACSSF,2010e5,wv,000,0034,0000334,070,54,005,07000US540059079682852,"Van CDP, District 2, Boone County, West Virginia",62,47,0,0,0,0,47,15,15,0,0,0,0,15,0,0,0,0,0,0
ACSSF,2010e5,wv,000,0034,0000335,070,54,005,07000US540059079699999,"District Remainder of 2, District 2, Boone County, West Virginia",1659,1384,531,107,75,349,853,275,125,91,37,0,54,34,150,46,32,0,14,104
ACSSF,2010e5,wv,000,0034,0000336,070,54,005,07000US540059083220212,"Danville town, District 3, Boone County, West Virginia",245,197,73,6,13,54,124,48,6,6,0,0,6,0,42,28,0,9,19,14
ACSSF,2010e5,wv,000,0034,0000337,070,54,005,07000US540059083250524,"Madison city (part), District 3, Boone County, West Virginia",730,559,185,48,21,116,374,171,37,0,0,0,0,37,134,47,7,0,40,87
ACSSF,2010e5,wv,000,0034,0000338,070,54,005,07000US540059083299999,"District Remainder of 3, District 3, Boone County, West Virginia",1653,1397,415,91,87,237,982,256,74,18,7,0,11,56,182,98,0,0,98,84
ACSSF,2010e5,wv,000,0034,0000339,070,54,007,07000US540079096827868,"Flatwoods town (part), Eastern district, Braxton County, West Virginia",16,14,3,0,3,0,11,2,0,0,0,0,0,0,2,0,0,0,0,2
ACSSF,2010e5,wv,000,0034,0000340,070,54,007,07000US540079096878580,"Sutton town (part), Eastern district, Braxton County, West Virginia",251,157,31,4,3,24,126,94,4,4,0,4,0,0,90,58,20,18,20,32
ACSSF,2010e5,wv,000,0034,0000341,070,54,007,07000US540079096899999,"Remainder of Eastern district, Eastern district, Braxton County, West Virginia",492,448,146,16,55,75,302,44,25,5,0,0,5,20,19,11,0,0,11,8
ACSSF,2010e5,wv,000,0034,0000342,070,54,007,07000US540079234611716,"Burnsville town, Northern district, Braxton County, West Virginia",150,101,32,10,0,22,69,49,14,8,0,0,8,6,35,10,0,4,6,25
ACSSF,2010e5,wv,000,0034,0000343,070,54,007,07000US540079234627868,"Flatwoods town (part), Northern district, Braxton County, West Virginia",22,20,6,0,0,6,14,2,0,0,0,0,0,0,2,0,0,0,0,2
ACSSF,2010e5,wv,000,0034,0000344,070,54,007,07000US540079234699999,"Remainder of Northern district, Northern district, Braxton County, West Virginia",759,654,176,42,22,112,478,105,25,0,0,0,0,25,80,23,11,0,12,57
ACSSF,2010e5,wv,000,0034,0000345,070,54,007,07000US540079292299999,"Southern district, Southern district, Braxton County, West Virginia",1162,901,307,26,76,205,594,261,106,60,0,0,60,46,155,101,22,21,58,54
ACSSF,2010e5,wv,000,0034,0000346,070,54,007,07000US540079359730220,"Gassaway town, Western district, Braxton County, West Virginia",217,169,52,15,8,29,117,48,0,0,0,0,0,0,48,39,18,3,18,9
ACSSF,2010e5,wv,000,0034,0000347,070,54,007,07000US540079359778580,"Sutton town (part), Western district, Braxton County, West Virginia",60,37,6,1,5,0,31,23,16,3,0,0,3,13,7,0,0,0,0,7
ACSSF,2010e5,wv,000,0034,0000348,070,54,007,07000US540079359799999,"Remainder of Western district, Western district, Braxton County, West Virginia",775,697,122,6,0,116,575,78,23,8,0,0,8,15,55,55,10,0,45,0
ACSSF,2010e5,wv,000,0034,0000349,070,54,009,07000US540099110428204,"Follansbee city (part), Follansbee district, Brooke County, West Virginia",822,643,155,12,45,98,488,179,73,39,29,0,10,34,106,57,0,0,57,49
ACSSF,2010e5,wv,000,0034,0000350,070,54,009,07000US540099110438476,"Hooverson Heights CDP (part), Follansbee district, Brooke County, West Virginia",682,557,244,37,61,146,313,125,22,10,0,0,10,12,103,48,23,9,16,55
ACSSF,2010e5,wv,000,0034,0000351,070,54,009,07000US540099110499999,"Remainder of Follansbee district, Follansbee district, Brooke County, West Virginia",1043,811,253,89,35,129,558,232,34,6,0,0,6,28,198,104,74,0,30,94
ACSSF,2010e5,wv,000,0034,0000352,070,54,009,07000US540099355228204,"Follansbee city (part), Weirton district, Brooke County, West Virginia",0,0,0,0,0,0,0,0,0,0,0,0,0,0,0,0,0,0,0,0
ACSSF,2010e5,wv,000,0034,0000353,070,54,009,07000US540099355238476,"Hooverson Heights CDP (part), Weirton district, Brooke County, West Virginia",139,100,0,0,0,0,100,39,39,17,0,0,17,22,0,0,0,0,0,0
ACSSF,2010e5,wv,000,0034,0000354,070,54,009,07000US540099355285156,"Weirton city (part), Weirton district, Brooke County, West Virginia",1059,622,173,11,38,124,449,437,100,11,0,0,11,89,337,238,28,70,140,99
ACSSF,2010e5,wv,000,0034,0000355,070,54,009,07000US540099355299999,"Remainder of Weirton district, Weirton district, Brooke County, West Virginia",885,721,196,0,140,56,525,164,64,34,0,0,34,30,100,88,17,56,15,12
ACSSF,2010e5,wv,000,0034,0000356,070,54,009,07000US540099356405452,"Beech Bottom village, Wellsburg district, Brooke County, West Virginia",111,76,22,6,5,11,54,35,7,0,0,0,0,7,28,16,4,0,12,12
ACSSF,2010e5,wv,000,0034,0000357,070,54,009,07000US540099356406844,"Bethany town, Wellsburg district, Brooke County, West Virginia",115,92,21,4,0,17,71,23,7,7,0,0,7,0,16,0,0,0,0,16
ACSSF,2010e5,wv,000,0034,0000358,070,54,009,07000US540099356485324,"Wellsburg city, Wellsburg district, Brooke County, West Virginia",693,474,164,7,44,113,310,219,99,92,17,20,55,7,120,102,20,1,81,18
ACSSF,2010e5,wv,000,0034,0000359,070,54,009,07000US540099356487892,"Windsor Heights village, Wellsburg district, Brooke County, West Virginia",109,94,36,16,12,8,58,15,9,3,0,0,3,6,6,2,0,2,0,4
ACSSF,2010e5,wv,000,0034,0000360,070,54,009,07000US540099356499999,"Remainder of Wellsburg district, Wellsburg district, Brooke County, West Virginia",920,789,178,0,46,132,611,131,43,22,10,0,12,21,88,69,0,0,69,19
ACSSF,2010e5,wv,000,0034,0000361,070,54,011,07000US540119076439460,"Huntington city (part), District 1, Cabell County, West Virginia",3589,2498,787,265,63,459,1711,1091,221,128,71,0,57,93,870,491,76,113,302,379
ACSSF,2010e5,wv,000,0034,0000362,070,54,011,07000US540119076499999,"District Remainder of 1, District 1, Cabell County, West Virginia",1301,1027,386,15,95,276,641,274,60,47,32,0,15,13,214,111,19,0,92,103
ACSSF,2010e5,wv,000,0034,0000363,070,54,011,07000US540119079839460,"Huntington city (part), District 2, Cabell County, West Virginia",3136,1862,687,192,155,340,1175,1274,316,168,11,0,157,148,958,499,115,52,332,459
ACSSF,2010e5,wv,000,0034,0000364,070,54,011,07000US540119083404276,"Barboursville village (part), District 3, Cabell County, West Virginia",0,0,0,0,0,0,0,0,0,0,0,0,0,0,0,0,0,0,0,0
ACSSF,2010e5,wv,000,0034,0000365,070,54,011,07000US540119083439460,"Huntington city (part), District 3, Cabell County, West Virginia",3681,2413,685,210,156,319,1728,1268,278,159,45,0,114,119,990,541,110,166,265,449
ACSSF,2010e5,wv,000,0034,0000366,070,54,011,07000US540119083446420,"Lesage CDP (part), District 3, Cabell County, West Virginia",93,67,56,47,0,9,11,26,0,0,0,0,0,0,26,26,26,0,0,0
ACSSF,2010e5,wv,000,0034,0000367,070,54,011,07000US540119083499999,"District Remainder of 3, District 3, Cabell County, West Virginia",541,360,140,67,21,52,220,181,62,34,0,0,34,28,119,108,26,8,74,11
ACSSF,2010e5,wv,000,0034,0000368,070,54,011,07000US540119087004276,"Barboursville village (part), District 4, Cabell County, West Virginia",1166,989,229,63,74,92,760,177,29,13,0,0,13,16,148,102,0,0,102,46
ACSSF,2010e5,wv,000,0034,0000369,070,54,011,07000US540119087039460,"Huntington city (part), District 4, Cabell County, West Virginia",41,41,11,11,0,0,30,0,0,0,0,0,0,0,0,0,0,0,0,0
ACSSF,2010e5,wv,000,0034,0000370,070,54,011,07000US540119087062488,"Pea Ridge CDP, District 4, Cabell County, West Virginia",1672,1447,446,57,153,236,1001,225,53,17,0,0,17,36,172,31,0,0,31,141
ACSSF,2010e5,wv,000,0034,0000371,070,54,011,07000US540119087071476,"Salt Rock CDP (part), District 4, Cabell County, West Virginia",14,14,0,0,0,0,14,0,0,0,0,0,0,0,0,0,0,0,0,0
ACSSF,2010e5,wv,000,0034,0000372,070,54,011,07000US540119087099999,"District Remainder of 4, District 4, Cabell County, West Virginia",3866,3097,1162,223,159,780,1935,769,108,60,0,10,50,48,661,497,158,149,190,164
ACSSF,2010e5,wv,000,0034,0000373,070,54,011,07000US540119088204276,"Barboursville village (part), District 5, Cabell County, West Virginia",13,13,0,0,0,0,13,0,0,0,0,0,0,0,0,0,0,0,0,0
ACSSF,2010e5,wv,000,0034,0000374,070,54,011,07000US540119088219516,"Culloden CDP (part), District 5, Cabell County, West Virginia",716,590,265,55,47,163,325,126,58,0,0,0,0,58,68,29,0,0,29,39
ACSSF,2010e5,wv,000,0034,0000375,070,54,011,07000US540119088246420,"Lesage CDP (part), District 5, Cabell County, West Virginia",305,249,66,10,0,56,183,56,0,0,0,0,0,0,56,11,0,0,11,45
ACSSF,2010e5,wv,000,0034,0000376,070,54,011,07000US540119088254484,"Milton town, District 5, Cabell County, West Virginia",675,497,189,44,70,75,308,178,35,6,6,0,0,29,143,74,19,0,55,69
ACSSF,2010e5,wv,000,0034,0000377,070,54,011,07000US540119088271476,"Salt Rock CDP (part), District 5, Cabell County, West Virginia",58,58,22,22,0,0,36,0,0,0,0,0,0,0,0,0,0,0,0,0
ACSSF,2010e5,wv,000,0034,0000378,070,54,011,07000US540119088299999,"District Remainder of 5, District 5, Cabell County, West Virginia",3828,3098,1021,226,184,611,2077,730,175,87,27,0,60,88,555,336,63,10,263,219
ACSSF,2010e5,wv,000,0034,0000379,070,54,013,07000US540139076699999,"District 1, District 1, Calhoun County, West Virginia",324,268,9,0,0,9,259,56,27,0,0,0,0,27,29,19,0,0,19,10
ACSSF,2010e5,wv,000,0034,0000380,070,54,013,07000US540139080099999,"District 2, District 2, Calhoun County, West Virginia",384,261,70,0,18,52,191,123,76,63,24,26,13,13,47,13,0,0,13,34
ACSSF,2010e5,wv,000,0034,0000381,070,54,013,07000US540139083632884,"Grantsville town, District 3, Calhoun County, West Virginia",198,144,58,8,25,25,86,54,31,0,0,0,0,31,23,3,3,0,0,20
ACSSF,2010e5,wv,000,0034,0000382,070,54,013,07000US540139083699999,"District Remainder of 3, District 3, Calhoun County, West Virginia",165,131,35,0,14,21,96,34,12,12,12,0,0,0,22,22,0,0,22,0
ACSSF,2010e5,wv,000,0034,0000383,070,54,013,07000US540139087399999,"District 4, District 4, Calhoun County, West Virginia",499,326,105,0,0,105,221,173,54,45,27,18,0,9,119,20,0,0,20,99
ACSSF,2010e5,wv,000,0034,0000384,070,54,013,07000US540139088599999,"District 5, District 5, Calhoun County, West Virginia",493,407,187,0,49,138,220,86,38,0,0,0,0,38,48,20,20,0,0,28
ACSSF,2010e5,wv,000,0034,0000385,070,54,015,07000US540159089199999,"District A, District A, Clay County, West Virginia",765,529,188,14,75,99,341,236,80,18,0,0,18,62,156,78,10,0,68,78
ACSSF,2010e5,wv,000,0034,0000386,070,54,015,07000US540159089315676,"Clay town, District B, Clay County, West Virginia",100,84,35,0,0,35,49,16,0,0,0,0,0,0,16,7,0,0,7,9
ACSSF,2010e5,wv,000,0034,0000387,070,54,015,07000US540159089399999,"District Remainder of B, District B, Clay County, West Virginia",793,624,291,85,37,169,333,169,70,34,14,0,20,36,99,35,0,35,0,64
ACSSF,2010e5,wv,000,0034,0000388,070,54,015,07000US540159089599999,"District C, District C, Clay County, West Virginia",770,693,257,0,42,215,436,77,24,0,0,0,0,24,53,28,0,8,20,25
ACSSF,2010e5,wv,000,0034,0000389,070,54,017,07000US540179013899999,"Beech district, Beech district, Doddridge County, West Virginia",690,526,173,0,29,144,353,164,76,57,36,0,21,19,88,37,0,37,0,51
ACSSF,2010e5,wv,000,0034,0000390,070,54,017,07000US540179209486116,"West Union town (part), Maple district, Doddridge County, West Virginia",72,53,11,4,7,0,42,19,7,3,0,3,0,4,12,0,0,0,0,12
ACSSF,2010e5,wv,000,0034,0000391,070,54,017,07000US540179209499999,"Remainder of Maple district, Maple district, Doddridge County, West Virginia",267,183,62,0,10,52,121,84,0,0,0,0,0,0,84,23,0,0,23,61
ACSSF,2010e5,wv,000,0034,0000392,070,54,017,07000US540179237499999,"Oak district, Oak district, Doddridge County, West Virginia",459,404,73,0,21,52,331,55,23,23,15,0,8,0,32,22,0,0,22,10
ACSSF,2010e5,wv,000,0034,0000393,070,54,017,07000US540179246686116,"West Union town (part), Pine district, Doddridge County, West Virginia",108,81,31,4,2,25,50,27,9,5,5,0,0,4,18,11,0,0,11,7
ACSSF,2010e5,wv,000,0034,0000394,070,54,017,07000US540179246699999,"Remainder of Pine district, Pine district, Doddridge County, West Virginia",403,235,91,26,0,65,144,168,63,38,38,0,0,25,105,65,0,0,65,40
ACSSF,2010e5,wv,000,0034,0000395,070,54,019,07000US540199228001996,"Ansted town, New Haven district, Fayette County, West Virginia",445,364,128,42,20,66,236,81,17,3,0,0,3,14,64,40,14,4,22,24
ACSSF,2010e5,wv,000,0034,0000396,070,54,019,07000US540199228027028,"Fayetteville town (part), New Haven district, Fayette County, West Virginia",755,579,243,37,47,159,336,176,80,35,0,5,30,45,96,48,0,13,35,48
ACSSF,2010e5,wv,000,0034,0000397,070,54,019,07000US540199228037036,"Hico CDP, New Haven district, Fayette County, West Virginia",60,50,16,0,0,16,34,10,0,0,0,0,0,0,10,0,0,0,0,10
ACSSF,2010e5,wv,000,0034,0000398,070,54,019,07000US540199228052780,"Meadow Bridge town, New Haven district, Fayette County, West Virginia",93,69,11,3,5,3,58,24,0,0,0,0,0,0,24,15,0,7,8,9
ACSSF,2010e5,wv,000,0034,0000399,070,54,019,07000US540199228060028,"Oak Hill city (part), New Haven district, Fayette County, West Virginia",52,52,0,0,0,0,52,0,0,0,0,0,0,0,0,0,0,0,0,0
ACSSF,2010e5,wv,000,0034,0000400,070,54,019,07000US540199228065668,"Prince CDP, New Haven district, Fayette County, West Virginia",74,26,0,0,0,0,26,48,0,0,0,0,0,0,48,34,0,0,34,14
ACSSF,2010e5,wv,000,0034,0000401,070,54,019,07000US540199228099999,"Remainder of New Haven district, New Haven district, Fayette County, West Virginia",2687,2196,720,146,129,445,1476,491,139,54,40,0,14,85,352,166,22,62,82,186
ACSSF,2010e5,wv,000,0034,0000402,070,54,019,07000US540199247231876,"Glen Jean CDP, Plateau district, Fayette County, West Virginia",89,55,0,0,0,0,55,34,0,0,0,0,0,0,34,0,0,0,0,34
ACSSF,2010e5,wv,000,0034,0000403,070,54,019,07000US540199247237444,"Hilltop CDP, Plateau district, Fayette County, West Virginia",132,54,17,0,0,17,37,78,0,0,0,0,0,0,78,69,0,0,69,9
ACSSF,2010e5,wv,000,0034,0000404,070,54,019,07000US540199247254508,"Minden CDP, Plateau district, Fayette County, West Virginia",36,18,0,0,0,0,18,18,0,0,0,0,0,0,18,0,0,0,0,18
ACSSF,2010e5,wv,000,0034,0000405,070,54,019,07000US540199247256404,"Mount Hope city (part), Plateau district, Fayette County, West Virginia",361,232,78,14,21,43,154,129,29,12,0,0,12,17,100,58,33,0,25,42
ACSSF,2010e5,wv,000,0034,0000406,070,54,019,07000US540199247260028,"Oak Hill city (part), Plateau district, Fayette County, West Virginia",2252,1622,522,100,124,298,1100,630,202,94,83,0,11,108,428,211,25,33,153,217
ACSSF,2010e5,wv,000,0034,0000407,070,54,019,07000US540199247280284,"Thurmond town, Plateau district, Fayette County, West Virginia",2,2,0,0,0,0,2,0,0,0,0,0,0,0,0,0,0,0,0,0
ACSSF,2010e5,wv,000,0034,0000408,070,54,019,07000US540199247299999,"Remainder of Plateau district, Plateau district, Fayette County, West Virginia",1736,1378,415,87,56,272,963,358,111,34,8,0,26,77,247,128,7,0,121,119
ACSSF,2010e5,wv,000,0034,0000409,070,54,019,07000US540199339605068,"Beards Fork CDP, Valley district, Fayette County, West Virginia",52,36,0,0,0,0,36,16,0,0,0,0,0,0,16,0,0,0,0,16
ACSSF,2010e5,wv,000,0034,0000410,070,54,019,07000US540199339609100,"Boomer CDP, Valley district, Fayette County, West Virginia",235,138,36,0,9,27,102,97,66,34,17,0,17,32,31,0,0,0,0,31
ACSSF,2010e5,wv,000,0034,0000411,070,54,019,07000US540199339614630,"Charlton Heights CDP, Valley district, Fayette County, West Virginia",75,59,19,0,19,0,40,16,0,0,0,0,0,0,16,0,0,0,0,16
ACSSF,2010e5,wv,000,0034,0000412,070,54,019,07000US540199339620764,"Deep Water CDP, Valley district, Fayette County, West Virginia",35,13,13,0,0,13,0,22,12,0,0,0,0,12,10,10,0,0,10,0
ACSSF,2010e5,wv,000,0034,0000413,070,54,019,07000US540199339621628,"Dixie CDP (part), Valley district, Fayette County, West Virginia",40,40,0,0,0,0,40,0,0,0,0,0,0,0,0,0,0,0,0,0
ACSSF,2010e5,wv,000,0034,0000414,070,54,019,07000US540199339626812,"Falls View CDP, Valley district, Fayette County, West Virginia",42,25,0,0,0,0,25,17,17,0,0,0,0,17,0,0,0,0,0,0
ACSSF,2010e5,wv,000,0034,0000415,070,54,019,07000US540199339627028,"Fayetteville town (part), Valley district, Fayette County, West Virginia",0,0,0,0,0,0,0,0,0,0,0,0,0,0,0,0,0,0,0,0
ACSSF,2010e5,wv,000,0034,0000416,070,54,019,07000US540199339630364,"Gauley Bridge town, Valley district, Fayette County, West Virginia",175,102,27,0,3,24,75,73,9,0,0,0,0,9,64,42,11,6,25,22
ACSSF,2010e5,wv,000,0034,0000417,070,54,019,07000US540199339631732,"Glen Ferris CDP, Valley district, Fayette County, West Virginia",15,15,15,0,0,15,0,0,0,0,0,0,0,0,0,0,0,0,0,0
ACSSF,2010e5,wv,000,0034,0000418,070,54,019,07000US540199339643828,"Kimberly CDP, Valley district, Fayette County, West Virginia",90,68,15,0,0,15,53,22,22,0,0,0,0,22,0,0,0,0,0,0
ACSSF,2010e5,wv,000,0034,0000419,070,54,019,07000US540199339643852,"Kincaid CDP, Valley district, Fayette County, West Virginia",93,65,15,0,0,15,50,28,0,0,0,0,0,0,28,0,0,0,0,28
ACSSF,2010e5,wv,000,0034,0000420,070,54,019,07000US540199339655468,"Montgomery city (part), Valley district, Fayette County, West Virginia",169,70,28,3,10,15,42,99,9,3,3,0,0,6,90,31,7,10,14,59
ACSSF,2010e5,wv,000,0034,0000421,070,54,019,07000US540199339656212,"Mount Carbon CDP, Valley district, Fayette County, West Virginia",110,110,13,0,0,13,97,0,0,0,0,0,0,0,0,0,0,0,0,0
ACSSF,2010e5,wv,000,0034,0000422,070,54,019,07000US540199339656404,"Mount Hope city (part), Valley district, Fayette County, West Virginia",0,0,0,0,0,0,0,0,0,0,0,0,0,0,0,0,0,0,0,0
ACSSF,2010e5,wv,000,0034,0000423,070,54,019,07000US540199339660028,"Oak Hill city (part), Valley district, Fayette County, West Virginia",0,0,0,0,0,0,0,0,0,0,0,0,0,0,0,0,0,0,0,0
ACSSF,2010e5,wv,000,0034,0000424,070,54,019,07000US540199339661660,"Page CDP, Valley district, Fayette County, West Virginia",42,26,0,0,0,0,26,16,0,0,0,0,0,0,16,16,0,0,16,0
ACSSF,2010e5,wv,000,0034,0000425,070,54,019,07000US540199339662356,"Pax town, Valley district, Fayette County, West Virginia",37,29,12,2,0,10,17,8,0,0,0,0,0,0,8,6,2,0,4,2
ACSSF,2010e5,wv,000,0034,0000426,070,54,019,07000US540199339665284,"Powellton CDP, Valley district, Fayette County, West Virginia",144,130,29,15,0,14,101,14,0,0,0,0,0,0,14,0,0,0,0,14
ACSSF,2010e5,wv,000,0034,0000427,070,54,019,07000US540199339672292,"Scarbro CDP, Valley district, Fayette County, West Virginia",155,117,18,18,0,0,99,38,0,0,0,0,0,0,38,0,0,0,0,38
ACSSF,2010e5,wv,000,0034,0000428,070,54,019,07000US540199339674740,"Smithers city (part), Valley district, Fayette County, West Virginia",209,75,15,3,0,12,60,134,44,27,22,0,5,17,90,38,5,8,25,52
ACSSF,2010e5,wv,000,0034,0000429,070,54,019,07000US540199339699999,"Remainder of Valley district, Valley district, Fayette County, West Virginia",1852,1400,506,51,131,324,894,452,154,111,16,15,80,43,298,65,0,16,49,233
ACSSF,2010e5,wv,000,0034,0000430,070,54,021,07000US540219040899999,"Center district, Center district, Gilmer County, West Virginia",409,282,28,0,0,28,254,127,15,0,0,0,0,15,112,76,10,0,66,36
ACSSF,2010e5,wv,000,0034,0000431,070,54,021,07000US540219053432044,"Glenville town, City district, Gilmer County, West Virginia",325,189,104,13,17,74,85,136,25,8,0,0,8,17,111,41,3,23,15,70
ACSSF,2010e5,wv,000,0034,0000432,070,54,021,07000US540219053499999,"Remainder of City district, City district, Gilmer County, West Virginia",67,67,32,0,0,32,35,0,0,0,0,0,0,0,0,0,0,0,0,0
ACSSF,2010e5,wv,000,0034,0000433,070,54,021,07000US540219075899999,"De Kalb-Troy district, De Kalb-Troy district, Gilmer County, West Virginia",457,385,175,32,19,124,210,72,43,6,0,0,6,37,29,11,0,0,11,18
ACSSF,2010e5,wv,000,0034,0000434,070,54,021,07000US540219123671620,"Sand Fork town, Glenville district, Gilmer County, West Virginia",85,46,26,5,14,7,20,39,5,5,0,5,0,0,34,13,8,5,0,21
ACSSF,2010e5,wv,000,0034,0000435,070,54,021,07000US540219123699999,"Remainder of Glenville district, Glenville district, Gilmer County, West Virginia",206,186,30,20,0,10,156,20,0,0,0,0,0,0,20,0,0,0,0,20
ACSSF,2010e5,wv,000,0034,0000436,070,54,023,07000US540239129662956,"Petersburg city (part), Grant district, Grant County, West Virginia",0,0,0,0,0,0,0,0,0,0,0,0,0,0,0,0,0,0,0,0
ACSSF,2010e5,wv,000,0034,0000437,070,54,023,07000US540239129699999,"Remainder of Grant district, Grant district, Grant County, West Virginia",1116,958,366,157,33,176,592,158,0,0,0,0,0,0,158,105,60,14,31,53
ACSSF,2010e5,wv,000,0034,0000438,070,54,023,07000US540239220862956,"Petersburg city (part), Milroy district, Grant County, West Virginia",731,512,163,41,30,92,349,219,65,50,50,0,0,15,154,96,10,0,86,58
ACSSF,2010e5,wv,000,0034,0000439,070,54,023,07000US540239220899999,"Remainder of Milroy district, Milroy district, Grant County, West Virginia",517,363,86,21,16,49,277,154,83,54,0,0,54,29,71,71,20,0,51,0
ACSSF,2010e5,wv,000,0034,0000440,070,54,023,07000US540239321604924,"Bayard town, Union district, Grant County, West Virginia",110,90,43,10,0,33,47,20,4,4,0,0,4,0,16,8,8,0,0,8
ACSSF,2010e5,wv,000,0034,0000441,070,54,023,07000US540239321699999,"Remainder of Union district, Union district, Grant County, West Virginia",977,866,250,54,93,103,616,111,32,0,0,0,0,32,79,41,13,0,28,38
ACSSF,2010e5,wv,000,0034,0000442,070,54,025,07000US540259044926428,"Fairlea CDP, Central district, Greenbrier County, West Virginia",614,460,200,96,66,38,260,154,43,0,0,0,0,43,111,42,0,42,0,69
ACSSF,2010e5,wv,000,0034,0000443,070,54,025,07000US540259044946636,"Lewisburg city, Central district, Greenbrier County, West Virginia",996,891,274,97,48,129,617,105,38,0,0,0,0,38,67,28,0,0,28,39
ACSSF,2010e5,wv,000,0034,0000444,070,54,025,07000US540259044970156,"Ronceverte city (part), Central district, Greenbrier County, West Virginia",178,136,40,7,10,23,96,42,3,3,0,0,3,0,39,17,9,0,8,22
ACSSF,2010e5,wv,000,0034,0000445,070,54,025,07000US540259044999999,"Remainder of Central district, Central district, Greenbrier County, West Virginia",1773,1331,498,50,117,331,833,442,78,35,35,0,0,43,364,194,65,0,129,170
ACSSF,2010e5,wv,000,0034,0000446,070,54,025,07000US540259097200772,"Alderson town (part), Eastern district, Greenbrier County, West Virginia",280,156,47,21,11,15,109,124,48,45,41,0,4,3,76,43,25,5,13,33
ACSSF,2010e5,wv,000,0034,0000447,070,54,025,07000US540259097226692,"Falling Spring town, Eastern district, Greenbrier County, West Virginia",51,45,11,0,4,7,34,6,3,3,0,3,0,0,3,0,0,0,0,3
ACSSF,2010e5,wv,000,0034,0000448,070,54,025,07000US540259097270156,"Ronceverte city (part), Eastern district, Greenbrier County, West Virginia",280,212,69,23,20,26,143,68,18,3,0,0,3,15,50,17,3,3,11,33
ACSSF,2010e5,wv,000,0034,0000449,070,54,025,07000US540259097286812,"White Sulphur Springs city, Eastern district, Greenbrier County, West Virginia",747,455,127,22,46,59,328,292,107,83,0,21,62,24,185,117,38,36,43,68
ACSSF,2010e5,wv,000,0034,0000450,070,54,025,07000US540259097299999,"Remainder of Eastern district, Eastern district, Greenbrier County, West Virginia",1949,1473,399,107,39,253,1074,476,112,31,0,0,31,81,364,176,28,15,133,188
ACSSF,2010e5,wv,000,0034,0000451,070,54,025,07000US540259360166412,"Quinwood town, Western district, Greenbrier County, West Virginia",93,65,13,0,0,13,52,28,14,10,6,0,4,4,14,10,0,0,10,4
ACSSF,2010e5,wv,000,0034,0000452,070,54,025,07000US540259360166652,"Rainelle town, Western district, Greenbrier County, West Virginia",431,310,119,69,0,50,191,121,30,0,0,0,0,30,91,48,18,23,7,43
ACSSF,2010e5,wv,000,0034,0000453,070,54,025,07000US540259360170828,"Rupert town, Western district, Greenbrier County, West Virginia",281,167,50,16,3,31,117,114,25,15,0,0,15,10,89,67,8,0,59,22
ACSSF,2010e5,wv,000,0034,0000454,070,54,025,07000US540259360199999,"Remainder of Western district, Western district, Greenbrier County, West Virginia",2304,1804,632,150,154,328,1172,500,198,82,11,0,71,116,302,146,0,0,146,156
ACSSF,2010e5,wv,000,0034,0000455,070,54,027,07000US540279020413108,"Capon Bridge town (part), Bloomery district, Hampshire County, West Virginia",12,11,4,4,0,0,7,1,0,0,0,0,0,0,1,0,0,0,0,1
ACSSF,2010e5,wv,000,0034,0000456,070,54,027,07000US540279020499999,"Remainder of Bloomery district, Bloomery district, Hampshire County, West Virginia",725,581,180,22,17,141,401,144,131,115,0,0,115,16,13,0,0,0,0,13
ACSSF,2010e5,wv,000,0034,0000457,070,54,027,07000US540279036013108,"Capon Bridge town (part), Capon district, Hampshire County, West Virginia",91,44,18,7,6,5,26,47,0,0,0,0,0,0,47,32,0,0,32,15
ACSSF,2010e5,wv,000,0034,0000458,070,54,027,07000US540279036099999,"Remainder of Capon district, Capon district, Hampshire County, West Virginia",513,414,120,0,21,99,294,99,26,14,0,0,14,12,73,47,0,0,47,26
ACSSF,2010e5,wv,000,0034,0000459,070,54,027,07000US540279124899999,"Gore district, Gore district, Hampshire County, West Virginia",1157,867,231,18,26,187,636,290,77,54,16,0,38,23,213,76,0,0,76,137
ACSSF,2010e5,wv,000,0034,0000460,070,54,027,07000US540279218499999,"Mill Creek district, Mill Creek district, Hampshire County, West Virginia",348,294,76,30,0,46,218,54,6,0,0,0,0,6,48,31,13,18,0,17
ACSSF,2010e5,wv,000,0034,0000461,070,54,027,07000US540279267670084,"Romney city, Romney district, Hampshire County, West Virginia",388,287,88,26,16,46,199,101,18,8,0,0,8,10,83,30,0,0,30,53
ACSSF,2010e5,wv,000,0034,0000462,070,54,027,07000US540279267699999,"Remainder of Romney district, Romney district, Hampshire County, West Virginia",502,333,99,0,19,80,234,169,11,0,0,0,0,11,158,106,11,21,74,52
ACSSF,2010e5,wv,000,0034,0000463,070,54,027,07000US540279282099999,"Sherman district, Sherman district, Hampshire County, West Virginia",1275,941,421,73,177,171,520,334,92,0,0,0,0,92,242,193,33,36,124,49
ACSSF,2010e5,wv,000,0034,0000464,070,54,027,07000US540279298833436,"Green Spring CDP, Springfield district, Hampshire County, West Virginia",43,43,13,0,0,13,30,0,0,0,0,0,0,0,0,0,0,0,0,0
ACSSF,2010e5,wv,000,0034,0000465,070,54,027,07000US540279298876084,"Springfield CDP, Springfield district, Hampshire County, West Virginia",172,140,50,38,12,0,90,32,0,0,0,0,0,0,32,0,0,0,0,32
ACSSF,2010e5,wv,000,0034,0000466,070,54,027,07000US540279298899999,"Remainder of Springfield district, Springfield district, Hampshire County, West Virginia",578,395,141,0,16,125,254,183,18,0,0,0,0,18,165,115,0,19,96,50
ACSSF,2010e5,wv,000,0034,0000467,070,54,029,07000US540299031285156,"Weirton city (part), Butler district, Hancock County, West Virginia",3043,2296,683,138,148,397,1613,747,174,66,17,0,49,108,573,338,0,112,226,235
ACSSF,2010e5,wv,000,0034,0000468,070,54,029,07000US540299054058372,"New Cumberland city, Clay district, Hancock County, West Virginia",346,227,78,24,12,42,149,119,53,47,0,16,31,6,66,24,3,0,21,42
ACSSF,2010e5,wv,000,0034,0000469,070,54,029,07000US540299054085156,"Weirton city (part), Clay district, Hancock County, West Virginia",1428,865,345,121,80,144,520,563,170,103,66,0,37,67,393,183,67,32,84,210
ACSSF,2010e5,wv,000,0034,0000470,070,54,029,07000US540299054099999,"Remainder of Clay district, Clay district, Hancock County, West Virginia",1062,913,321,37,91,193,592,149,88,0,0,0,0,88,61,8,0,0,8,53
ACSSF,2010e5,wv,000,0034,0000471,070,54,029,07000US540299130815076,"Chester city, Grant district, Hancock County, West Virginia",666,539,213,40,41,132,326,127,54,54,9,0,45,0,73,37,5,16,16,36
ACSSF,2010e5,wv,000,0034,0000472,070,54,029,07000US540299130858420,"Newell CDP, Grant district, Hancock County, West Virginia",312,218,53,27,0,26,165,94,29,29,0,0,29,0,65,48,0,0,48,17
ACSSF,2010e5,wv,000,0034,0000473,070,54,029,07000US540299130899999,"Remainder of Grant district, Grant district, Hancock County, West Virginia",2025,1708,553,137,126,290,1155,317,72,55,34,0,21,17,245,92,0,20,72,153
ACSSF,2010e5,wv,000,0034,0000474,070,54,031,07000US540319037284580,"Wardensville town, Capon district, Hardy County, West Virginia",93,74,22,4,0,18,52,19,6,6,4,0,2,0,13,13,0,4,9,0
ACSSF,2010e5,wv,000,0034,0000475,070,54,031,07000US540319037299999,"Remainder of Capon district, Capon district, Hardy County, West Virginia",586,499,92,10,14,68,407,87,22,22,0,0,22,0,65,36,17,19,0,29
ACSSF,2010e5,wv,000,0034,0000476,070,54,031,07000US540319196899999,"Lost River district, Lost River district, Hardy County, West Virginia",595,471,40,10,0,30,431,124,36,13,13,0,0,23,88,25,0,0,25,63
ACSSF,2010e5,wv,000,0034,0000477,070,54,031,07000US540319223255588,"Moorefield town (part), Moorefield district, Hardy County, West Virginia",354,255,55,7,0,48,200,99,13,0,0,0,0,13,86,64,6,8,50,22
ACSSF,2010e5,wv,000,0034,0000478,070,54,031,07000US540319223299999,"Remainder of Moorefield district, Moorefield district, Hardy County, West Virginia",98,48,16,0,16,0,32,50,25,0,0,0,0,25,25,0,0,0,0,25
ACSSF,2010e5,wv,000,0034,0000479,070,54,031,07000US540319238255588,"Moorefield town (part), Old Fields district, Hardy County, West Virginia",160,102,11,0,7,4,91,58,5,0,0,0,0,5,53,39,0,30,9,14
ACSSF,2010e5,wv,000,0034,0000480,070,54,031,07000US540319238299999,"Remainder of Old Fields district, Old Fields district, Hardy County, West Virginia",503,419,64,0,37,27,355,84,14,0,0,0,0,14,70,54,16,18,20,16
ACSSF,2010e5,wv,000,0034,0000481,070,54,031,07000US540319292855588,"Moorefield town (part), South Fork district, Hardy County, West Virginia",0,0,0,0,0,0,0,0,0,0,0,0,0,0,0,0,0,0,0,0
ACSSF,2010e5,wv,000,0034,0000482,070,54,031,07000US540319292899999,"Remainder of South Fork district, South Fork district, Hardy County, West Virginia",627,569,195,37,41,117,374,58,27,18,0,0,18,9,31,31,16,0,15,0
ACSSF,2010e5,wv,000,0034,0000483,070,54,033,07000US540339097501900,"Anmoore town (part), Eastern district, Harrison County, West Virginia",32,17,6,0,0,6,11,15,0,0,0,0,0,0,15,0,0,0,0,15
ACSSF,2010e5,wv,000,0034,0000484,070,54,033,07000US540339097510180,"Bridgeport city (part), Eastern district, Harrison County, West Virginia",2154,1763,608,95,131,382,1155,391,137,91,17,0,74,46,254,111,0,22,89,143
ACSSF,2010e5,wv,000,0034,0000485,070,54,033,07000US540339097515628,"Clarksburg city (part), Eastern district, Harrison County, West Virginia",6,0,0,0,0,0,0,6,6,0,0,0,0,6,0,0,0,0,0,0
ACSSF,2010e5,wv,000,0034,0000486,070,54,033,07000US540339097521316,"Despard CDP (part), Eastern district, Harrison County, West Virginia",198,110,39,0,27,12,71,88,0,0,0,0,0,0,88,46,0,0,46,42
ACSSF,2010e5,wv,000,0034,0000487,070,54,033,07000US540339097536628,"Hepzibah CDP, Eastern district, Harrison County, West Virginia",192,179,49,0,21,28,130,13,13,13,13,0,0,0,0,0,0,0,0,0
ACSSF,2010e5,wv,000,0034,0000488,070,54,033,07000US540339097575796,"Spelter CDP, Eastern district, Harrison County, West Virginia",88,61,30,21,0,9,31,27,0,0,0,0,0,0,27,0,0,0,0,27
ACSSF,2010e5,wv,000,0034,0000489,070,54,033,07000US540339097599999,"Remainder of Eastern district, Eastern district, Harrison County, West Virginia",837,575,248,44,35,169,327,262,20,11,0,0,11,9,242,119,0,7,112,123
ACSSF,2010e5,wv,000,0034,0000490,070,54,033,07000US540339235210180,"Bridgeport city (part), Northern district, Harrison County, West Virginia",20,20,0,0,0,0,20,0,0,0,0,0,0,0,0,0,0,0,0,0
ACSSF,2010e5,wv,000,0034,0000491,070,54,033,07000US540339235225516,"Enterprise CDP, Northern district, Harrison County, West Virginia",343,222,54,0,20,34,168,121,24,0,0,0,0,24,97,19,19,0,0,78
ACSSF,2010e5,wv,000,0034,0000492,070,54,033,07000US540339235234180,"Gypsy CDP, Northern district, Harrison County, West Virginia",18,0,0,0,0,0,0,18,0,0,0,0,0,0,18,0,0,0,0,18
ACSSF,2010e5,wv,000,0034,0000493,070,54,033,07000US540339235249252,"Lumberport town (part), Northern district, Harrison County, West Virginia",259,193,62,16,0,46,131,66,14,10,0,5,5,4,52,17,0,4,13,35
ACSSF,2010e5,wv,000,0034,0000494,070,54,033,07000US540339235273636,"Shinnston city, Northern district, Harrison County, West Virginia",682,523,172,9,56,107,351,159,24,11,0,0,11,13,135,27,17,10,0,108
ACSSF,2010e5,wv,000,0034,0000495,070,54,033,07000US540339235299999,"Remainder of Northern district, Northern district, Harrison County, West Virginia",1838,1509,509,110,93,306,1000,329,111,41,0,0,41,70,218,152,36,8,108,66
ACSSF,2010e5,wv,000,0034,0000496,070,54,033,07000US540339236815628,"Clarksburg city (part), North Urban district, Harrison County, West Virginia",1758,1116,392,115,63,214,724,642,84,36,12,0,24,48,558,300,66,83,151,258
ACSSF,2010e5,wv,000,0034,0000497,070,54,033,07000US540339236821316,"Despard CDP (part), North Urban district, Harrison County, West Virginia",18,10,0,0,0,0,10,8,0,0,0,0,0,0,8,0,0,0,0,8
ACSSF,2010e5,wv,000,0034,0000498,070,54,033,07000US540339236849252,"Lumberport town (part), North Urban district, Harrison County, West Virginia",59,7,3,3,0,0,4,52,15,15,15,0,0,0,37,36,4,0,32,1
ACSSF,2010e5,wv,000,0034,0000499,070,54,033,07000US540339236899999,"Remainder of North Urban district, North Urban district, Harrison County, West Virginia",971,670,217,51,76,90,453,301,107,0,0,0,0,107,194,135,35,53,47,59
ACSSF,2010e5,wv,000,0034,0000500,070,54,033,07000US540339292301900,"Anmoore town (part), Southern district, Harrison County, West Virginia",270,140,82,55,6,21,58,130,29,19,0,0,19,10,101,87,0,0,87,14
ACSSF,2010e5,wv,000,0034,0000501,070,54,033,07000US540339292310180,"Bridgeport city (part), Southern district, Harrison County, West Virginia",132,117,54,0,30,24,63,15,0,0,0,0,0,0,15,0,0,0,0,15
ACSSF,2010e5,wv,000,0034,0000502,070,54,033,07000US540339292315628,"Clarksburg city (part), Southern district, Harrison County, West Virginia",323,161,30,30,0,0,131,162,62,24,0,0,24,38,100,81,27,0,54,19
ACSSF,2010e5,wv,000,0034,0000503,070,54,033,07000US540339292348748,"Lost Creek town, Southern district, Harrison County, West Virginia",133,76,27,0,6,21,49,57,4,4,4,0,0,0,53,29,4,7,18,24
ACSSF,2010e5,wv,000,0034,0000504,070,54,033,07000US540339292359836,"Nutter Fort town, Southern district, Harrison County, West Virginia",455,357,93,17,0,76,264,98,26,19,0,0,19,7,72,26,0,0,26,46
ACSSF,2010e5,wv,000,0034,0000505,070,54,033,07000US540339292377188,"Stonewood city, Southern district, Harrison County, West Virginia",596,432,121,24,37,60,311,164,13,0,0,0,0,13,151,66,8,0,58,85
ACSSF,2010e5,wv,000,0034,0000506,070,54,033,07000US540339292399999,"Remainder of Southern district, Southern district, Harrison County, West Virginia",1962,1671,610,113,63,434,1061,291,87,19,0,0,19,68,204,129,46,0,83,75
ACSSF,2010e5,wv,000,0034,0000507,070,54,033,07000US540339293215628,"Clarksburg city (part), South Urban district, Harrison County, West Virginia",2070,1509,634,122,96,416,875,561,131,98,0,15,83,33,430,185,105,14,66,245
ACSSF,2010e5,wv,000,0034,0000508,070,54,033,07000US540339293299999,"Remainder of South Urban district, South Urban district, Harrison County, West Virginia",834,633,247,25,57,165,386,201,0,0,0,0,0,0,201,83,18,0,65,118
ACSSF,2010e5,wv,000,0034,0000509,070,54,033,07000US540339295271380,"Salem city, Southwest district, Harrison County, West Virginia",389,269,77,22,7,48,192,120,27,11,7,0,4,16,93,72,18,5,49,21
ACSSF,2010e5,wv,000,0034,0000510,070,54,033,07000US540339295285924,"West Milford town, Southwest district, Harrison County, West Virginia",323,229,87,7,6,74,142,94,16,5,0,0,5,11,78,49,15,0,34,29
ACSSF,2010e5,wv,000,0034,0000511,070,54,033,07000US540339295288276,"Wolf Summit CDP, Southwest district, Harrison County, West Virginia",67,67,16,0,16,0,51,0,0,0,0,0,0,0,0,0,0,0,0,0
ACSSF,2010e5,wv,000,0034,0000512,070,54,033,07000US540339295299999,"Remainder of Southwest district, Southwest district, Harrison County, West Virginia",1941,1630,595,84,84,427,1035,311,56,26,0,0,26,30,255,142,64,0,78,113
ACSSF,2010e5,wv,000,0034,0000513,070,54,035,07000US540359097668596,"Ripley city (part), Eastern district, Jackson County, West Virginia",730,646,260,118,34,108,386,84,17,17,17,0,0,0,67,37,11,0,26,30
ACSSF,2010e5,wv,000,0034,0000514,070,54,035,07000US540359097699999,"Remainder of Eastern district, Eastern district, Jackson County, West Virginia",2037,1593,680,106,120,454,913,444,185,120,49,36,35,65,259,139,35,24,80,120
ACSSF,2010e5,wv,000,0034,0000515,070,54,035,07000US540359235367108,"Ravenswood city, Northern district, Jackson County, West Virginia",1033,769,251,47,65,139,518,264,59,34,17,0,17,25,205,157,22,0,135,48
ACSSF,2010e5,wv,000,0034,0000516,070,54,035,07000US540359235399999,"Remainder of Northern district, Northern district, Jackson County, West Virginia",1532,1298,390,60,96,234,908,234,92,59,36,0,23,33,142,112,42,0,70,30
ACSSF,2010e5,wv,000,0034,0000517,070,54,035,07000US540359360568596,"Ripley city (part), Western district, Jackson County, West Virginia",103,45,0,0,0,0,45,58,42,42,0,0,42,0,16,0,0,0,0,16
ACSSF,2010e5,wv,000,0034,0000518,070,54,035,07000US540359360599999,"Remainder of Western district, Western district, Jackson County, West Virginia",2979,2371,865,211,220,434,1506,608,150,121,0,0,121,29,458,168,0,26,142,290
ACSSF,2010e5,wv,000,0034,0000519,070,54,037,07000US540379050414610,"Charles Town city (part), Charles Town district, Jefferson County, West Virginia",982,809,453,161,100,192,356,173,67,40,0,0,40,27,106,0,0,0,0,106
ACSSF,2010e5,wv,000,0034,0000520,070,54,037,07000US540379050466988,"Ranson corporation (part), Charles Town district, Jefferson County, West Virginia",1017,570,245,67,90,88,325,447,112,16,16,0,0,96,335,212,65,37,110,123
ACSSF,2010e5,wv,000,0034,0000521,070,54,037,07000US540379050499999,"Remainder of Charles Town district, Charles Town district, Jefferson County, West Virginia",871,667,343,51,104,188,324,204,91,61,6,0,55,30,113,76,12,0,64,37
ACSSF,2010e5,wv,000,0034,0000522,070,54,037,07000US540379154808932,"Bolivar town, Harpers Ferry district, Jefferson County, West Virginia",197,162,59,5,9,45,103,35,3,0,0,0,0,3,32,11,3,0,8,21
ACSSF,2010e5,wv,000,0034,0000523,070,54,037,07000US540379154814610,"Charles Town city (part), Harpers Ferry district, Jefferson County, West Virginia",0,0,0,0,0,0,0,0,0,0,0,0,0,0,0,0,0,0,0,0
ACSSF,2010e5,wv,000,0034,0000524,070,54,037,07000US540379154835284,"Harpers Ferry town, Harpers Ferry district, Jefferson County, West Virginia",60,60,14,9,0,5,46,0,0,0,0,0,0,0,0,0,0,0,0,0
ACSSF,2010e5,wv,000,0034,0000525,070,54,037,07000US540379154866988,"Ranson corporation (part), Harpers Ferry district, Jefferson County, West Virginia",89,75,33,17,0,16,42,14,14,14,0,0,14,0,0,0,0,0,0,0
ACSSF,2010e5,wv,000,0034,0000526,070,54,037,07000US540379154873444,"Shenandoah Junction CDP (part), Harpers Ferry district, Jefferson County, West Virginia",170,114,37,26,0,11,77,56,16,0,0,0,0,16,40,40,0,10,30,0
ACSSF,2010e5,wv,000,0034,0000527,070,54,037,07000US540379154899999,"Remainder of Harpers Ferry district, Harpers Ferry district, Jefferson County, West Virginia",2029,1822,733,175,208,350,1089,207,55,0,0,0,0,55,152,77,0,0,77,75
ACSSF,2010e5,wv,000,0034,0000528,070,54,037,07000US540379174014610,"Charles Town city (part), Kabletown district, Jefferson County, West Virginia",160,122,98,28,15,55,24,38,17,0,0,0,0,17,21,0,0,0,0,21
ACSSF,2010e5,wv,000,0034,0000529,070,54,037,07000US540379174073252,"Shannondale CDP, Kabletown district, Jefferson County, West Virginia",697,646,311,77,33,201,335,51,17,17,0,17,0,0,34,34,0,0,34,0
ACSSF,2010e5,wv,000,0034,0000530,070,54,037,07000US540379174099999,"Remainder of Kabletown district, Kabletown district, Jefferson County, West Virginia",2426,1994,895,222,172,501,1099,432,159,111,101,0,10,48,273,170,64,9,97,103
ACSSF,2010e5,wv,000,0034,0000531,070,54,037,07000US540379216014610,"Charles Town city (part), Middleway district, Jefferson County, West Virginia",0,0,0,0,0,0,0,0,0,0,0,0,0,0,0,0,0,0,0,0
ACSSF,2010e5,wv,000,0034,0000532,070,54,037,07000US540379216053692,"Middleway CDP, Middleway district, Jefferson County, West Virginia",51,40,9,0,0,9,31,11,0,0,0,0,0,0,11,0,0,0,0,11
ACSSF,2010e5,wv,000,0034,0000533,070,54,037,07000US540379216066988,"Ranson corporation (part), Middleway district, Jefferson County, West Virginia",14,0,0,0,0,0,0,14,0,0,0,0,0,0,14,14,0,14,0,0
ACSSF,2010e5,wv,000,0034,0000534,070,54,037,07000US540379216073444,"Shenandoah Junction CDP (part), Middleway district, Jefferson County, West Virginia",0,0,0,0,0,0,0,0,0,0,0,0,0,0,0,0,0,0,0,0
ACSSF,2010e5,wv,000,0034,0000535,070,54,037,07000US540379216099999,"Remainder of Middleway district, Middleway district, Jefferson County, West Virginia",2615,2033,730,150,87,493,1303,582,190,68,0,0,68,122,392,171,34,56,81,221
ACSSF,2010e5,wv,000,0034,0000536,070,54,037,07000US540379276073444,"Shenandoah Junction CDP (part), Shepherdstown district, Jefferson County, West Virginia",0,0,0,0,0,0,0,0,0,0,0,0,0,0,0,0,0,0,0,0
ACSSF,2010e5,wv,000,0034,0000537,070,54,037,07000US540379276073468,"Shepherdstown town, Shepherdstown district, Jefferson County, West Virginia",157,109,43,3,6,34,66,48,14,3,0,0,3,11,34,11,4,0,7,23
ACSSF,2010e5,wv,000,0034,0000538,070,54,037,07000US540379276099999,"Remainder of Shepherdstown district, Shepherdstown district, Jefferson County, West Virginia",2055,1924,730,184,209,337,1194,131,95,24,24,0,0,71,36,24,0,11,13,12
ACSSF,2010e5,wv,000,0034,0000539,070,54,039,07000US540399076805836,"Belle town, District 1, Kanawha County, West Virginia",326,200,47,5,18,24,153,126,21,19,3,0,16,2,105,52,0,6,46,53
ACSSF,2010e5,wv,000,0034,0000540,070,54,039,07000US540399076813924,"Cedar Grove town, District 1, Kanawha County, West Virginia",253,155,38,7,12,19,117,98,23,15,0,0,15,8,75,41,7,20,14,34
ACSSF,2010e5,wv,000,0034,0000541,070,54,039,07000US540399076814600,"Charleston city (part), District 1, Kanawha County, West Virginia",3633,2687,988,271,128,589,1699,946,189,58,40,0,18,131,757,368,153,67,148,389
ACSSF,2010e5,wv,000,0034,0000542,070,54,039,07000US540399076814812,"Chelyan CDP, District 1, Kanawha County, West Virginia",112,77,0,0,0,0,77,35,0,0,0,0,0,0,35,18,0,0,18,17
ACSSF,2010e5,wv,000,0034,0000543,070,54,039,07000US540399076815028,"Chesapeake town, District 1, Kanawha County, West Virginia",448,305,124,56,11,57,181,143,43,18,9,0,9,25,100,45,0,4,41,55
ACSSF,2010e5,wv,000,0034,0000544,070,54,039,07000US540399076816612,"Coal Fork CDP (part), District 1, Kanawha County, West Virginia",343,299,62,8,0,54,237,44,0,0,0,0,0,0,44,25,25,0,0,19
ACSSF,2010e5,wv,000,0034,0000545,070,54,039,07000US540399076823092,"East Bank town, District 1, Kanawha County, West Virginia",303,176,40,16,0,24,136,127,33,20,15,0,5,13,94,65,9,33,23,29
ACSSF,2010e5,wv,000,0034,0000546,070,54,039,07000US540399076831324,"Glasgow town, District 1, Kanawha County, West Virginia",180,150,55,13,18,24,95,30,10,0,0,0,0,10,20,13,4,9,0,7
ACSSF,2010e5,wv,000,0034,0000547,070,54,039,07000US540399076834756,"Handley town, District 1, Kanawha County, West Virginia",47,34,12,2,4,6,22,13,2,0,0,0,0,2,11,3,3,0,0,8
ACSSF,2010e5,wv,000,0034,0000548,070,54,039,07000US540399076851724,"Marmet city, District 1, Kanawha County, West Virginia",454,328,118,16,8,94,210,126,36,4,0,0,4,32,90,54,13,11,30,36
ACSSF,2010e5,wv,000,0034,0000549,070,54,039,07000US540399076855468,"Montgomery city (part), District 1, Kanawha County, West Virginia",179,105,56,0,0,56,49,74,9,4,2,0,2,5,65,50,29,7,14,15
ACSSF,2010e5,wv,000,0034,0000550,070,54,039,07000US540399076865356,"Pratt town, District 1, Kanawha County, West Virginia",145,101,42,9,5,28,59,44,10,5,0,0,5,5,34,8,0,0,8,26
ACSSF,2010e5,wv,000,0034,0000551,070,54,039,07000US540399076866892,"Rand CDP, District 1, Kanawha County, West Virginia",394,218,22,0,12,10,196,176,35,16,16,0,0,19,141,92,10,49,33,49
ACSSF,2010e5,wv,000,0034,0000552,070,54,039,07000US540399076873876,"Shrewsbury CDP, District 1, Kanawha County, West Virginia",229,200,76,0,55,21,124,29,0,0,0,0,0,0,29,0,0,0,0,29
ACSSF,2010e5,wv,000,0034,0000553,070,54,039,07000US540399076874740,"Smithers city (part), District 1, Kanawha County, West Virginia",0,0,0,0,0,0,0,0,0,0,0,0,0,0,0,0,0,0,0,0
ACSSF,2010e5,wv,000,0034,0000554,070,54,039,07000US540399076899999,"District Remainder of 1, District 1, Kanawha County, West Virginia",3961,3024,872,86,162,624,2152,937,251,63,0,0,63,188,686,372,37,56,279,314
ACSSF,2010e5,wv,000,0034,0000555,070,54,039,07000US540399080401396,"Alum Creek CDP (part), District 2, Kanawha County, West Virginia",71,59,7,0,0,7,52,12,12,12,0,12,0,0,0,0,0,0,0,0
ACSSF,2010e5,wv,000,0034,0000556,070,54,039,07000US540399080414600,"Charleston city (part), District 2, Kanawha County, West Virginia",5311,4065,1589,344,272,973,2476,1246,322,237,62,13,162,85,924,529,160,91,278,395
ACSSF,2010e5,wv,000,0034,0000557,070,54,039,07000US540399080422564,"Dunbar city (part), District 2, Kanawha County, West Virginia",2139,1435,418,94,61,263,1017,704,100,18,9,0,9,82,604,309,73,41,195,295
ACSSF,2010e5,wv,000,0034,0000558,070,54,039,07000US540399080441010,"Jefferson CDP (part), District 2, Kanawha County, West Virginia",104,51,12,9,3,0,39,53,0,0,0,0,0,0,53,41,3,15,23,12
ACSSF,2010e5,wv,000,0034,0000559,070,54,039,07000US540399080471212,"St. Albans city (part), District 2, Kanawha County, West Virginia",20,20,0,0,0,0,20,0,0,0,0,0,0,0,0,0,0,0,0,0
ACSSF,2010e5,wv,000,0034,0000560,070,54,039,07000US540399080475292,"South Charleston city, District 2, Kanawha County, West Virginia",3678,2563,782,222,125,435,1781,1115,187,64,7,0,57,123,928,502,155,63,284,426
ACSSF,2010e5,wv,000,0034,0000561,070,54,039,07000US540399080499999,"District Remainder of 2, District 2, Kanawha County, West Virginia",2210,1824,759,164,148,447,1065,386,122,51,0,27,24,71,264,127,23,0,104,137
ACSSF,2010e5,wv,000,0034,0000562,070,54,039,07000US540399084019108,"Cross Lanes CDP, District 3, Kanawha County, West Virginia",2496,2024,675,178,98,399,1349,472,111,59,48,0,11,52,361,202,82,11,109,159
ACSSF,2010e5,wv,000,0034,0000563,070,54,039,07000US540399084022564,"Dunbar city (part), District 3, Kanawha County, West Virginia",0,0,0,0,0,0,0,0,0,0,0,0,0,0,0,0,0,0,0,0
ACSSF,2010e5,wv,000,0034,0000564,070,54,039,07000US540399084041010,"Jefferson CDP (part), District 3, Kanawha County, West Virginia",0,0,0,0,0,0,0,0,0,0,0,0,0,0,0,0,0,0,0,0
ACSSF,2010e5,wv,000,0034,0000565,070,54,039,07000US540399084059068,"Nitro city (part), District 3, Kanawha County, West Virginia",1529,1105,442,121,197,124,663,424,183,125,48,0,77,58,241,141,13,11,117,100
ACSSF,2010e5,wv,000,0034,0000566,070,54,039,07000US540399084071212,"St. Albans city (part), District 3, Kanawha County, West Virginia",2917,2180,675,124,93,458,1505,737,254,173,9,0,164,81,483,257,44,21,192,226
ACSSF,2010e5,wv,000,0034,0000567,070,54,039,07000US540399084074356,"Sissonville CDP (part), District 3, Kanawha County, West Virginia",191,191,100,0,13,87,91,0,0,0,0,0,0,0,0,0,0,0,0,0
ACSSF,2010e5,wv,000,0034,0000568,070,54,039,07000US540399084082180,"Upper Falls CDP, District 3, Kanawha County, West Virginia",1067,884,313,54,48,211,571,183,23,0,0,0,0,23,160,108,20,35,53,52
ACSSF,2010e5,wv,000,0034,0000569,070,54,039,07000US540399084099999,"District Remainder of 3, District 3, Kanawha County, West Virginia",5333,4030,1409,265,337,807,2621,1303,345,160,39,0,121,185,958,539,102,133,304,419
ACSSF,2010e5,wv,000,0034,0000570,070,54,039,07000US540399087607204,"Big Chimney CDP, District 4, Kanawha County, West Virginia",179,179,14,0,0,14,165,0,0,0,0,0,0,0,0,0,0,0,0,0
ACSSF,2010e5,wv,000,0034,0000571,070,54,039,07000US540399087614600,"Charleston city (part), District 4, Kanawha County, West Virginia",3383,2065,617,140,121,356,1448,1318,253,140,0,63,77,113,1065,680,233,75,372,385
ACSSF,2010e5,wv,000,0034,0000572,070,54,039,07000US540399087616012,"Clendenin town, District 4, Kanawha County, West Virginia",340,246,89,29,11,49,157,94,7,0,0,0,0,7,87,48,7,14,27,39
ACSSF,2010e5,wv,000,0034,0000573,070,54,039,07000US540399087616612,"Coal Fork CDP (part), District 4, Kanawha County, West Virginia",0,0,0,0,0,0,0,0,0,0,0,0,0,0,0,0,0,0,0,0
ACSSF,2010e5,wv,000,0034,0000574,070,54,039,07000US540399087624748,"Elkview CDP, District 4, Kanawha County, West Virginia",408,346,100,22,20,58,246,62,12,0,0,0,0,12,50,0,0,0,0,50
ACSSF,2010e5,wv,000,0034,0000575,070,54,039,07000US540399087663772,"Pinch CDP, District 4, Kanawha County, West Virginia",884,769,240,77,74,89,529,115,10,10,10,0,0,0,105,38,0,0,38,67
ACSSF,2010e5,wv,000,0034,0000576,070,54,039,07000US540399087674356,"Sissonville CDP (part), District 4, Kanawha County, West Virginia",1268,1001,301,84,49,168,700,267,37,25,0,8,17,12,230,116,10,34,72,114
ACSSF,2010e5,wv,000,0034,0000577,070,54,039,07000US540399087699999,"District Remainder of 4, District 4, Kanawha County, West Virginia",6529,5422,1649,335,310,1004,3773,1107,304,192,42,0,150,112,803,401,151,21,229,402
ACSSF,2010e5,wv,000,0034,0000578,070,54,041,07000US540419067685972,"Weston city (part), Courthouse-Collins Settlement district, Lewis County, West Virginia",630,466,155,47,16,92,311,164,42,42,13,10,19,0,122,97,9,11,77,25
ACSSF,2010e5,wv,000,0034,0000579,070,54,041,07000US540419067699999,"Remainder of Courthouse-Collins Settlement district, Courthouse-Collins Settlement district, Lewis County, West Virginia",721,572,169,19,18,132,403,149,43,19,0,0,19,24,106,69,22,0,47,37
ACSSF,2010e5,wv,000,0034,0000580,070,54,041,07000US540419117685972,"Weston city (part), Freemans Creek district, Lewis County, West Virginia",298,239,107,10,6,91,132,59,9,0,0,0,0,9,50,43,13,20,10,7
ACSSF,2010e5,wv,000,0034,0000581,070,54,041,07000US540419117699999,"Remainder of Freemans Creek district, Freemans Creek district, Lewis County, West Virginia",1094,988,257,0,94,163,731,106,52,26,17,0,9,26,54,54,0,0,54,0
ACSSF,2010e5,wv,000,0034,0000582,070,54,041,07000US540419148040828,"Jane Lew town, Hackers Creek-Skin Creek district, Lewis County, West Virginia",122,97,19,8,0,11,78,25,0,0,0,0,0,0,25,6,0,0,6,19
ACSSF,2010e5,wv,000,0034,0000583,070,54,041,07000US540419148085972,"Weston city (part), Hackers Creek-Skin Creek district, Lewis County, West Virginia",236,136,26,0,8,18,110,100,0,0,0,0,0,0,100,63,11,0,52,37
ACSSF,2010e5,wv,000,0034,0000584,070,54,041,07000US540419148099999,"Remainder of Hackers Creek-Skin Creek district, Hackers Creek-Skin Creek district, Lewis County, West Virginia",1142,948,311,34,95,182,637,194,79,19,19,0,0,60,115,77,48,29,0,38
ACSSF,2010e5,wv,000,0034,0000585,070,54,043,07000US540439038434516,"Hamlin town, Carroll district, Lincoln County, West Virginia",312,178,70,25,13,32,108,134,29,19,8,0,11,10,105,62,22,3,37,43
ACSSF,2010e5,wv,000,0034,0000586,070,54,043,07000US540439038499999,"Remainder of Carroll district, Carroll district, Lincoln County, West Virginia",780,631,205,24,20,161,426,149,56,34,0,0,34,22,93,93,7,25,61,0
ACSSF,2010e5,wv,000,0034,0000587,070,54,043,07000US540439096099999,"Duval district, Duval district, Lincoln County, West Virginia",1192,1013,485,127,55,303,528,179,37,0,0,0,0,37,142,110,16,74,20,32
ACSSF,2010e5,wv,000,0034,0000588,070,54,043,07000US540439157235596,"Harts CDP, Harts Creek district, Lincoln County, West Virginia",309,186,59,13,17,29,127,123,16,0,0,0,0,16,107,74,9,0,65,33
ACSSF,2010e5,wv,000,0034,0000589,070,54,043,07000US540439157299999,"Remainder of Harts Creek district, Harts Creek district, Lincoln County, West Virginia",794,592,222,35,11,176,370,202,37,16,16,0,0,21,165,49,15,23,11,116
ACSSF,2010e5,wv,000,0034,0000590,070,54,043,07000US540439170499999,"Jefferson district, Jefferson district, Lincoln County, West Virginia",350,286,163,56,20,87,123,64,20,0,0,0,0,20,44,28,0,0,28,16
ACSSF,2010e5,wv,000,0034,0000591,070,54,043,07000US540439181299999,"Laurel Hill district, Laurel Hill district, Lincoln County, West Virginia",670,502,241,118,25,98,261,168,96,54,0,38,16,42,72,44,18,0,26,28
ACSSF,2010e5,wv,000,0034,0000592,070,54,043,07000US540439278485804,"West Hamlin town, Sheridan district, Lincoln County, West Virginia",207,131,41,9,0,32,90,76,10,5,0,0,5,5,66,29,6,0,23,37
ACSSF,2010e5,wv,000,0034,0000593,070,54,043,07000US540439278499999,"Remainder of Sheridan district, Sheridan district, Lincoln County, West Virginia",1143,786,238,31,52,155,548,357,163,73,25,0,48,90,194,113,72,0,41,81
ACSSF,2010e5,wv,000,0034,0000594,070,54,043,07000US540439324099999,"Union district, Union district, Lincoln County, West Virginia",65,52,0,0,0,0,52,13,0,0,0,0,0,0,13,13,0,0,13,0
ACSSF,2010e5,wv,000,0034,0000595,070,54,043,07000US540439351601396,"Alum Creek CDP (part), Washington district, Lincoln County, West Virginia",274,204,115,37,0,78,89,70,0,0,0,0,0,0,70,13,0,13,0,57
ACSSF,2010e5,wv,000,0034,0000596,070,54,043,07000US540439351699999,"Remainder of Washington district, Washington district, Lincoln County, West Virginia",456,380,183,96,20,67,197,76,0,0,0,0,0,0,76,0,0,0,0,76
ACSSF,2010e5,wv,000,0034,0000597,070,54,045,07000US540459045336484,"Henlawson CDP, Central district, Logan County, West Virginia",154,114,0,0,0,0,114,40,19,0,0,0,0,19,21,0,0,0,0,21
ACSSF,2010e5,wv,000,0034,0000598,070,54,045,07000US540459045348148,"Logan city, Central district, Logan County, West Virginia",376,244,102,26,32,44,142,132,24,18,8,0,10,6,108,43,8,10,25,65
ACSSF,2010e5,wv,000,0034,0000599,070,54,045,07000US540459045349732,"McConnell CDP, Central district, Logan County, West Virginia",207,159,45,0,45,0,114,48,0,0,0,0,0,0,48,12,0,0,12,36
ACSSF,2010e5,wv,000,0034,0000600,070,54,045,07000US540459045354892,"Mitchell Heights town, Central district, Logan County, West Virginia",116,102,32,4,13,15,70,14,2,2,0,0,2,0,12,4,0,0,4,8
ACSSF,2010e5,wv,000,0034,0000601,070,54,045,07000US540459045356342,"Mount Gay-Shamrock CDP (part), Central district, Logan County, West Virginia",459,344,96,15,18,63,248,115,46,12,0,0,12,34,69,15,15,0,0,54
ACSSF,2010e5,wv,000,0034,0000602,070,54,045,07000US540459045357916,"Neibert CDP, Central district, Logan County, West Virginia",47,47,12,0,0,12,35,0,0,0,0,0,0,0,0,0,0,0,0,0
ACSSF,2010e5,wv,000,0034,0000603,070,54,045,07000US540459045376996,"Stollings CDP, Central district, Logan County, West Virginia",157,123,15,0,15,0,108,34,18,0,0,0,0,18,16,0,0,0,0,16
ACSSF,2010e5,wv,000,0034,0000604,070,54,045,07000US540459045383332,"Verdunville CDP (part), Central district, Logan County, West Virginia",48,48,18,0,0,18,30,0,0,0,0,0,0,0,0,0,0,0,0,0
ACSSF,2010e5,wv,000,0034,0000605,070,54,045,07000US540459045385900,"West Logan town, Central district, Logan County, West Virginia",124,89,34,12,5,17,55,35,6,3,0,0,3,3,29,15,0,0,15,14
ACSSF,2010e5,wv,000,0034,0000606,070,54,045,07000US540459045399999,"Remainder of Central district, Central district, Logan County, West Virginia",1665,1160,477,92,74,311,683,505,184,133,82,0,51,51,321,166,0,49,117,155
ACSSF,2010e5,wv,000,0034,0000607,070,54,045,07000US540459097900196,"Accoville CDP, Eastern district, Logan County, West Virginia",174,149,65,17,0,48,84,25,0,0,0,0,0,0,25,0,0,0,0,25
ACSSF,2010e5,wv,000,0034,0000608,070,54,045,07000US540459097901660,"Amherstdale CDP, Eastern district, Logan County, West Virginia",101,40,15,0,0,15,25,61,37,0,0,0,0,37,24,24,24,0,0,0
ACSSF,2010e5,wv,000,0034,0000609,070,54,045,07000US540459097907228,"Big Creek CDP, Eastern district, Logan County, West Virginia",58,25,0,0,0,0,25,33,0,0,0,0,0,0,33,0,0,0,0,33
ACSSF,2010e5,wv,000,0034,0000610,070,54,045,07000US540459097910876,"Bruno CDP, Eastern district, Logan County, West Virginia",145,126,19,19,0,0,107,19,0,0,0,0,0,0,19,0,0,0,0,19
ACSSF,2010e5,wv,000,0034,0000611,070,54,045,07000US540459097914524,"Chapmanville town (part), Eastern district, Logan County, West Virginia",411,323,137,27,32,78,186,88,0,0,0,0,0,0,88,43,13,0,30,45
ACSSF,2010e5,wv,000,0034,0000612,070,54,045,07000US540459097944188,"Kistler CDP, Eastern district, Logan County, West Virginia",116,45,0,0,0,0,45,71,0,0,0,0,0,0,71,40,0,0,40,31
ACSSF,2010e5,wv,000,0034,0000613,070,54,045,07000US540459097950860,"Mallory CDP, Eastern district, Logan County, West Virginia",482,446,102,17,0,85,344,36,20,0,0,0,0,20,16,0,0,0,0,16
ACSSF,2010e5,wv,000,0034,0000614,070,54,045,07000US540459097950932,"Man town (part), Eastern district, Logan County, West Virginia",293,238,83,20,15,48,155,55,13,5,5,0,0,8,42,3,0,0,3,39
ACSSF,2010e5,wv,000,0034,0000615,070,54,045,07000US540459097969100,"Robinette CDP, Eastern district, Logan County, West Virginia",118,90,12,0,0,12,78,28,16,0,0,0,0,16,12,12,0,0,12,0
ACSSF,2010e5,wv,000,0034,0000616,070,54,045,07000US540459097999999,"Remainder of Eastern district, Eastern district, Logan County, West Virginia",2012,1514,615,156,134,325,899,498,101,61,0,0,61,40,397,84,56,0,28,313
ACSSF,2010e5,wv,000,0034,0000617,070,54,045,07000US540459360814524,"Chapmanville town (part), Western district, Logan County, West Virginia",0,0,0,0,0,0,0,0,0,0,0,0,0,0,0,0,0,0,0,0
ACSSF,2010e5,wv,000,0034,0000618,070,54,045,07000US540459360814716,"Chauncey CDP, Western district, Logan County, West Virginia",177,157,59,20,20,19,98,20,0,0,0,0,0,0,20,0,0,0,0,20
ACSSF,2010e5,wv,000,0034,0000619,070,54,045,07000US540459360837948,"Holden CDP, Western district, Logan County, West Virginia",185,121,97,47,21,29,24,64,0,0,0,0,0,0,64,27,0,0,27,37
ACSSF,2010e5,wv,000,0034,0000620,070,54,045,07000US540459360850932,"Man town (part), Western district, Logan County, West Virginia",47,28,0,0,0,0,28,19,19,19,0,0,19,0,0,0,0,0,0,0
ACSSF,2010e5,wv,000,0034,0000621,070,54,045,07000US540459360855132,"Monaville CDP, Western district, Logan County, West Virginia",104,104,39,9,0,30,65,0,0,0,0,0,0,0,0,0,0,0,0,0
ACSSF,2010e5,wv,000,0034,0000622,070,54,045,07000US540459360856342,"Mount Gay-Shamrock CDP (part), Western district, Logan County, West Virginia",0,0,0,0,0,0,0,0,0,0,0,0,0,0,0,0,0,0,0,0
ACSSF,2010e5,wv,000,0034,0000623,070,54,045,07000US540459360860628,"Omar CDP, Western district, Logan County, West Virginia",224,163,54,0,20,34,109,61,0,0,0,0,0,0,61,0,0,0,0,61
ACSSF,2010e5,wv,000,0034,0000624,070,54,045,07000US540459360870468,"Rossmore CDP, Western district, Logan County, West Virginia",68,9,0,0,0,0,9,59,17,0,0,0,0,17,42,16,0,16,0,26
ACSSF,2010e5,wv,000,0034,0000625,070,54,045,07000US540459360872004,"Sarah Ann CDP, Western district, Logan County, West Virginia",32,19,19,0,0,19,0,13,0,0,0,0,0,0,13,0,0,0,0,13
ACSSF,2010e5,wv,000,0034,0000626,070,54,045,07000US540459360878796,"Switzer CDP, Western district, Logan County, West Virginia",276,194,42,13,15,14,152,82,0,0,0,0,0,0,82,23,23,0,0,59
ACSSF,2010e5,wv,000,0034,0000627,070,54,045,07000US540459360883332,"Verdunville CDP (part), Western district, Logan County, West Virginia",79,79,39,0,0,39,40,0,0,0,0,0,0,0,0,0,0,0,0,0
ACSSF,2010e5,wv,000,0034,0000628,070,54,045,07000US540459360899999,"Remainder of Western district, Western district, Logan County, West Virginia",2059,1553,572,6,153,413,981,506,96,54,32,0,22,42,410,165,37,30,98,245
ACSSF,2010e5,wv,000,0034,0000629,070,54,047,07000US540479016804732,"Bartley CDP, Big Creek district, McDowell County, West Virginia",21,21,0,0,0,0,21,0,0,0,0,0,0,0,0,0,0,0,0,0
ACSSF,2010e5,wv,000,0034,0000630,070,54,047,07000US540479016806748,"Berwind CDP, Big Creek district, McDowell County, West Virginia",54,25,0,0,0,0,25,29,12,0,0,0,0,12,17,17,0,0,17,0
ACSSF,2010e5,wv,000,0034,0000631,070,54,047,07000US540479016819492,"Cucumber CDP, Big Creek district, McDowell County, West Virginia",35,19,6,6,0,0,13,16,0,0,0,0,0,0,16,16,0,0,16,0
ACSSF,2010e5,wv,000,0034,0000632,070,54,047,07000US540479016867228,"Raysal CDP (part), Big Creek district, McDowell County, West Virginia",0,0,0,0,0,0,0,0,0,0,0,0,0,0,0,0,0,0,0,0
ACSSF,2010e5,wv,000,0034,0000633,070,54,047,07000US540479016884484,"War city, Big Creek district, McDowell County, West Virginia",212,146,47,19,3,25,99,66,19,19,0,0,19,0,47,20,0,4,16,27
ACSSF,2010e5,wv,000,0034,0000634,070,54,047,07000US540479016899999,"Remainder of Big Creek district, Big Creek district, McDowell County, West Virginia",1104,817,162,18,36,108,655,287,72,20,0,20,0,52,215,154,16,42,96,61
ACSSF,2010e5,wv,000,0034,0000635,070,54,047,07000US540479024007516,"Big Sandy CDP, Browns Creek district, McDowell County, West Virginia",63,63,33,19,0,14,30,0,0,0,0,0,0,0,0,0,0,0,0,0
ACSSF,2010e5,wv,000,0034,0000636,070,54,047,07000US540479024020500,"Davy town, Browns Creek district, McDowell County, West Virginia",94,84,7,7,0,0,77,10,0,0,0,0,0,0,10,0,0,0,0,10
ACSSF,2010e5,wv,000,0034,0000637,070,54,047,07000US540479024043780,"Kimball town, Browns Creek district, McDowell County, West Virginia",72,50,9,0,0,9,41,22,2,2,2,0,0,0,20,4,0,4,0,16
ACSSF,2010e5,wv,000,0034,0000638,070,54,047,07000US540479024069844,"Roderfield CDP (part), Browns Creek district, McDowell County, West Virginia",0,0,0,0,0,0,0,0,0,0,0,0,0,0,0,0,0,0,0,0
ACSSF,2010e5,wv,000,0034,0000639,070,54,047,07000US540479024083764,"Vivian CDP, Browns Creek district, McDowell County, West Virginia",17,17,0,0,0,0,17,0,0,0,0,0,0,0,0,0,0,0,0,0
ACSSF,2010e5,wv,000,0034,0000640,070,54,047,07000US540479024085228,"Welch city (part), Browns Creek district, McDowell County, West Virginia",449,315,95,0,25,70,220,134,33,7,0,0,7,26,101,28,0,0,28,73
ACSSF,2010e5,wv,000,0034,0000641,070,54,047,07000US540479024099999,"Remainder of Browns Creek district, Browns Creek district, McDowell County, West Virginia",545,431,212,0,0,212,219,114,50,15,0,0,15,35,64,52,0,0,52,12
ACSSF,2010e5,wv,000,0034,0000642,070,54,047,07000US540479234501780,"Anawalt town, North Elkin district, McDowell County, West Virginia",77,60,12,0,0,12,48,17,6,4,0,0,4,2,11,5,0,5,0,6
ACSSF,2010e5,wv,000,0034,0000643,070,54,047,07000US540479234519324,"Crumpler CDP, North Elkin district, McDowell County, West Virginia",61,57,25,0,0,25,32,4,4,4,0,0,4,0,0,0,0,0,0,0
ACSSF,2010e5,wv,000,0034,0000644,070,54,047,07000US540479234530196,"Gary city, North Elkin district, McDowell County, West Virginia",233,148,30,20,0,10,118,85,0,0,0,0,0,0,85,35,0,15,20,50
ACSSF,2010e5,wv,000,0034,0000645,070,54,047,07000US540479234543516,"Keystone city, North Elkin district, McDowell County, West Virginia",61,38,16,4,9,3,22,23,6,0,0,0,0,6,17,0,0,0,0,17
ACSSF,2010e5,wv,000,0034,0000646,070,54,047,07000US540479234552588,"Maybeury CDP, North Elkin district, McDowell County, West Virginia",66,55,29,0,14,15,26,11,0,0,0,0,0,0,11,0,0,0,0,11
ACSSF,2010e5,wv,000,0034,0000647,070,54,047,07000US540479234559428,"Northfork town, North Elkin district, McDowell County, West Virginia",125,46,10,4,0,6,36,79,5,5,0,0,5,0,74,44,8,8,28,30
ACSSF,2010e5,wv,000,0034,0000648,070,54,047,07000US540479234561684,"Pageton CDP, North Elkin district, McDowell County, West Virginia",40,40,0,0,0,0,40,0,0,0,0,0,0,0,0,0,0,0,0,0
ACSSF,2010e5,wv,000,0034,0000649,070,54,047,07000US540479234585228,"Welch city (part), North Elkin district, McDowell County, West Virginia",33,14,14,0,14,0,0,19,0,0,0,0,0,0,19,0,0,0,0,19
ACSSF,2010e5,wv,000,0034,0000650,070,54,047,07000US540479234599999,"Remainder of North Elkin district, North Elkin district, McDowell County, West Virginia",635,472,190,0,14,176,282,163,24,0,0,0,0,24,139,52,0,12,40,87
ACSSF,2010e5,wv,000,0034,0000651,070,54,047,07000US540479271209700,"Bradshaw town, Sandy River district, McDowell County, West Virginia",70,50,15,2,3,10,35,20,8,0,0,0,0,8,12,9,6,0,3,3
ACSSF,2010e5,wv,000,0034,0000652,070,54,047,07000US540479271239652,"Iaeger town, Sandy River district, McDowell County, West Virginia",77,74,22,2,2,18,52,3,0,0,0,0,0,0,3,3,0,0,3,0
ACSSF,2010e5,wv,000,0034,0000653,070,54,047,07000US540479271267228,"Raysal CDP (part), Sandy River district, McDowell County, West Virginia",69,69,0,0,0,0,69,0,0,0,0,0,0,0,0,0,0,0,0,0
ACSSF,2010e5,wv,000,0034,0000654,070,54,047,07000US540479271269844,"Roderfield CDP (part), Sandy River district, McDowell County, West Virginia",16,16,0,0,0,0,16,0,0,0,0,0,0,0,0,0,0,0,0,0
ACSSF,2010e5,wv,000,0034,0000655,070,54,047,07000US540479271299999,"Remainder of Sandy River district, Sandy River district, McDowell County, West Virginia",1261,1015,267,70,106,91,748,246,93,25,0,0,25,68,153,82,0,0,82,71
ACSSF,2010e5,wv,000,0034,0000656,070,54,049,07000US540499215404612,"Barrackville town, Middletown district, Marion County, West Virginia",404,315,105,17,20,68,210,89,36,3,0,0,3,33,53,23,11,11,1,30
ACSSF,2010e5,wv,000,0034,0000657,070,54,049,07000US540499215426452,"Fairmont city (part), Middletown district, Marion County, West Virginia",2978,1979,614,147,85,382,1365,999,203,127,18,0,109,76,796,416,187,77,152,380
ACSSF,2010e5,wv,000,0034,0000658,070,54,049,07000US540499215464228,"Pleasant Valley city (part), Middletown district, Marion County, West Virginia",0,0,0,0,0,0,0,0,0,0,0,0,0,0,0,0,0,0,0,0
ACSSF,2010e5,wv,000,0034,0000659,070,54,049,07000US540499215499999,"Remainder of Middletown district, Middletown district, Marion County, West Virginia",681,524,238,0,30,208,286,157,0,0,0,0,0,0,157,73,0,0,73,84
ACSSF,2010e5,wv,000,0034,0000660,070,54,049,07000US540499241826452,"Fairmont city (part), Palatine district, Marion County, West Virginia",1332,927,286,73,77,136,641,405,129,106,0,0,106,23,276,162,0,15,147,114
ACSSF,2010e5,wv,000,0034,0000661,070,54,049,07000US540499241864228,"Pleasant Valley city (part), Palatine district, Marion County, West Virginia",846,648,298,59,98,141,350,198,71,33,8,0,25,38,127,84,14,0,70,43
ACSSF,2010e5,wv,000,0034,0000662,070,54,049,07000US540499241886620,"White Hall town, Palatine district, Marion County, West Virginia",151,128,46,26,6,14,82,23,3,0,0,0,0,3,20,6,3,0,3,14
ACSSF,2010e5,wv,000,0034,0000663,070,54,049,07000US540499241888708,"Worthington town (part), Palatine district, Marion County, West Virginia",0,0,0,0,0,0,0,0,0,0,0,0,0,0,0,0,0,0,0,0
ACSSF,2010e5,wv,000,0034,0000664,070,54,049,07000US540499241899999,"Remainder of Palatine district, Palatine district, Marion County, West Virginia",3663,2847,1081,279,138,664,1766,816,233,88,0,0,88,145,583,289,52,22,215,294
ACSSF,2010e5,wv,000,0034,0000665,070,54,049,07000US540499359413468,"Carolina CDP, West Augusta district, Marion County, West Virginia",110,93,70,9,17,44,23,17,17,0,0,0,0,17,0,0,0,0,0,0
ACSSF,2010e5,wv,000,0034,0000666,070,54,049,07000US540499359426524,"Fairview town, West Augusta district, Marion County, West Virginia",110,85,41,5,6,30,44,25,9,5,5,0,0,4,16,10,2,0,8,6
ACSSF,2010e5,wv,000,0034,0000667,070,54,049,07000US540499359426932,"Farmington town, West Augusta district, Marion County, West Virginia",92,64,18,8,2,8,46,28,2,0,0,0,0,2,26,10,0,0,10,16
ACSSF,2010e5,wv,000,0034,0000668,070,54,049,07000US540499359432908,"Grant Town town, West Augusta district, Marion County, West Virginia",135,88,38,14,3,21,50,47,19,0,0,0,0,19,28,12,0,0,12,16
ACSSF,2010e5,wv,000,0034,0000669,070,54,049,07000US540499359439676,"Idamay CDP, West Augusta district, Marion County, West Virginia",165,151,35,35,0,0,116,14,0,0,0,0,0,0,14,0,0,0,0,14
ACSSF,2010e5,wv,000,0034,0000670,070,54,049,07000US540499359451100,"Mannington city, West Augusta district, Marion County, West Virginia",624,455,214,29,48,137,241,169,60,29,0,29,0,31,109,64,21,12,31,45
ACSSF,2010e5,wv,000,0034,0000671,070,54,049,07000US540499359455276,"Monongah town, West Augusta district, Marion County, West Virginia",373,245,118,16,4,98,127,128,20,0,0,0,0,20,108,82,26,13,43,26
ACSSF,2010e5,wv,000,0034,0000672,070,54,049,07000US540499359466460,"Rachel CDP, West Augusta district, Marion County, West Virginia",47,32,23,0,0,23,9,15,15,15,0,0,15,0,0,0,0,0,0,0
ACSSF,2010e5,wv,000,0034,0000673,070,54,049,07000US540499359468908,"Rivesville town, West Augusta district, Marion County, West Virginia",328,224,82,14,20,48,142,104,27,10,0,0,10,17,77,43,5,5,33,34
ACSSF,2010e5,wv,000,0034,0000674,070,54,049,07000US540499359488708,"Worthington town (part), West Augusta district, Marion County, West Virginia",61,46,12,8,4,0,34,15,4,0,0,0,0,4,11,6,0,0,6,5
ACSSF,2010e5,wv,000,0034,0000675,070,54,049,07000US540499359499999,"Remainder of West Augusta district, West Augusta district, Marion County, West Virginia",2927,2498,792,180,99,513,1706,429,142,57,13,0,44,85,287,173,0,0,173,114
ACSSF,2010e5,wv,000,0034,0000676,070,54,051,07000US540519078006340,"Benwood city, District 1, Marshall County, West Virginia",363,230,77,5,28,44,153,133,44,27,0,0,27,17,89,57,8,13,36,32
ACSSF,2010e5,wv,000,0034,0000677,070,54,051,07000US540519078050260,"McMechen city, District 1, Marshall County, West Virginia",429,329,86,41,19,26,243,100,26,26,6,0,20,0,74,57,28,0,29,17
ACSSF,2010e5,wv,000,0034,0000678,070,54,051,07000US540519078086452,"Wheeling city (part), District 1, Marshall County, West Virginia",91,91,66,0,0,66,25,0,0,0,0,0,0,0,0,0,0,0,0,0
ACSSF,2010e5,wv,000,0034,0000679,070,54,051,07000US540519078099999,"District Remainder of 1, District 1, Marshall County, West Virginia",2157,1758,692,95,103,494,1066,399,116,47,12,0,35,69,283,96,18,19,59,187
ACSSF,2010e5,wv,000,0034,0000680,070,54,051,07000US540519081656020,"Moundsville city, District 2, Marshall County, West Virginia",2457,1720,473,41,109,323,1247,737,181,103,38,0,65,78,556,287,96,27,164,269
ACSSF,2010e5,wv,000,0034,0000681,070,54,051,07000US540519081699999,"District Remainder of 2, District 2, Marshall County, West Virginia",239,239,27,0,11,16,212,0,0,0,0,0,0,0,0,0,0,0,0,0
ACSSF,2010e5,wv,000,0034,0000682,070,54,051,07000US540519085212484,"Cameron city, District 3, Marshall County, West Virginia",256,197,101,27,27,47,96,59,30,23,23,0,0,7,29,13,5,0,8,16
ACSSF,2010e5,wv,000,0034,0000683,070,54,051,07000US540519085231492,"Glen Dale city, District 3, Marshall County, West Virginia",487,391,134,45,13,76,257,96,49,29,3,0,26,20,47,15,0,0,15,32
ACSSF,2010e5,wv,000,0034,0000684,070,54,051,07000US540519085299999,"District Remainder of 3, District 3, Marshall County, West Virginia",2906,2359,818,187,187,444,1541,547,168,52,52,0,0,116,379,239,68,12,159,140
ACSSF,2010e5,wv,000,0034,0000685,070,54,053,07000US540539004899999,"Arbuckle district, Arbuckle district, Mason County, West Virginia",310,256,60,11,36,13,196,54,19,17,0,0,17,2,35,0,0,0,0,35
ACSSF,2010e5,wv,000,0034,0000686,070,54,053,07000US540539061202188,"Apple Grove CDP (part), Clendenin district, Mason County, West Virginia",22,22,0,0,0,0,22,0,0,0,0,0,0,0,0,0,0,0,0,0
ACSSF,2010e5,wv,000,0034,0000687,070,54,053,07000US540539061229716,"Gallipolis Ferry CDP, Clendenin district, Mason County, West Virginia",307,242,39,6,0,33,203,65,7,0,0,0,0,7,58,46,0,34,12,12
ACSSF,2010e5,wv,000,0034,0000688,070,54,053,07000US540539061236436,"Henderson town, Clendenin district, Mason County, West Virginia",51,26,9,4,0,5,17,25,5,3,0,3,0,2,20,19,6,4,9,1
ACSSF,2010e5,wv,000,0034,0000689,070,54,053,07000US540539061299999,"Remainder of Clendenin district, Clendenin district, Mason County, West Virginia",711,557,206,21,65,120,351,154,61,28,0,0,28,33,93,0,0,0,0,93
ACSSF,2010e5,wv,000,0034,0000690,070,54,053,07000US540539064846300,"Leon town, Cologne district, Mason County, West Virginia",46,39,12,0,4,8,27,7,5,5,0,0,5,0,2,0,0,0,0,2
ACSSF,2010e5,wv,000,0034,0000691,070,54,053,07000US540539064899999,"Remainder of Cologne district, Cologne district, Mason County, West Virginia",238,211,62,0,14,48,149,27,27,0,0,0,0,27,0,0,0,0,0,0
ACSSF,2010e5,wv,000,0034,0000692,070,54,053,07000US540539066099999,"Cooper district, Cooper district, Mason County, West Virginia",541,465,125,27,27,71,340,76,15,15,0,0,15,0,61,11,0,0,11,50
ACSSF,2010e5,wv,000,0034,0000693,070,54,053,07000US540539126035500,"Hartford City town (part), Graham district, Mason County, West Virginia",135,97,56,25,0,31,41,38,12,0,0,0,0,12,26,17,0,0,17,9
ACSSF,2010e5,wv,000,0034,0000694,070,54,053,07000US540539126058564,"New Haven town, Graham district, Mason County, West Virginia",516,352,153,55,24,74,199,164,23,18,12,6,0,5,141,88,12,0,76,53
ACSSF,2010e5,wv,000,0034,0000695,070,54,053,07000US540539126099999,"Remainder of Graham district, Graham district, Mason County, West Virginia",330,290,102,0,50,52,188,40,35,12,12,0,0,23,5,5,0,0,5,0
ACSSF,2010e5,wv,000,0034,0000696,070,54,053,07000US540539151202188,"Apple Grove CDP (part), Hannan district, Mason County, West Virginia",23,0,0,0,0,0,0,23,23,0,0,0,0,23,0,0,0,0,0,0
ACSSF,2010e5,wv,000,0034,0000697,070,54,053,07000US540539151299999,"Remainder of Hannan district, Hannan district, Mason County, West Virginia",825,670,243,35,69,139,427,155,23,23,0,0,23,0,132,83,41,0,42,49
ACSSF,2010e5,wv,000,0034,0000698,070,54,053,07000US540539186064708,"Point Pleasant city (part), Lewis district, Mason County, West Virginia",1080,751,309,8,107,194,442,329,95,82,9,0,73,13,234,125,57,0,68,109
ACSSF,2010e5,wv,000,0034,0000699,070,54,053,07000US540539186099999,"Remainder of Lewis district, Lewis district, Mason County, West Virginia",484,413,128,72,0,56,285,71,0,0,0,0,0,0,71,24,0,0,24,47
ACSSF,2010e5,wv,000,0034,0000700,070,54,053,07000US540539265264708,"Point Pleasant city (part), Robinson district, Mason County, West Virginia",60,46,11,0,11,0,35,14,0,0,0,0,0,0,14,0,0,0,0,14
ACSSF,2010e5,wv,000,0034,0000701,070,54,053,07000US540539265299999,"Remainder of Robinson district, Robinson district, Mason County, West Virginia",664,426,140,0,37,103,286,238,0,0,0,0,0,0,238,238,162,10,66,0
ACSSF,2010e5,wv,000,0034,0000702,070,54,053,07000US540539326499999,"Union district, Union district, Mason County, West Virginia",452,370,127,0,19,108,243,82,34,0,0,0,0,34,48,23,0,0,23,25
ACSSF,2010e5,wv,000,0034,0000703,070,54,053,07000US540539343235500,"Hartford City town (part), Waggener district, Mason County, West Virginia",71,49,13,0,13,0,36,22,10,4,0,0,4,6,12,4,0,0,4,8
ACSSF,2010e5,wv,000,0034,0000704,070,54,053,07000US540539343252180,"Mason town, Waggener district, Mason County, West Virginia",280,188,62,3,5,54,126,92,3,3,3,0,0,0,89,49,19,5,25,40
ACSSF,2010e5,wv,000,0034,0000705,070,54,053,07000US540539343299999,"Remainder of Waggener district, Waggener district, Mason County, West Virginia",448,287,93,24,0,69,194,161,45,45,0,0,45,0,116,82,0,18,64,34
ACSSF,2010e5,wv,000,0034,0000706,070,54,055,07000US540559090008524,"Bluefield city (part), District I, Mercer County, West Virginia",2538,1858,552,83,119,350,1306,680,54,14,0,0,14,40,626,403,107,54,242,223
ACSSF,2010e5,wv,000,0034,0000707,070,54,055,07000US540559090008764,"Bluewell CDP, District I, Mercer County, West Virginia",542,414,166,40,17,109,248,128,43,0,0,0,0,43,85,55,17,0,38,30
ACSSF,2010e5,wv,000,0034,0000708,070,54,055,07000US540559090009796,"Bramwell town, District I, Mercer County, West Virginia",113,59,13,2,4,7,46,54,6,4,4,0,0,2,48,10,2,0,8,38
ACSSF,2010e5,wv,000,0034,0000709,070,54,055,07000US540559090010948,"Brush Fork CDP, District I, Mercer County, West Virginia",219,123,39,0,14,25,84,96,9,0,0,0,0,9,87,32,32,0,0,55
ACSSF,2010e5,wv,000,0034,0000710,070,54,055,07000US540559090099999,"District Remainder of I, District I, Mercer County, West Virginia",1230,1005,254,74,36,144,751,225,52,38,38,0,0,14,173,88,0,17,71,85
ACSSF,2010e5,wv,000,0034,0000711,070,54,055,07000US540559091265692,"Princeton city (part), District II, Mercer County, West Virginia",1717,1237,369,154,28,187,868,480,268,166,0,44,122,102,212,63,23,0,40,149
ACSSF,2010e5,wv,000,0034,0000712,070,54,055,07000US540559091299999,"District Remainder of II, District II, Mercer County, West Virginia",4389,3270,1045,290,153,602,2225,1119,338,130,73,13,44,208,781,461,159,0,302,320
ACSSF,2010e5,wv,000,0034,0000713,070,54,055,07000US540559092403292,"Athens town, District III, Mercer County, West Virginia",180,149,29,7,11,11,120,31,0,0,0,0,0,0,31,22,19,0,3,9
ACSSF,2010e5,wv,000,0034,0000714,070,54,055,07000US540559092408524,"Bluefield city (part), District III, Mercer County, West Virginia",0,0,0,0,0,0,0,0,0,0,0,0,0,0,0,0,0,0,0,0
ACSSF,2010e5,wv,000,0034,0000715,070,54,055,07000US540559092445292,"Lashmeet CDP, District III, Mercer County, West Virginia",107,107,10,0,0,10,97,0,0,0,0,0,0,0,0,0,0,0,0,0
ACSSF,2010e5,wv,000,0034,0000716,070,54,055,07000US540559092452420,"Matoaka town, District III, Mercer County, West Virginia",55,24,2,0,0,2,22,31,19,16,6,0,10,3,12,0,0,0,0,12
ACSSF,2010e5,wv,000,0034,0000717,070,54,055,07000US540559092455372,"Montcalm CDP, District III, Mercer County, West Virginia",143,136,33,0,18,15,103,7,0,0,0,0,0,0,7,0,0,0,0,7
ACSSF,2010e5,wv,000,0034,0000718,070,54,055,07000US540559092460196,"Oakvale town, District III, Mercer County, West Virginia",27,27,3,0,3,0,24,0,0,0,0,0,0,0,0,0,0,0,0,0
ACSSF,2010e5,wv,000,0034,0000719,070,54,055,07000US540559092465692,"Princeton city (part), District III, Mercer County, West Virginia",4,0,0,0,0,0,0,4,0,0,0,0,0,0,4,4,0,0,4,0
ACSSF,2010e5,wv,000,0034,0000720,070,54,055,07000US540559092499999,"District Remainder of III, District III, Mercer County, West Virginia",4747,3869,1264,165,264,835,2605,878,225,110,42,17,51,115,653,311,89,56,166,342
ACSSF,2010e5,wv,000,0034,0000721,070,54,057,07000US540579078411620,"Burlington CDP, District 1, Mineral County, West Virginia",0,0,0,0,0,0,0,0,0,0,0,0,0,0,0,0,0,0,0,0
ACSSF,2010e5,wv,000,0034,0000722,070,54,057,07000US540579078424484,"Elk Garden town, District 1, Mineral County, West Virginia",80,50,18,3,8,7,32,30,11,3,0,0,3,8,19,14,0,0,14,5
ACSSF,2010e5,wv,000,0034,0000723,070,54,057,07000US540579078428444,"Fort Ashby CDP (part), District 1, Mineral County, West Virginia",380,348,132,25,65,42,216,32,0,0,0,0,0,0,32,32,17,0,15,0
ACSSF,2010e5,wv,000,0034,0000724,070,54,057,07000US540579078463604,"Piedmont town, District 1, Mineral County, West Virginia",269,137,54,3,4,47,83,132,22,16,0,12,4,6,110,83,11,19,53,27
ACSSF,2010e5,wv,000,0034,0000725,070,54,057,07000US540579078499999,"District Remainder of 1, District 1, Mineral County, West Virginia",1859,1535,443,131,34,278,1092,324,112,73,20,41,12,39,212,165,0,15,150,47
ACSSF,2010e5,wv,000,0034,0000726,070,54,057,07000US540579082043492,"Keyser city, District 2, Mineral County, West Virginia",1284,900,317,72,103,142,583,384,81,58,14,0,44,23,303,163,26,23,114,140
ACSSF,2010e5,wv,000,0034,0000727,070,54,057,07000US540579082099999,"District Remainder of 2, District 2, Mineral County, West Virginia",1108,863,223,56,23,144,640,245,32,24,0,0,24,8,213,185,34,0,151,28
ACSSF,2010e5,wv,000,0034,0000728,070,54,057,07000US540579085613525,"Carpendale town, District 3, Mineral County, West Virginia",293,254,43,4,4,35,211,39,3,3,0,0,3,0,36,2,0,0,2,34
ACSSF,2010e5,wv,000,0034,0000729,070,54,057,07000US540579085628444,"Fort Ashby CDP (part), District 3, Mineral County, West Virginia",159,144,62,0,13,49,82,15,0,0,0,0,0,0,15,15,0,0,15,0
ACSSF,2010e5,wv,000,0034,0000730,070,54,057,07000US540579085668260,"Ridgeley town, District 3, Mineral County, West Virginia",191,136,39,4,0,35,97,55,20,5,0,4,1,15,35,31,0,0,31,4
ACSSF,2010e5,wv,000,0034,0000731,070,54,057,07000US540579085687316,"Wiley Ford CDP, District 3, Mineral County, West Virginia",246,190,93,9,65,19,97,56,19,0,0,0,0,19,37,5,0,0,5,32
ACSSF,2010e5,wv,000,0034,0000732,070,54,057,07000US540579085699999,"District Remainder of 3, District 3, Mineral County, West Virginia",1841,1463,423,89,56,278,1040,378,146,114,70,17,27,32,232,166,28,26,112,66
ACSSF,2010e5,wv,000,0034,0000733,070,54,059,07000US540599014167396,"Red Jacket CDP (part), Beech Ben Mate district, Mingo County, West Virginia",194,130,46,0,0,46,84,64,30,30,30,0,0,0,34,34,14,0,20,0
ACSSF,2010e5,wv,000,0034,0000734,070,54,059,07000US540599014199999,"Remainder of Beech Ben Mate district, Beech Ben Mate district, Mingo County, West Virginia",831,627,247,79,42,126,380,204,36,0,0,0,0,36,168,113,16,34,63,55
ACSSF,2010e5,wv,000,0034,0000735,070,54,059,07000US540599177043300,"Kermit town, Kermit Harvey district, Mingo County, West Virginia",199,144,37,16,0,21,107,55,5,0,0,0,0,5,50,12,0,4,8,38
ACSSF,2010e5,wv,000,0034,0000736,070,54,059,07000US540599177099999,"Remainder of Kermit Harvey district, Kermit Harvey district, Mingo County, West Virginia",903,739,218,28,25,165,521,164,61,34,0,34,0,27,103,0,0,0,0,103
ACSSF,2010e5,wv,000,0034,0000737,070,54,059,07000US540599184820980,"Delbarton town, Lee district, Mingo County, West Virginia",263,210,96,8,26,62,114,53,14,0,0,0,0,14,39,12,0,5,7,27
ACSSF,2010e5,wv,000,0034,0000738,070,54,059,07000US540599184899999,"Remainder of Lee district, Lee district, Mingo County, West Virginia",903,707,252,45,47,160,455,196,115,31,31,0,0,84,81,27,0,27,0,54
ACSSF,2010e5,wv,000,0034,0000739,070,54,059,07000US540599206452324,"Matewan town, Magnolia district, Mingo County, West Virginia",150,90,38,0,0,38,52,60,21,5,0,0,5,16,39,15,5,0,10,24
ACSSF,2010e5,wv,000,0034,0000740,070,54,059,07000US540599206467396,"Red Jacket CDP (part), Magnolia district, Mingo County, West Virginia",11,11,11,11,0,0,0,0,0,0,0,0,0,0,0,0,0,0,0,0
ACSSF,2010e5,wv,000,0034,0000741,070,54,059,07000US540599206499999,"Remainder of Magnolia district, Magnolia district, Mingo County, West Virginia",661,401,160,44,15,101,241,260,88,57,0,0,57,31,172,101,0,16,85,71
ACSSF,2010e5,wv,000,0034,0000742,070,54,059,07000US540599301230772,"Gilbert town, Stafford district, Mingo County, West Virginia",104,88,28,12,0,16,60,16,5,0,0,0,0,5,11,3,0,0,3,8
ACSSF,2010e5,wv,000,0034,0000743,070,54,059,07000US540599301230777,"Gilbert Creek CDP, Stafford district, Mingo County, West Virginia",535,476,123,78,0,45,353,59,26,26,0,0,26,0,33,33,19,0,14,0
ACSSF,2010e5,wv,000,0034,0000744,070,54,059,07000US540599301242292,"Justice CDP, Stafford district, Mingo County, West Virginia",151,151,71,0,0,71,80,0,0,0,0,0,0,0,0,0,0,0,0,0
ACSSF,2010e5,wv,000,0034,0000745,070,54,059,07000US540599301299999,"Remainder of Stafford district, Stafford district, Mingo County, West Virginia",453,297,68,0,0,68,229,156,20,0,0,0,0,20,136,38,16,0,22,98
ACSSF,2010e5,wv,000,0034,0000746,070,54,059,07000US540599316214692,"Chattaroy CDP (part), Tug Hardee district, Mingo County, West Virginia",148,132,28,28,0,0,104,16,0,0,0,0,0,0,16,16,0,0,16,0
ACSSF,2010e5,wv,000,0034,0000747,070,54,059,07000US540599316299999,"Remainder of Tug Hardee district, Tug Hardee district, Mingo County, West Virginia",927,706,268,83,34,151,438,221,121,13,0,0,13,108,100,19,0,0,19,81
ACSSF,2010e5,wv,000,0034,0000748,070,54,059,07000US540599369614692,"Chattaroy CDP (part), Williamson district, Mingo County, West Virginia",108,75,17,0,0,17,58,33,0,0,0,0,0,0,33,16,0,0,16,17
ACSSF,2010e5,wv,000,0034,0000749,070,54,059,07000US540599369687508,"Williamson city, Williamson district, Mingo County, West Virginia",741,462,135,35,34,66,327,279,7,0,0,0,0,7,272,101,57,15,29,171
ACSSF,2010e5,wv,000,0034,0000750,070,54,059,07000US540599369699999,"Remainder of Williamson district, Williamson district, Mingo County, West Virginia",205,152,74,0,14,60,78,53,25,0,0,0,0,25,28,20,0,0,20,8
ACSSF,2010e5,wv,000,0034,0000751,070,54,061,07000US540619045655756,"Morgantown city (part), Central district, Monongalia County, West Virginia",3385,2564,842,204,189,449,1722,821,213,119,35,67,17,94,608,310,92,17,201,298
ACSSF,2010e5,wv,000,0034,0000752,070,54,061,07000US540619045676516,"Star City town (part), Central district, Monongalia County, West Virginia",365,249,81,26,26,29,168,116,52,39,21,0,18,13,64,9,0,0,9,55
ACSSF,2010e5,wv,000,0034,0000753,070,54,061,07000US540619045699999,"Remainder of Central district, Central district, Monongalia County, West Virginia",36,3,0,0,0,0,3,33,0,0,0,0,0,0,33,22,0,22,0,11
ACSSF,2010e5,wv,000,0034,0000754,070,54,061,07000US540619098310420,"Brookhaven CDP (part), Eastern district, Monongalia County, West Virginia",1348,939,466,92,108,266,473,409,193,95,58,0,37,98,216,141,81,0,60,75
ACSSF,2010e5,wv,000,0034,0000755,070,54,061,07000US540619098314775,"Cheat Lake CDP, Eastern district, Monongalia County, West Virginia",2042,1792,719,172,161,386,1073,250,78,52,38,0,14,26,172,69,0,5,64,103
ACSSF,2010e5,wv,000,0034,0000756,070,54,061,07000US540619098355756,"Morgantown city (part), Eastern district, Monongalia County, West Virginia",253,144,40,0,8,32,104,109,38,0,0,0,0,38,71,37,0,28,9,34
ACSSF,2010e5,wv,000,0034,0000757,070,54,061,07000US540619098399999,"Remainder of Eastern district, Eastern district, Monongalia County, West Virginia",4226,3422,1408,542,260,606,2014,804,277,76,10,0,66,201,527,304,99,8,197,223
ACSSF,2010e5,wv,000,0034,0000758,070,54,061,07000US540619361208092,"Blacksville town, Western district, Monongalia County, West Virginia",33,21,7,0,3,4,14,12,4,0,0,0,0,4,8,2,0,0,2,6
ACSSF,2010e5,wv,000,0034,0000759,070,54,061,07000US540619361210420,"Brookhaven CDP (part), Western district, Monongalia County, West Virginia",10,10,10,0,10,0,0,0,0,0,0,0,0,0,0,0,0,0,0,0
ACSSF,2010e5,wv,000,0034,0000760,070,54,061,07000US540619361213756,"Cassville CDP, Western district, Monongalia County, West Virginia",248,248,97,28,53,16,151,0,0,0,0,0,0,0,0,0,0,0,0,0
ACSSF,2010e5,wv,000,0034,0000761,070,54,061,07000US540619361232932,"Granville town, Western district, Monongalia County, West Virginia",146,114,30,4,0,26,84,32,15,5,0,5,0,10,17,5,0,0,5,12
ACSSF,2010e5,wv,000,0034,0000762,070,54,061,07000US540619361255756,"Morgantown city (part), Western district, Monongalia County, West Virginia",15,15,15,15,0,0,0,0,0,0,0,0,0,0,0,0,0,0,0,0
ACSSF,2010e5,wv,000,0034,0000763,070,54,061,07000US540619361262788,"Pentress CDP, Western district, Monongalia County, West Virginia",58,58,32,19,0,13,26,0,0,0,0,0,0,0,0,0,0,0,0,0
ACSSF,2010e5,wv,000,0034,0000764,070,54,061,07000US540619361276516,"Star City town (part), Western district, Monongalia County, West Virginia",0,0,0,0,0,0,0,0,0,0,0,0,0,0,0,0,0,0,0,0
ACSSF,2010e5,wv,000,0034,0000765,070,54,061,07000US540619361285996,"Westover city, Western district, Monongalia County, West Virginia",981,703,216,45,65,106,487,278,59,19,11,0,8,40,219,146,44,10,92,73
ACSSF,2010e5,wv,000,0034,0000766,070,54,061,07000US540619361299999,"Remainder of Western district, Western district, Monongalia County, West Virginia",5639,4779,1820,419,285,1116,2959,860,261,113,21,0,92,148,599,311,59,63,189,288
ACSSF,2010e5,wv,000,0034,0000767,070,54,063,07000US540639045781940,"Union town, Central district, Monroe County, West Virginia",125,78,36,5,0,31,42,47,30,17,0,0,17,13,17,8,0,8,0,9
ACSSF,2010e5,wv,000,0034,0000768,070,54,063,07000US540639045799999,"Remainder of Central district, Central district, Monroe County, West Virginia",1257,1079,262,123,10,129,817,178,71,27,0,0,27,44,107,83,61,0,22,24
ACSSF,2010e5,wv,000,0034,0000769,070,54,063,07000US540639098400772,"Alderson town (part), Eastern district, Monroe County, West Virginia",72,32,17,12,5,0,15,40,3,0,0,0,0,3,37,16,0,0,16,21
ACSSF,2010e5,wv,000,0034,0000770,070,54,063,07000US540639098499999,"Remainder of Eastern district, Eastern district, Monroe County, West Virginia",1179,1034,320,63,91,166,714,145,61,27,0,0,27,34,84,0,0,0,0,84
ACSSF,2010e5,wv,000,0034,0000771,070,54,063,07000US540639361363052,"Peterstown town, Western district, Monroe County, West Virginia",130,87,48,6,7,35,39,43,7,0,0,0,0,7,36,8,0,3,5,28
ACSSF,2010e5,wv,000,0034,0000772,070,54,063,07000US540639361399999,"Remainder of Western district, Western district, Monroe County, West Virginia",1159,987,282,90,50,142,705,172,26,0,0,0,0,26,146,36,0,0,36,110
ACSSF,2010e5,wv,000,0034,0000773,070,54,065,07000US540659078604876,"Bath (Berkeley Springs) town (part), District 1, Morgan County, West Virginia",3,3,0,0,0,0,3,0,0,0,0,0,0,0,0,0,0,0,0,0
ACSSF,2010e5,wv,000,0034,0000774,070,54,065,07000US540659078633100,"Great Cacapon CDP, District 1, Morgan County, West Virginia",107,92,33,0,13,20,59,15,0,0,0,0,0,0,15,0,0,0,0,15
ACSSF,2010e5,wv,000,0034,0000775,070,54,065,07000US540659078662332,"Paw Paw town, District 1, Morgan County, West Virginia",92,51,5,0,0,5,46,41,0,0,0,0,0,0,41,23,6,0,17,18
ACSSF,2010e5,wv,000,0034,0000776,070,54,065,07000US540659078699999,"District Remainder of 1, District 1, Morgan County, West Virginia",1012,733,181,0,24,157,552,279,53,5,0,0,5,48,226,127,0,0,127,99
ACSSF,2010e5,wv,000,0034,0000777,070,54,065,07000US540659082204876,"Bath (Berkeley Springs) town (part), District 2, Morgan County, West Virginia",152,112,44,4,18,22,68,40,2,0,0,0,0,2,38,20,0,6,14,18
ACSSF,2010e5,wv,000,0034,0000778,070,54,065,07000US540659082299999,"District Remainder of 2, District 2, Morgan County, West Virginia",1087,888,195,59,64,72,693,199,34,9,0,0,9,25,165,102,0,28,74,63
ACSSF,2010e5,wv,000,0034,0000779,070,54,065,07000US540659085899999,"District 3, District 3, Morgan County, West Virginia",1629,1340,507,63,111,333,833,289,181,136,59,10,67,45,108,63,0,0,63,45
ACSSF,2010e5,wv,000,0034,0000780,070,54,067,07000US540679013218604,"Craigsville CDP, Beaver district, Nicholas County, West Virginia",836,703,298,91,105,102,405,133,51,21,0,0,21,30,82,44,19,0,25,38
ACSSF,2010e5,wv,000,0034,0000781,070,54,067,07000US540679013227196,"Fenwick CDP, Beaver district, Nicholas County, West Virginia",50,28,14,0,0,14,14,22,0,0,0,0,0,0,22,0,0,0,0,22
ACSSF,2010e5,wv,000,0034,0000782,070,54,067,07000US540679013268116,"Richwood city, Beaver district, Nicholas County, West Virginia",616,426,87,34,34,19,339,190,55,37,8,0,29,18,135,71,18,51,2,64
ACSSF,2010e5,wv,000,0034,0000783,070,54,067,07000US540679013280476,"Tioga CDP, Beaver district, Nicholas County, West Virginia",26,8,0,0,0,0,8,18,0,0,0,0,0,0,18,0,0,0,0,18
ACSSF,2010e5,wv,000,0034,0000784,070,54,067,07000US540679013299999,"Remainder of Beaver district, Beaver district, Nicholas County, West Virginia",727,638,189,49,0,140,449,89,53,30,30,0,0,23,36,16,0,0,16,20
ACSSF,2010e5,wv,000,0034,0000785,070,54,067,07000US540679134499999,"Grant district, Grant district, Nicholas County, West Virginia",393,253,94,0,0,94,159,140,84,65,0,0,65,19,56,0,0,0,0,56
ACSSF,2010e5,wv,000,0034,0000786,070,54,067,07000US540679150007756,"Birch River CDP, Hamilton district, Nicholas County, West Virginia",72,62,0,0,0,0,62,10,0,0,0,0,0,0,10,0,0,0,0,10
ACSSF,2010e5,wv,000,0034,0000787,070,54,067,07000US540679150099999,"Remainder of Hamilton district, Hamilton district, Nicholas County, West Virginia",763,678,211,40,43,128,467,85,76,38,12,0,26,38,9,0,0,0,0,9
ACSSF,2010e5,wv,000,0034,0000788,070,54,067,07000US540679171606052,"Belva CDP, Jefferson district, Nicholas County, West Virginia",8,0,0,0,0,0,0,8,0,0,0,0,0,0,8,8,0,0,8,0
ACSSF,2010e5,wv,000,0034,0000789,070,54,067,07000US540679171621628,"Dixie CDP (part), Jefferson district, Nicholas County, West Virginia",68,68,53,0,0,53,15,0,0,0,0,0,0,0,0,0,0,0,0,0
ACSSF,2010e5,wv,000,0034,0000790,070,54,067,07000US540679171699999,"Remainder of Jefferson district, Jefferson district, Nicholas County, West Virginia",387,296,87,0,22,65,209,91,62,20,0,0,20,42,29,15,0,0,15,14
ACSSF,2010e5,wv,000,0034,0000791,070,54,067,07000US540679175258180,"Nettie CDP, Kentucky district, Nicholas County, West Virginia",266,266,54,0,0,54,212,0,0,0,0,0,0,0,0,0,0,0,0,0
ACSSF,2010e5,wv,000,0034,0000792,070,54,067,07000US540679175299999,"Remainder of Kentucky district, Kentucky district, Nicholas County, West Virginia",1036,834,365,100,65,200,469,202,97,78,15,0,63,19,105,0,0,0,0,105
ACSSF,2010e5,wv,000,0034,0000793,070,54,067,07000US540679307277980,"Summersville town (part), Summersville district, Nicholas County, West Virginia",1093,942,319,29,0,290,623,151,39,0,0,0,0,39,112,16,0,0,16,96
ACSSF,2010e5,wv,000,0034,0000794,070,54,067,07000US540679307299999,"Remainder of Summersville district, Summersville district, Nicholas County, West Virginia",430,360,139,0,0,139,221,70,0,0,0,0,0,0,70,52,0,0,52,18
ACSSF,2010e5,wv,000,0034,0000795,070,54,067,07000US540679366077980,"Summersville town (part), Wilderness district, Nicholas County, West Virginia",0,0,0,0,0,0,0,0,0,0,0,0,0,0,0,0,0,0,0,0
ACSSF,2010e5,wv,000,0034,0000796,070,54,067,07000US540679366099999,"Remainder of Wilderness district, Wilderness district, Nicholas County, West Virginia",900,801,243,49,56,138,558,99,18,11,11,0,0,7,81,15,0,0,15,66
ACSSF,2010e5,wv,000,0034,0000797,070,54,069,07000US540699078815916,"Clearview village, District 1, Ohio County, West Virginia",204,178,47,3,6,38,131,26,0,0,0,0,0,0,26,13,9,4,0,13
ACSSF,2010e5,wv,000,0034,0000798,070,54,069,07000US540699078880932,"Triadelphia town, District 1, Ohio County, West Virginia",249,202,49,19,9,21,153,47,29,19,19,0,0,10,18,18,18,0,0,0
ACSSF,2010e5,wv,000,0034,0000799,070,54,069,07000US540699078882732,"Valley Grove village, District 1, Ohio County, West Virginia",115,94,35,5,8,22,59,21,2,0,0,0,0,2,19,19,3,0,16,0
ACSSF,2010e5,wv,000,0034,0000800,070,54,069,07000US540699078885876,"West Liberty town, District 1, Ohio County, West Virginia",71,57,8,0,3,5,49,14,4,0,0,0,0,4,10,0,0,0,0,10
ACSSF,2010e5,wv,000,0034,0000801,070,54,069,07000US540699078886452,"Wheeling city (part), District 1, Ohio County, West Virginia",1324,1020,354,47,48,259,666,304,32,19,0,0,19,13,272,164,18,33,113,108
ACSSF,2010e5,wv,000,0034,0000802,070,54,069,07000US540699078899999,"District Remainder of 1, District 1, Ohio County, West Virginia",2499,2261,881,108,249,524,1380,238,36,13,0,0,13,23,202,116,42,0,74,86
ACSSF,2010e5,wv,000,0034,0000803,070,54,069,07000US540699082486452,"Wheeling city (part), District 2, Ohio County, West Virginia",2933,1783,567,155,64,348,1216,1150,255,133,67,0,66,122,895,522,182,139,201,373
ACSSF,2010e5,wv,000,0034,0000804,070,54,069,07000US540699082499999,"District Remainder of 2, District 2, Ohio County, West Virginia",172,151,55,0,20,35,96,21,0,0,0,0,0,0,21,21,0,0,21,0
ACSSF,2010e5,wv,000,0034,0000805,070,54,069,07000US540699086206940,"Bethlehem village, District 3, Ohio County, West Virginia",775,701,243,31,27,185,458,74,15,10,10,0,0,5,59,21,0,15,6,38
ACSSF,2010e5,wv,000,0034,0000806,070,54,069,07000US540699086286452,"Wheeling city (part), District 3, Ohio County, West Virginia",2859,2191,696,104,106,486,1495,668,77,23,0,0,23,54,591,243,27,61,155,348
ACSSF,2010e5,wv,000,0034,0000807,070,54,069,07000US540699086299999,"District Remainder of 3, District 3, Ohio County, West Virginia",285,250,110,16,28,66,140,35,0,0,0,0,0,0,35,9,0,0,9,26
ACSSF,2010e5,wv,000,0034,0000808,070,54,071,07000US540719046229044,"Franklin town, Central district, Pendleton County, West Virginia",212,133,57,16,9,32,76,79,3,0,0,0,0,3,76,25,9,0,16,51
ACSSF,2010e5,wv,000,0034,0000809,070,54,071,07000US540719046299999,"Remainder of Central district, Central district, Pendleton County, West Virginia",542,505,152,0,40,112,353,37,14,0,0,0,0,14,23,0,0,0,0,23
ACSSF,2010e5,wv,000,0034,0000810,070,54,071,07000US540719098709868,"Brandywine CDP, Eastern district, Pendleton County, West Virginia",113,99,42,0,31,11,57,14,0,0,0,0,0,0,14,0,0,0,0,14
ACSSF,2010e5,wv,000,0034,0000811,070,54,071,07000US540719098799999,"Remainder of Eastern district, Eastern district, Pendleton County, West Virginia",607,488,128,40,55,33,360,119,48,48,21,0,27,0,71,47,0,34,13,24
ACSSF,2010e5,wv,000,0034,0000812,070,54,071,07000US540719361599999,"Western district, Western district, Pendleton County, West Virginia",737,616,149,14,20,115,467,121,34,0,0,0,0,34,87,65,31,0,34,22
ACSSF,2010e5,wv,000,0034,0000813,070,54,073,07000US540739089206004,"Belmont city, District A, Pleasants County, West Virginia",213,168,57,3,19,35,111,45,10,0,0,0,0,10,35,15,0,0,15,20
ACSSF,2010e5,wv,000,0034,0000814,070,54,073,07000US540739089299999,"District Remainder of A, District A, Pleasants County, West Virginia",214,210,112,22,25,65,98,4,4,4,0,0,4,0,0,0,0,0,0,0
ACSSF,2010e5,wv,000,0034,0000815,070,54,073,07000US540739089499999,"District B, District B, Pleasants County, West Virginia",345,276,40,0,0,40,236,69,26,26,0,0,26,0,43,30,0,0,30,13
ACSSF,2010e5,wv,000,0034,0000816,070,54,073,07000US540739089671356,"St. Marys city (part), District C, Pleasants County, West Virginia",404,290,101,14,8,79,189,114,23,7,0,7,0,16,91,64,19,7,38,27
ACSSF,2010e5,wv,000,0034,0000817,070,54,073,07000US540739089699999,"District Remainder of C, District C, Pleasants County, West Virginia",40,40,17,0,0,17,23,0,0,0,0,0,0,0,0,0,0,0,0,0
ACSSF,2010e5,wv,000,0034,0000818,070,54,073,07000US540739089871356,"St. Marys city (part), District D, Pleasants County, West Virginia",106,83,17,4,0,13,66,23,0,0,0,0,0,0,23,0,0,0,0,23
ACSSF,2010e5,wv,000,0034,0000819,070,54,073,07000US540739089899999,"District Remainder of D, District D, Pleasants County, West Virginia",352,327,144,28,0,116,183,25,18,8,0,0,8,10,7,0,0,0,0,7
ACSSF,2010e5,wv,000,0034,0000820,070,54,075,07000US540759099651676,"Marlinton town (part), Edray district, Pocahontas County, West Virginia",351,165,18,4,0,14,147,186,79,36,0,0,36,43,107,78,56,3,19,29
ACSSF,2010e5,wv,000,0034,0000821,070,54,075,07000US540759099699999,"Remainder of Edray district, Edray district, Pocahontas County, West Virginia",713,606,119,17,10,92,487,107,46,14,0,0,14,32,61,57,0,15,42,4
ACSSF,2010e5,wv,000,0034,0000822,070,54,075,07000US540759141604780,"Bartow CDP, Greenbank district, Pocahontas County, West Virginia",30,30,0,0,0,0,30,0,0,0,0,0,0,0,0,0,0,0,0,0
ACSSF,2010e5,wv,000,0034,0000823,070,54,075,07000US540759141613684,"Cass CDP, Greenbank district, Pocahontas County, West Virginia",0,0,0,0,0,0,0,0,0,0,0,0,0,0,0,0,0,0,0,0
ACSSF,2010e5,wv,000,0034,0000824,070,54,075,07000US540759141622852,"Durbin town, Greenbank district, Pocahontas County, West Virginia",88,63,5,0,0,5,58,25,8,6,0,0,6,2,17,11,11,0,0,6
ACSSF,2010e5,wv,000,0034,0000825,070,54,075,07000US540759141628948,"Frank CDP, Greenbank district, Pocahontas County, West Virginia",56,56,56,0,0,56,0,0,0,0,0,0,0,0,0,0,0,0,0,0
ACSSF,2010e5,wv,000,0034,0000826,070,54,075,07000US540759141633124,"Green Bank CDP, Greenbank district, Pocahontas County, West Virginia",32,32,24,24,0,0,8,0,0,0,0,0,0,0,0,0,0,0,0,0
ACSSF,2010e5,wv,000,0034,0000827,070,54,075,07000US540759141699999,"Remainder of Greenbank district, Greenbank district, Pocahontas County, West Virginia",597,588,257,17,64,176,331,9,0,0,0,0,0,0,9,0,0,0,0,9
ACSSF,2010e5,wv,000,0034,0000828,070,54,075,07000US540759165639412,"Huntersville CDP, Huntersville district, Pocahontas County, West Virginia",43,43,8,0,0,8,35,0,0,0,0,0,0,0,0,0,0,0,0,0
ACSSF,2010e5,wv,000,0034,0000829,070,54,075,07000US540759165651676,"Marlinton town (part), Huntersville district, Pocahontas County, West Virginia",14,11,5,0,0,5,6,3,0,0,0,0,0,0,3,0,0,0,0,3
ACSSF,2010e5,wv,000,0034,0000830,070,54,075,07000US540759165699999,"Remainder of Huntersville district, Huntersville district, Pocahontas County, West Virginia",261,247,106,0,26,80,141,14,0,0,0,0,0,0,14,14,0,0,14,0
ACSSF,2010e5,wv,000,0034,0000831,070,54,075,07000US540759194437372,"Hillsboro town, Little Levels district, Pocahontas County, West Virginia",67,56,36,23,4,9,20,11,0,0,0,0,0,0,11,8,0,0,8,3
ACSSF,2010e5,wv,000,0034,0000832,070,54,075,07000US540759194499999,"Remainder of Little Levels district, Little Levels district, Pocahontas County, West Virginia",451,377,123,46,17,60,254,74,26,17,17,0,0,9,48,25,0,0,25,23
ACSSF,2010e5,wv,000,0034,0000833,070,54,077,07000US540779109603460,"Aurora CDP, Fifth district, Preston County, West Virginia",40,40,30,0,0,30,10,0,0,0,0,0,0,0,0,0,0,0,0,0
ACSSF,2010e5,wv,000,0034,0000834,070,54,077,07000US540779109658300,"Newburg town (part), Fifth district, Preston County, West Virginia",113,98,33,0,17,16,65,15,4,4,0,0,4,0,11,11,11,0,0,0
ACSSF,2010e5,wv,000,0034,0000835,070,54,077,07000US540779109670588,"Rowlesburg town (part), Fifth district, Preston County, West Virginia",139,117,57,18,5,34,60,22,0,0,0,0,0,0,22,18,0,0,18,4
ACSSF,2010e5,wv,000,0034,0000836,070,54,077,07000US540779109681268,"Tunnelton town, Fifth district, Preston County, West Virginia",95,80,39,11,5,23,41,15,0,0,0,0,0,0,15,10,5,0,5,5
ACSSF,2010e5,wv,000,0034,0000837,070,54,077,07000US540779109699999,"Remainder of Fifth district, Fifth district, Preston County, West Virginia",1291,1120,402,75,60,267,718,171,33,13,13,0,0,20,138,48,10,13,25,90
ACSSF,2010e5,wv,000,0034,0000838,070,54,077,07000US540779110010852,"Bruceton Mills town, First district, Preston County, West Virginia",39,18,11,0,8,3,7,21,9,9,0,0,9,0,12,9,5,0,4,3
ACSSF,2010e5,wv,000,0034,0000839,070,54,077,07000US540779110052228,"Masontown town, First district, Preston County, West Virginia",234,179,80,6,18,56,99,55,14,7,0,7,0,7,41,32,12,14,6,9
ACSSF,2010e5,wv,000,0034,0000840,070,54,077,07000US540779110067636,"Reedsville town, First district, Preston County, West Virginia",145,122,52,31,5,16,70,23,0,0,0,0,0,0,23,13,0,0,13,10
ACSSF,2010e5,wv,000,0034,0000841,070,54,077,07000US540779110099999,"Remainder of First district, First district, Preston County, West Virginia",1492,1258,482,121,35,326,776,234,29,18,0,0,18,11,205,97,39,14,44,108
ACSSF,2010e5,wv,000,0034,0000842,070,54,077,07000US540779113400748,"Albright town, Fourth district, Preston County, West Virginia",81,76,37,8,2,27,39,5,0,0,0,0,0,0,5,0,0,0,0,5
ACSSF,2010e5,wv,000,0034,0000843,070,54,077,07000US540779113444044,"Kingwood city (part), Fourth district, Preston County, West Virginia",416,325,65,0,20,45,260,91,0,0,0,0,0,0,91,27,0,12,15,64
ACSSF,2010e5,wv,000,0034,0000844,070,54,077,07000US540779113470588,"Rowlesburg town (part), Fourth district, Preston County, West Virginia",46,46,15,0,0,15,31,0,0,0,0,0,0,0,0,0,0,0,0,0
ACSSF,2010e5,wv,000,0034,0000845,070,54,077,07000US540779113479708,"Terra Alta town (part), Fourth district, Preston County, West Virginia",343,239,125,23,30,72,114,104,37,27,22,0,5,10,67,40,5,9,26,27
ACSSF,2010e5,wv,000,0034,0000846,070,54,077,07000US540779113499999,"Remainder of Fourth district, Fourth district, Preston County, West Virginia",864,696,275,85,25,165,421,168,26,0,0,0,0,26,142,36,0,0,36,106
ACSSF,2010e5,wv,000,0034,0000847,070,54,077,07000US540779274209844,"Brandonville town, Second district, Preston County, West Virginia",24,15,2,2,0,0,13,9,0,0,0,0,0,0,9,2,0,0,2,7
ACSSF,2010e5,wv,000,0034,0000848,070,54,077,07000US540779274279708,"Terra Alta town (part), Second district, Preston County, West Virginia",155,101,35,5,4,26,66,54,16,0,0,0,0,16,38,34,14,0,20,4
ACSSF,2010e5,wv,000,0034,0000849,070,54,077,07000US540779274299999,"Remainder of Second district, Second district, Preston County, West Virginia",1570,1364,363,64,51,248,1001,206,59,11,0,0,11,48,147,66,17,15,34,81
ACSSF,2010e5,wv,000,0034,0000850,070,54,077,07000US540779310244044,"Kingwood city (part), Third district, Preston County, West Virginia",445,355,151,88,19,44,204,90,27,27,0,0,27,0,63,48,0,0,48,15
ACSSF,2010e5,wv,000,0034,0000851,070,54,077,07000US540779310258300,"Newburg town (part), Third district, Preston County, West Virginia",48,37,14,5,3,6,23,11,6,6,6,0,0,0,5,5,0,0,5,0
ACSSF,2010e5,wv,000,0034,0000852,070,54,077,07000US540779310299999,"Remainder of Third district, Third district, Preston County, West Virginia",1423,1073,337,149,29,159,736,350,174,92,48,13,31,82,176,144,39,69,36,32
ACSSF,2010e5,wv,000,0034,0000853,070,54,079,07000US540799029211284,"Buffalo town, Buffalo-Union district, Putnam County, West Virginia",361,276,108,0,3,105,168,85,43,25,6,6,13,18,42,30,9,6,15,12
ACSSF,2010e5,wv,000,0034,0000854,070,54,079,07000US540799029219516,"Culloden CDP (part), Buffalo-Union district, Putnam County, West Virginia",0,0,0,0,0,0,0,0,0,0,0,0,0,0,0,0,0,0,0,0
ACSSF,2010e5,wv,000,0034,0000855,070,54,079,07000US540799029224292,"Eleanor town, Buffalo-Union district, Putnam County, West Virginia",501,402,154,27,36,91,248,99,6,0,0,0,0,6,93,45,4,0,41,48
ACSSF,2010e5,wv,000,0034,0000856,070,54,079,07000US540799029238260,"Hometown CDP, Buffalo-Union district, Putnam County, West Virginia",238,172,18,0,0,18,154,66,0,0,0,0,0,0,66,36,36,0,0,30
ACSSF,2010e5,wv,000,0034,0000857,070,54,079,07000US540799029239532,"Hurricane city (part), Buffalo-Union district, Putnam County, West Virginia",27,27,0,0,0,0,27,0,0,0,0,0,0,0,0,0,0,0,0,0
ACSSF,2010e5,wv,000,0034,0000858,070,54,079,07000US540799029299999,"Remainder of Buffalo-Union district, Buffalo-Union district, Putnam County, West Virginia",2003,1522,457,51,58,348,1065,481,109,48,0,0,48,61,372,110,0,0,110,262
ACSSF,2010e5,wv,000,0034,0000859,070,54,079,07000US540799072019516,"Culloden CDP (part), Curry district, Putnam County, West Virginia",50,35,13,13,0,0,22,15,0,0,0,0,0,0,15,0,0,0,0,15
ACSSF,2010e5,wv,000,0034,0000860,070,54,079,07000US540799072039532,"Hurricane city (part), Curry district, Putnam County, West Virginia",1252,1043,407,102,92,213,636,209,28,15,0,0,15,13,181,136,18,68,50,45
ACSSF,2010e5,wv,000,0034,0000861,070,54,079,07000US540799072099999,"Remainder of Curry district, Curry district, Putnam County, West Virginia",1452,1236,498,118,172,208,738,216,19,19,8,0,11,0,197,97,9,32,56,100
ACSSF,2010e5,wv,000,0034,0000862,070,54,079,07000US540799250804204,"Bancroft town, Pocatalico district, Putnam County, West Virginia",50,39,14,0,0,14,25,11,0,0,0,0,0,0,11,0,0,0,0,11
ACSSF,2010e5,wv,000,0034,0000863,070,54,079,07000US540799250859068,"Nitro city (part), Pocatalico district, Putnam County, West Virginia",345,186,42,30,0,12,144,159,48,38,0,0,38,10,111,80,63,0,17,31
ACSSF,2010e5,wv,000,0034,0000864,070,54,079,07000US540799250864516,"Poca town (part), Pocatalico district, Putnam County, West Virginia",369,283,84,24,10,50,199,86,18,0,0,0,0,18,68,50,5,12,33,18
ACSSF,2010e5,wv,000,0034,0000865,070,54,079,07000US540799250899999,"Remainder of Pocatalico district, Pocatalico district, Putnam County, West Virginia",1672,1313,578,132,103,343,735,359,139,76,0,0,76,63,220,189,0,113,76,31
ACSSF,2010e5,wv,000,0034,0000866,070,54,079,07000US540799273639532,"Hurricane city (part), Scott district, Putnam County, West Virginia",16,16,0,0,0,0,16,0,0,0,0,0,0,0,0,0,0,0,0,0
ACSSF,2010e5,wv,000,0034,0000867,070,54,079,07000US540799273659068,"Nitro city (part), Scott district, Putnam County, West Virginia",0,0,0,0,0,0,0,0,0,0,0,0,0,0,0,0,0,0,0,0
ACSSF,2010e5,wv,000,0034,0000868,070,54,079,07000US540799273664516,"Poca town (part), Scott district, Putnam County, West Virginia",0,0,0,0,0,0,0,0,0,0,0,0,0,0,0,0,0,0,0,0
ACSSF,2010e5,wv,000,0034,0000869,070,54,079,07000US540799273679545,"Teays Valley CDP (part), Scott district, Putnam County, West Virginia",669,602,261,61,93,107,341,67,17,0,0,0,0,17,50,12,0,0,12,38
ACSSF,2010e5,wv,000,0034,0000870,070,54,079,07000US540799273687988,"Winfield town, Scott district, Putnam County, West Virginia",719,632,327,64,59,204,305,87,15,15,6,0,9,0,72,29,6,0,23,43
ACSSF,2010e5,wv,000,0034,0000871,070,54,079,07000US540799273699999,"Remainder of Scott district, Scott district, Putnam County, West Virginia",1835,1563,783,88,17,678,780,272,98,50,0,31,19,48,174,81,65,0,16,93
ACSSF,2010e5,wv,000,0034,0000872,070,54,079,07000US540799309039532,"Hurricane city (part), Teays district, Putnam County, West Virginia",466,444,245,54,54,137,199,22,12,0,0,0,0,12,10,10,0,0,10,0
ACSSF,2010e5,wv,000,0034,0000873,070,54,079,07000US540799309079545,"Teays Valley CDP (part), Teays district, Putnam County, West Virginia",3248,2806,1193,310,243,640,1613,442,162,49,0,0,49,113,280,224,33,67,124,56
ACSSF,2010e5,wv,000,0034,0000874,070,54,079,07000US540799309099999,"Remainder of Teays district, Teays district, Putnam County, West Virginia",656,524,236,18,60,158,288,132,69,15,0,0,15,54,63,49,0,0,49,14
ACSSF,2010e5,wv,000,0034,0000875,070,54,081,07000US540819079205332,"Beckley city (part), District 1, Raleigh County, West Virginia",0,0,0,0,0,0,0,0,0,0,0,0,0,0,0,0,0,0,0,0
ACSSF,2010e5,wv,000,0034,0000876,070,54,081,07000US540819079208956,"Bolt CDP, District 1, Raleigh County, West Virginia",156,156,62,20,0,42,94,0,0,0,0,0,0,0,0,0,0,0,0,0
ACSSF,2010e5,wv,000,0034,0000877,070,54,081,07000US540819079216516,"Coal City CDP, District 1, Raleigh County, West Virginia",463,348,208,38,35,135,140,115,41,0,0,0,0,41,74,12,0,12,0,62
ACSSF,2010e5,wv,000,0034,0000878,070,54,081,07000US540819079218508,"Crab Orchard CDP, District 1, Raleigh County, West Virginia",825,693,240,45,63,132,453,132,72,25,0,25,0,47,60,0,0,0,0,60
ACSSF,2010e5,wv,000,0034,0000879,070,54,081,07000US540819079223644,"Eccles CDP, District 1, Raleigh County, West Virginia",118,64,64,14,0,50,0,54,23,23,0,0,23,0,31,0,0,0,0,31
ACSSF,2010e5,wv,000,0034,0000880,070,54,081,07000US540819079230724,"Ghent CDP, District 1, Raleigh County, West Virginia",166,134,21,0,21,0,113,32,0,0,0,0,0,0,32,0,0,0,0,32
ACSSF,2010e5,wv,000,0034,0000881,070,54,081,07000US540819079232068,"Glen White CDP, District 1, Raleigh County, West Virginia",0,0,0,0,0,0,0,0,0,0,0,0,0,0,0,0,0,0,0,0
ACSSF,2010e5,wv,000,0034,0000882,070,54,081,07000US540819079236292,"Helen CDP, District 1, Raleigh County, West Virginia",18,18,0,0,0,0,18,0,0,0,0,0,0,0,0,0,0,0,0,0
ACSSF,2010e5,wv,000,0034,0000883,070,54,081,07000US540819079246468,"Lester town, District 1, Raleigh County, West Virginia",84,51,20,0,0,20,31,33,0,0,0,0,0,0,33,15,3,0,12,18
ACSSF,2010e5,wv,000,0034,0000884,070,54,081,07000US540819079249492,"Mabscott town (part), District 1, Raleigh County, West Virginia",453,366,148,26,40,82,218,87,28,0,0,0,0,28,59,32,8,6,18,27
ACSSF,2010e5,wv,000,0034,0000885,070,54,081,07000US540819079249564,"MacArthur CDP (part), District 1, Raleigh County, West Virginia",371,274,58,0,0,58,216,97,30,30,0,0,30,0,67,58,48,10,0,9
ACSSF,2010e5,wv,000,0034,0000886,070,54,081,07000US540819079267996,"Rhodell town, District 1, Raleigh County, West Virginia",33,21,10,3,0,7,11,12,0,0,0,0,0,0,12,12,0,0,12,0
ACSSF,2010e5,wv,000,0034,0000887,070,54,081,07000US540819079275172,"Sophia town, District 1, Raleigh County, West Virginia",343,279,105,26,20,59,174,64,0,0,0,0,0,0,64,34,4,13,17,30
ACSSF,2010e5,wv,000,0034,0000888,070,54,081,07000US540819079299999,"District Remainder of 1, District 1, Raleigh County, West Virginia",3840,3149,1057,196,124,737,2092,691,170,63,27,0,36,107,521,274,61,87,126,247
ACSSF,2010e5,wv,000,0034,0000889,070,54,081,07000US540819082805332,"Beckley city (part), District 2, Raleigh County, West Virginia",2067,1522,509,129,57,323,1013,545,48,0,0,0,0,48,497,264,35,39,190,233
ACSSF,2010e5,wv,000,0034,0000890,070,54,081,07000US540819082809676,"Bradley CDP, District 2, Raleigh County, West Virginia",555,468,155,73,42,40,313,87,24,12,12,0,0,12,63,63,21,0,42,0
ACSSF,2010e5,wv,000,0034,0000891,070,54,081,07000US540819082863988,"Piney View CDP, District 2, Raleigh County, West Virginia",244,187,40,0,0,40,147,57,41,0,0,0,0,41,16,16,0,0,16,0
ACSSF,2010e5,wv,000,0034,0000892,070,54,081,07000US540819082865836,"Prosperity CDP, District 2, Raleigh County, West Virginia",367,183,83,25,0,58,100,184,19,0,0,0,0,19,165,66,39,0,27,99
ACSSF,2010e5,wv,000,0034,0000893,070,54,081,07000US540819082876444,"Stanaford CDP (part), District 2, Raleigh County, West Virginia",278,231,149,64,0,85,82,47,40,30,0,0,30,10,7,7,0,0,7,0
ACSSF,2010e5,wv,000,0034,0000894,070,54,081,07000US540819082899999,"District Remainder of 2, District 2, Raleigh County, West Virginia",3392,2461,904,191,186,527,1557,931,185,45,0,0,45,140,746,367,79,88,200,379
ACSSF,2010e5,wv,000,0034,0000895,070,54,081,07000US540819086405260,"Beaver CDP, District 3, Raleigh County, West Virginia",415,287,89,12,32,45,198,128,65,21,21,0,0,44,63,53,11,0,42,10
ACSSF,2010e5,wv,000,0034,0000896,070,54,081,07000US540819086405332,"Beckley city (part), District 3, Raleigh County, West Virginia",2384,1521,524,130,157,237,997,863,276,116,30,63,23,160,587,222,54,14,154,365
ACSSF,2010e5,wv,000,0034,0000897,070,54,081,07000US540819086420164,"Daniels CDP, District 3, Raleigh County, West Virginia",442,392,83,7,34,42,309,50,0,0,0,0,0,0,50,38,38,0,0,12
ACSSF,2010e5,wv,000,0034,0000898,070,54,081,07000US540819086449492,"Mabscott town (part), District 3, Raleigh County, West Virginia",0,0,0,0,0,0,0,0,0,0,0,0,0,0,0,0,0,0,0,0
ACSSF,2010e5,wv,000,0034,0000899,070,54,081,07000US540819086449564,"MacArthur CDP (part), District 3, Raleigh County, West Virginia",22,0,0,0,0,0,0,22,22,22,0,0,22,0,0,0,0,0,0,0
ACSSF,2010e5,wv,000,0034,0000900,070,54,081,07000US540819086473108,"Shady Spring CDP, District 3, Raleigh County, West Virginia",889,668,212,89,0,123,456,221,78,64,0,0,64,14,143,96,29,0,67,47
ACSSF,2010e5,wv,000,0034,0000901,070,54,081,07000US540819086476444,"Stanaford CDP (part), District 3, Raleigh County, West Virginia",182,172,66,0,41,25,106,10,0,0,0,0,0,0,10,0,0,0,0,10
ACSSF,2010e5,wv,000,0034,0000902,070,54,081,07000US540819086499999,"District Remainder of 3, District 3, Raleigh County, West Virginia",2907,2436,886,138,159,589,1550,471,143,79,13,0,66,64,328,117,7,25,85,211
ACSSF,2010e5,wv,000,0034,0000903,070,54,083,07000US540839015606988,"Beverly town, Beverly district, Randolph County, West Virginia",163,116,44,4,0,40,72,47,10,10,0,0,10,0,37,29,25,0,4,8
ACSSF,2010e5,wv,000,0034,0000904,070,54,083,07000US540839015609364,"Bowden CDP, Beverly district, Randolph County, West Virginia",0,0,0,0,0,0,0,0,0,0,0,0,0,0,0,0,0,0,0,0
ACSSF,2010e5,wv,000,0034,0000905,070,54,083,07000US540839015624580,"Elkins city (part), Beverly district, Randolph County, West Virginia",12,0,0,0,0,0,0,12,12,12,0,0,12,0,0,0,0,0,0,0
ACSSF,2010e5,wv,000,0034,0000906,070,54,083,07000US540839015699999,"Remainder of Beverly district, Beverly district, Randolph County, West Virginia",1051,777,216,14,39,163,561,274,111,15,0,0,15,96,163,138,15,50,73,25
ACSSF,2010e5,wv,000,0034,0000907,070,54,083,07000US540839093635092,"Harman town, Dry Fork district, Randolph County, West Virginia",43,22,3,3,0,0,19,21,4,4,0,0,4,0,17,14,5,0,9,3
ACSSF,2010e5,wv,000,0034,0000908,070,54,083,07000US540839093686932,"Whitmer CDP, Dry Fork district, Randolph County, West Virginia",67,67,50,27,0,23,17,0,0,0,0,0,0,0,0,0,0,0,0,0
ACSSF,2010e5,wv,000,0034,0000909,070,54,083,07000US540839093699999,"Remainder of Dry Fork district, Dry Fork district, Randolph County, West Virginia",469,399,26,26,0,0,373,70,9,0,0,0,0,9,61,30,0,0,30,31
ACSSF,2010e5,wv,000,0034,0000910,070,54,083,07000US540839166839628,"Huttonsville town, Huttonsville district, Randolph County, West Virginia",31,28,13,3,4,6,15,3,0,0,0,0,0,0,3,3,0,0,3,0
ACSSF,2010e5,wv,000,0034,0000911,070,54,083,07000US540839166854100,"Mill Creek town, Huttonsville district, Randolph County, West Virginia",176,143,50,0,14,36,93,33,3,3,0,0,3,0,30,13,0,0,13,17
ACSSF,2010e5,wv,000,0034,0000912,070,54,083,07000US540839166899999,"Remainder of Huttonsville district, Huttonsville district, Randolph County, West Virginia",371,367,82,19,15,48,285,4,0,0,0,0,0,0,4,0,0,0,0,4
ACSSF,2010e5,wv,000,0034,0000913,070,54,083,07000US540839182424580,"Elkins city (part), Leadsville district, Randolph County, West Virginia",1687,1238,487,63,48,376,751,449,91,67,47,5,15,24,358,238,39,82,117,120
ACSSF,2010e5,wv,000,0034,0000914,070,54,083,07000US540839182499999,"Remainder of Leadsville district, Leadsville district, Randolph County, West Virginia",1609,1384,450,64,91,295,934,225,62,18,7,0,11,44,163,55,0,0,55,108
ACSSF,2010e5,wv,000,0034,0000915,070,54,083,07000US540839214836340,"Helvetia CDP, Middle Fork district, Randolph County, West Virginia",4,4,0,0,0,0,4,0,0,0,0,0,0,0,0,0,0,0,0,0
ACSSF,2010e5,wv,000,0034,0000916,070,54,083,07000US540839214863484,"Pickens CDP, Middle Fork district, Randolph County, West Virginia",29,14,0,0,0,0,14,15,0,0,0,0,0,0,15,15,0,0,15,0
ACSSF,2010e5,wv,000,0034,0000917,070,54,083,07000US540839214899999,"Remainder of Middle Fork district, Middle Fork district, Randolph County, West Virginia",184,165,59,0,26,33,106,19,18,18,0,0,18,0,1,0,0,0,0,1
ACSSF,2010e5,wv,000,0034,0000918,070,54,083,07000US540839222082756,"Valley Head CDP, Mingo district, Randolph County, West Virginia",87,52,34,18,0,16,18,35,0,0,0,0,0,0,35,0,0,0,0,35
ACSSF,2010e5,wv,000,0034,0000919,070,54,083,07000US540839222099999,"Remainder of Mingo district, Mingo district, Randolph County, West Virginia",309,298,105,8,11,86,193,11,0,0,0,0,0,0,11,0,0,0,0,11
ACSSF,2010e5,wv,000,0034,0000920,070,54,083,07000US540839229255540,"Montrose town, New Interest district, Randolph County, West Virginia",39,20,6,0,0,6,14,19,4,0,0,0,0,4,15,4,0,0,4,11
ACSSF,2010e5,wv,000,0034,0000921,070,54,083,07000US540839229299999,"Remainder of New Interest district, New Interest district, Randolph County, West Virginia",356,326,70,7,14,49,256,30,20,20,20,0,0,0,10,0,0,0,0,10
ACSSF,2010e5,wv,000,0034,0000922,070,54,083,07000US540839264088324,"Womelsdorf (Coalton) town, Roaring Creek district, Randolph County, West Virginia",59,38,12,0,6,6,26,21,11,4,4,0,0,7,10,4,0,0,4,6
ACSSF,2010e5,wv,000,0034,0000923,070,54,083,07000US540839264099999,"Remainder of Roaring Creek district, Roaring Creek district, Randolph County, West Virginia",487,438,159,0,44,115,279,49,26,0,0,0,0,26,23,0,0,0,0,23
ACSSF,2010e5,wv,000,0034,0000924,070,54,083,07000US540839342019948,"Dailey CDP, Valley Bend district, Randolph County, West Virginia",15,15,0,0,0,0,15,0,0,0,0,0,0,0,0,0,0,0,0,0
ACSSF,2010e5,wv,000,0034,0000925,070,54,083,07000US540839342023140,"East Dailey CDP, Valley Bend district, Randolph County, West Virginia",150,138,56,22,34,0,82,12,12,0,0,0,0,12,0,0,0,0,0,0
ACSSF,2010e5,wv,000,0034,0000926,070,54,083,07000US540839342082564,"Valley Bend CDP, Valley Bend district, Randolph County, West Virginia",141,126,86,0,44,42,40,15,0,0,0,0,0,0,15,15,0,15,0,0
ACSSF,2010e5,wv,000,0034,0000927,070,54,083,07000US540839342099999,"Remainder of Valley Bend district, Valley Bend district, Randolph County, West Virginia",152,120,26,0,0,26,94,32,0,0,0,0,0,0,32,17,0,17,0,15
ACSSF,2010e5,wv,000,0034,0000928,070,54,085,07000US540859055224844,"Ellenboro town, Clay district, Ritchie County, West Virginia",164,138,23,0,2,21,115,26,2,0,0,0,0,2,24,18,0,0,18,6
ACSSF,2010e5,wv,000,0034,0000929,070,54,085,07000US540859055235428,"Harrisville town (part), Clay district, Ritchie County, West Virginia",0,0,0,0,0,0,0,0,0,0,0,0,0,0,0,0,0,0,0,0
ACSSF,2010e5,wv,000,0034,0000930,070,54,085,07000US540859055262764,"Pennsboro city, Clay district, Ritchie County, West Virginia",342,213,59,8,14,37,154,129,24,11,0,0,11,13,105,59,10,3,46,46
ACSSF,2010e5,wv,000,0034,0000931,070,54,085,07000US540859055299999,"Remainder of Clay district, Clay district, Ritchie County, West Virginia",555,446,198,30,106,62,248,109,67,42,42,0,0,25,42,0,0,0,0,42
ACSSF,2010e5,wv,000,0034,0000932,070,54,085,07000US540859138012124,"Cairo town, Grant district, Ritchie County, West Virginia",100,71,3,0,0,3,68,29,14,5,0,0,5,9,15,15,0,5,10,0
ACSSF,2010e5,wv,000,0034,0000933,070,54,085,07000US540859138099999,"Remainder of Grant district, Grant district, Ritchie County, West Virginia",430,375,111,53,0,58,264,55,26,0,0,0,0,26,29,29,0,8,21,0
ACSSF,2010e5,wv,000,0034,0000934,070,54,085,07000US540859224499999,"Murphy district, Murphy district, Ritchie County, West Virginia",339,255,50,0,0,50,205,84,21,0,0,0,0,21,63,21,0,0,21,42
ACSSF,2010e5,wv,000,0034,0000935,070,54,085,07000US540859333603364,"Auburn town, Union district, Ritchie County, West Virginia",21,13,0,0,0,0,13,8,2,0,0,0,0,2,6,5,0,0,5,1
ACSSF,2010e5,wv,000,0034,0000936,070,54,085,07000US540859333635428,"Harrisville town (part), Union district, Ritchie County, West Virginia",606,433,179,21,47,111,254,173,32,14,6,0,8,18,141,96,29,11,56,45
ACSSF,2010e5,wv,000,0034,0000937,070,54,085,07000US540859333665956,"Pullman town, Union district, Ritchie County, West Virginia",63,55,33,11,3,19,22,8,2,2,0,2,0,0,6,0,0,0,0,6
ACSSF,2010e5,wv,000,0034,0000938,070,54,085,07000US540859333699999,"Remainder of Union district, Union district, Ritchie County, West Virginia",304,255,37,0,11,26,218,49,40,19,0,0,19,21,9,0,0,0,0,9
ACSSF,2010e5,wv,000,0034,0000939,070,54,087,07000US540879079367660,"Reedy town, District I, Roane County, West Virginia",31,28,10,0,4,6,18,3,3,0,0,0,0,3,0,0,0,0,0,0
ACSSF,2010e5,wv,000,0034,0000940,070,54,087,07000US540879079375820,"Spencer city (part), District I, Roane County, West Virginia",196,176,76,18,49,9,100,20,20,0,0,0,0,20,0,0,0,0,0,0
ACSSF,2010e5,wv,000,0034,0000941,070,54,087,07000US540879079399999,"District Remainder of I, District I, Roane County, West Virginia",1027,822,291,116,29,146,531,205,30,13,0,0,13,17,175,59,31,0,28,116
ACSSF,2010e5,wv,000,0034,0000942,070,54,087,07000US540879082975820,"Spencer city (part), District II, Roane County, West Virginia",412,272,128,5,28,95,144,140,25,20,0,0,20,5,115,23,7,0,16,92
ACSSF,2010e5,wv,000,0034,0000943,070,54,087,07000US540879082999999,"District Remainder of II, District II, Roane County, West Virginia",816,706,218,0,28,190,488,110,16,0,0,0,0,16,94,20,0,20,0,74
ACSSF,2010e5,wv,000,0034,0000944,070,54,087,07000US540879086599999,"District III, District III, Roane County, West Virginia",1526,1269,333,117,12,204,936,257,45,0,0,0,0,45,212,120,24,96,0,92
ACSSF,2010e5,wv,000,0034,0000945,070,54,089,07000US540899021637636,"Hinton city (part), Bluestone River district, Summers County, West Virginia",173,66,51,10,14,27,15,107,30,30,0,0,30,0,77,25,0,0,25,52
ACSSF,2010e5,wv,000,0034,0000946,070,54,089,07000US540899021699999,"Remainder of Bluestone River district, Bluestone River district, Summers County, West Virginia",1089,886,297,94,37,166,589,203,57,20,0,0,20,37,146,78,0,0,78,68
ACSSF,2010e5,wv,000,0034,0000947,070,54,089,07000US540899144037636,"Hinton city (part), Greenbrier River district, Summers County, West Virginia",241,199,90,7,0,83,109,42,20,0,0,0,0,20,22,11,0,0,11,11
ACSSF,2010e5,wv,000,0034,0000948,070,54,089,07000US540899144099999,"Remainder of Greenbrier River district, Greenbrier River district, Summers County, West Virginia",805,686,163,29,34,100,523,119,51,28,0,0,28,23,68,16,0,0,16,52
ACSSF,2010e5,wv,000,0034,0000949,070,54,089,07000US540899231637636,"Hinton city (part), New River district, Summers County, West Virginia",146,81,8,8,0,0,73,65,19,19,19,0,0,0,46,9,0,0,9,37
ACSSF,2010e5,wv,000,0034,0000950,070,54,089,07000US540899231699999,"Remainder of New River district, New River district, Summers County, West Virginia",742,525,107,14,37,56,418,217,89,19,0,0,19,70,128,44,0,14,30,84
ACSSF,2010e5,wv,000,0034,0000951,070,54,091,07000US540919099332716,"Grafton city (part), Eastern district, Taylor County, West Virginia",480,285,74,0,0,74,211,195,22,0,0,0,0,22,173,121,0,53,68,52
ACSSF,2010e5,wv,000,0034,0000952,070,54,091,07000US540919099399999,"Remainder of Eastern district, Eastern district, Taylor County, West Virginia",989,871,263,73,49,141,608,118,48,0,0,0,0,48,70,27,0,0,27,43
ACSSF,2010e5,wv,000,0034,0000953,070,54,091,07000US540919317532716,"Grafton city (part), Tygart district, Taylor County, West Virginia",875,523,203,45,50,108,320,352,73,19,0,0,19,54,279,161,11,35,115,118
ACSSF,2010e5,wv,000,0034,0000954,070,54,091,07000US540919317599999,"Remainder of Tygart district, Tygart district, Taylor County, West Virginia",310,296,164,0,73,91,132,14,0,0,0,0,0,0,14,11,11,0,0,3
ACSSF,2010e5,wv,000,0034,0000955,070,54,091,07000US540919362127940,"Flemington town, Western district, Taylor County, West Virginia",91,68,27,0,12,15,41,23,7,4,0,0,4,3,16,6,0,0,6,10
ACSSF,2010e5,wv,000,0034,0000956,070,54,091,07000US540919362199999,"Remainder of Western district, Western district, Taylor County, West Virginia",1843,1494,592,183,77,332,902,349,100,26,0,15,11,74,249,149,21,0,128,100
ACSSF,2010e5,wv,000,0034,0000957,070,54,093,07000US540939019234492,"Hambleton town, Black Fork district, Tucker County, West Virginia",70,63,20,3,8,9,43,7,7,3,0,0,3,4,0,0,0,0,0,0
ACSSF,2010e5,wv,000,0034,0000958,070,54,093,07000US540939019236460,"Hendricks town, Black Fork district, Tucker County, West Virginia",101,88,35,7,8,20,53,13,2,2,2,0,0,0,11,0,0,0,0,11
ACSSF,2010e5,wv,000,0034,0000959,070,54,093,07000US540939019262284,"Parsons city, Black Fork district, Tucker County, West Virginia",489,362,149,41,20,88,213,127,30,6,6,0,0,24,97,53,24,21,8,44
ACSSF,2010e5,wv,000,0034,0000960,070,54,093,07000US540939019299999,"Remainder of Black Fork district, Black Fork district, Tucker County, West Virginia",495,433,201,31,31,139,232,62,32,14,0,0,14,18,30,19,19,0,0,11
ACSSF,2010e5,wv,000,0034,0000961,070,54,093,07000US540939062499999,"Clover district, Clover district, Tucker County, West Virginia",99,99,24,0,0,24,75,0,0,0,0,0,0,0,0,0,0,0,0,0
ACSSF,2010e5,wv,000,0034,0000962,070,54,093,07000US540939074420428,"Davis town, Davis district, Tucker County, West Virginia",146,116,35,14,4,17,81,30,10,5,0,0,5,5,20,0,0,0,0,20
ACSSF,2010e5,wv,000,0034,0000963,070,54,093,07000US540939074480020,"Thomas city (part), Davis district, Tucker County, West Virginia",0,0,0,0,0,0,0,0,0,0,0,0,0,0,0,0,0,0,0,0
ACSSF,2010e5,wv,000,0034,0000964,070,54,093,07000US540939074499999,"Remainder of Davis district, Davis district, Tucker County, West Virginia",0,0,0,0,0,0,0,0,0,0,0,0,0,0,0,0,0,0,0,0
ACSSF,2010e5,wv,000,0034,0000965,070,54,093,07000US540939094899999,"Dry Fork district, Dry Fork district, Tucker County, West Virginia",201,174,3,0,0,3,171,27,0,0,0,0,0,0,27,0,0,0,0,27
ACSSF,2010e5,wv,000,0034,0000966,070,54,093,07000US540939105680020,"Thomas city (part), Fairfax district, Tucker County, West Virginia",132,99,21,3,0,18,78,33,10,0,0,0,0,10,23,18,7,6,5,5
ACSSF,2010e5,wv,000,0034,0000967,070,54,093,07000US540939105699999,"Remainder of Fairfax district, Fairfax district, Tucker County, West Virginia",43,43,0,0,0,0,43,0,0,0,0,0,0,0,0,0,0,0,0,0
ACSSF,2010e5,wv,000,0034,0000968,070,54,093,07000US540939189699999,"Licking district, Licking district, Tucker County, West Virginia",44,14,0,0,0,0,14,30,0,0,0,0,0,0,30,0,0,0,0,30
ACSSF,2010e5,wv,000,0034,0000969,070,54,093,07000US540939268899999,"St. George district, St. George district, Tucker County, West Virginia",252,182,62,0,0,62,120,70,43,28,14,0,14,15,27,0,0,0,0,27
ACSSF,2010e5,wv,000,0034,0000970,070,54,095,07000US540959046929404,"Friendly town, Central district, Tyler County, West Virginia",33,30,15,6,4,5,15,3,0,0,0,0,0,0,3,0,0,0,0,3
ACSSF,2010e5,wv,000,0034,0000971,070,54,095,07000US540959046953572,"Middlebourne town, Central district, Tyler County, West Virginia",220,157,64,10,7,47,93,63,17,8,8,0,0,9,46,15,5,0,10,31
ACSSF,2010e5,wv,000,0034,0000972,070,54,095,07000US540959046999999,"Remainder of Central district, Central district, Tyler County, West Virginia",344,330,83,43,0,40,247,14,0,0,0,0,0,0,14,6,0,6,0,8
ACSSF,2010e5,wv,000,0034,0000973,070,54,095,07000US540959233461636,"Paden City city (part), North district, Tyler County, West Virginia",251,201,94,9,35,50,107,50,28,23,23,0,0,5,22,22,0,0,22,0
ACSSF,2010e5,wv,000,0034,0000974,070,54,095,07000US540959233499999,"Remainder of North district, North district, Tyler County, West Virginia",442,346,88,23,13,52,258,96,11,0,0,0,0,11,85,33,0,0,33,52
ACSSF,2010e5,wv,000,0034,0000975,070,54,095,07000US540959289899999,"South district, South district, Tyler County, West Virginia",748,554,182,17,36,129,372,194,111,57,24,0,33,54,83,10,0,0,10,73
ACSSF,2010e5,wv,000,0034,0000976,070,54,095,07000US540959359274380,"Sistersville city, West district, Tyler County, West Virginia",394,303,94,10,19,65,209,91,11,8,0,3,5,3,80,58,7,0,51,22
ACSSF,2010e5,wv,000,0034,0000977,070,54,095,07000US540959359299999,"Remainder of West district, West district, Tyler County, West Virginia",153,153,44,10,7,27,109,0,0,0,0,0,0,0,0,0,0,0,0,0
ACSSF,2010e5,wv,000,0034,0000978,070,54,097,07000US540979110211188,"Buckhannon city (part), First district, Upshur County, West Virginia",1014,729,284,73,61,150,445,285,14,6,6,0,0,8,271,142,0,58,84,129
ACSSF,2010e5,wv,000,0034,0000979,070,54,097,07000US540979110299999,"Remainder of First district, First district, Upshur County, West Virginia",582,422,212,41,0,171,210,160,98,26,0,0,26,72,62,21,21,0,0,41
ACSSF,2010e5,wv,000,0034,0000980,070,54,097,07000US540979274511188,"Buckhannon city (part), Second district, Upshur County, West Virginia",39,28,28,0,0,28,0,11,0,0,0,0,0,0,11,0,0,0,0,11
ACSSF,2010e5,wv,000,0034,0000981,070,54,097,07000US540979274599999,"Remainder of Second district, Second district, Upshur County, West Virginia",2335,2052,763,175,189,399,1289,283,111,16,16,0,0,95,172,114,15,64,35,58
ACSSF,2010e5,wv,000,0034,0000982,070,54,097,07000US540979310511188,"Buckhannon city (part), Third district, Upshur County, West Virginia",0,0,0,0,0,0,0,0,0,0,0,0,0,0,0,0,0,0,0,0
ACSSF,2010e5,wv,000,0034,0000983,070,54,097,07000US540979310599999,"Remainder of Third district, Third district, Upshur County, West Virginia",2226,1876,569,79,103,387,1307,350,126,82,22,31,29,44,224,72,0,55,17,152
ACSSF,2010e5,wv,000,0034,0000984,070,54,099,07000US540999032428516,"Fort Gay town, Butler district, Wayne County, West Virginia",206,140,47,4,23,20,93,66,23,8,0,0,8,15,43,14,0,0,14,29
ACSSF,2010e5,wv,000,0034,0000985,070,54,099,07000US540999032445580,"Lavalette CDP (part), Butler district, Wayne County, West Virginia",66,45,24,12,12,0,21,21,0,0,0,0,0,0,21,0,0,0,0,21
ACSSF,2010e5,wv,000,0034,0000986,070,54,099,07000US540999032465596,"Prichard CDP, Butler district, Wayne County, West Virginia",116,95,63,0,11,52,32,21,8,0,0,0,0,8,13,13,0,0,13,0
ACSSF,2010e5,wv,000,0034,0000987,070,54,099,07000US540999032499999,"Remainder of Butler district, Butler district, Wayne County, West Virginia",2102,1686,665,195,94,376,1021,416,99,34,0,34,0,65,317,72,0,15,57,245
ACSSF,2010e5,wv,000,0034,0000988,070,54,099,07000US540999049214308,"Ceredo city (part), Ceredo district, Wayne County, West Virginia",441,317,59,34,9,16,258,124,56,28,28,0,0,28,68,31,0,0,31,37
ACSSF,2010e5,wv,000,0034,0000989,070,54,099,07000US540999049243180,"Kenova city, Ceredo district, Wayne County, West Virginia",781,522,165,44,26,95,357,259,95,85,0,0,85,10,164,103,53,0,50,61
ACSSF,2010e5,wv,000,0034,0000990,070,54,099,07000US540999049299999,"Remainder of Ceredo district, Ceredo district, Wayne County, West Virginia",828,748,231,75,40,116,517,80,20,20,0,0,20,0,60,34,0,23,11,26
ACSSF,2010e5,wv,000,0034,0000991,070,54,099,07000US540999303619300,"Crum CDP, Stonewall district, Wayne County, West Virginia",37,24,8,0,0,8,16,13,0,0,0,0,0,0,13,0,0,0,0,13
ACSSF,2010e5,wv,000,0034,0000992,070,54,099,07000US540999303699999,"Remainder of Stonewall district, Stonewall district, Wayne County, West Virginia",2250,1785,579,63,130,386,1206,465,198,83,25,13,45,115,267,87,12,32,43,180
ACSSF,2010e5,wv,000,0034,0000993,070,54,099,07000US540999337245580,"Lavalette CDP (part), Union district, Wayne County, West Virginia",130,116,51,0,18,33,65,14,0,0,0,0,0,0,14,0,0,0,0,14
ACSSF,2010e5,wv,000,0034,0000994,070,54,099,07000US540999337284940,"Wayne town, Union district, Wayne County, West Virginia",484,357,162,62,8,92,195,127,25,0,0,0,0,25,102,67,19,0,48,35
ACSSF,2010e5,wv,000,0034,0000995,070,54,099,07000US540999337299999,"Remainder of Union district, Union district, Wayne County, West Virginia",2046,1759,750,217,117,416,1009,287,38,0,0,0,0,38,249,154,18,0,136,95
ACSSF,2010e5,wv,000,0034,0000996,070,54,099,07000US540999362414308,"Ceredo city (part), Westmoreland district, Wayne County, West Virginia",41,41,10,0,0,10,31,0,0,0,0,0,0,0,0,0,0,0,0,0
ACSSF,2010e5,wv,000,0034,0000997,070,54,099,07000US540999362439460,"Huntington city (part), Westmoreland district, Wayne County, West Virginia",1009,719,234,41,78,115,485,290,65,44,13,0,31,21,225,110,49,7,54,115
ACSSF,2010e5,wv,000,0034,0000998,070,54,099,07000US540999362499999,"Remainder of Westmoreland district, Westmoreland district, Wayne County, West Virginia",1219,905,292,31,95,166,613,314,10,0,0,0,0,10,304,236,48,14,174,68
ACSSF,2010e5,wv,000,0034,0000999,070,54,101,07000US541019047100364,"Addison (Webster Springs) town, Central district, Webster County, West Virginia",319,184,62,7,13,42,122,135,0,0,0,0,0,0,135,62,46,3,13,73
ACSSF,2010e5,wv,000,0034,0001000,070,54,101,07000US541019047199999,"Remainder of Central district, Central district, Webster County, West Virginia",593,515,263,10,41,212,252,78,26,4,4,0,0,22,52,19,19,0,0,33
ACSSF,2010e5,wv,000,0034,0001001,070,54,101,07000US541019236006436,"Bergoo CDP, Northern district, Webster County, West Virginia",15,0,0,0,0,0,0,15,0,0,0,0,0,0,15,15,0,0,15,0
ACSSF,2010e5,wv,000,0034,0001002,070,54,101,07000US541019236099999,"Remainder of Northern district, Northern district, Webster County, West Virginia",801,704,198,37,53,108,506,97,73,30,17,0,13,43,24,0,0,0,0,24
ACSSF,2010e5,wv,000,0034,0001003,070,54,101,07000US541019292512436,"Camden-on-Gauley town, Southern district, Webster County, West Virginia",30,16,0,0,0,0,16,14,0,0,0,0,0,0,14,5,1,0,4,9
ACSSF,2010e5,wv,000,0034,0001004,070,54,101,07000US541019292518412,"Cowen town, Southern district, Webster County, West Virginia",191,129,64,53,7,4,65,62,28,10,0,0,10,18,34,9,0,7,2,25
ACSSF,2010e5,wv,000,0034,0001005,070,54,101,07000US541019292599999,"Remainder of Southern district, Southern district, Webster County, West Virginia",978,817,297,42,64,191,520,161,89,79,36,0,43,10,72,72,53,0,19,0
ACSSF,2010e5,wv,000,0034,0001006,070,54,103,07000US541039079439340,"Hundred town, District 1, Wetzel County, West Virginia",78,73,27,5,3,19,46,5,2,0,0,0,0,2,3,3,0,0,3,0
ACSSF,2010e5,wv,000,0034,0001007,070,54,103,07000US541039079440636,"Jacksonburg CDP, District 1, Wetzel County, West Virginia",15,15,0,0,0,0,15,0,0,0,0,0,0,0,0,0,0,0,0,0
ACSSF,2010e5,wv,000,0034,0001008,070,54,103,07000US541039079447788,"Littleton CDP, District 1, Wetzel County, West Virginia",69,7,3,0,0,3,4,62,21,21,8,13,0,0,41,41,0,0,41,0
ACSSF,2010e5,wv,000,0034,0001009,070,54,103,07000US541039079463892,"Pine Grove town, District 1, Wetzel County, West Virginia",136,102,41,6,4,31,61,34,10,7,7,0,0,3,24,13,3,0,10,11
ACSSF,2010e5,wv,000,0034,0001010,070,54,103,07000US541039079467252,"Reader CDP, District 1, Wetzel County, West Virginia",202,152,86,36,0,50,66,50,22,22,0,0,22,0,28,28,11,0,17,0
ACSSF,2010e5,wv,000,0034,0001011,070,54,103,07000US541039079474788,"Smithfield town, District 1, Wetzel County, West Virginia",16,10,4,0,0,4,6,6,0,0,0,0,0,0,6,6,4,2,0,0
ACSSF,2010e5,wv,000,0034,0001012,070,54,103,07000US541039079499999,"District Remainder of 1, District 1, Wetzel County, West Virginia",1247,1134,383,64,61,258,751,113,76,31,0,0,31,45,37,11,11,0,0,26
ACSSF,2010e5,wv,000,0034,0001013,070,54,103,07000US541039083061636,"Paden City city (part), District 2, Wetzel County, West Virginia",466,345,105,20,32,53,240,121,16,7,0,0,7,9,105,69,34,0,35,36
ACSSF,2010e5,wv,000,0034,0001014,070,54,103,07000US541039083099999,"District Remainder of 2, District 2, Wetzel County, West Virginia",1129,885,307,59,63,185,578,244,35,16,16,0,0,19,209,104,0,72,32,105
ACSSF,2010e5,wv,000,0034,0001015,070,54,103,07000US541039086758684,"New Martinsville city, District 3, Wetzel County, West Virginia",1367,1122,319,57,62,200,803,245,16,0,0,0,0,16,229,74,17,0,57,155
ACSSF,2010e5,wv,000,0034,0001016,070,54,103,07000US541039086799999,"District Remainder of 3, District 3, Wetzel County, West Virginia",0,0,0,0,0,0,0,0,0,0,0,0,0,0,0,0,0,0,0,0
ACSSF,2010e5,wv,000,0034,0001017,070,54,105,07000US541059047324364,"Elizabeth town, Central district, Wirt County, West Virginia",341,215,79,0,30,49,136,126,39,31,14,0,17,8,87,79,17,12,50,8
ACSSF,2010e5,wv,000,0034,0001018,070,54,105,07000US541059047399999,"Remainder of Central district, Central district, Wirt County, West Virginia",307,261,27,0,27,0,234,46,25,0,0,0,0,25,21,0,0,0,0,21
ACSSF,2010e5,wv,000,0034,0001019,070,54,105,07000US541059234499999,"Northeast district, Northeast district, Wirt County, West Virginia",545,467,155,0,24,131,312,78,0,0,0,0,0,0,78,50,0,0,50,28
ACSSF,2010e5,wv,000,0034,0001020,070,54,105,07000US541059295899999,"Southwest district, Southwest district, Wirt County, West Virginia",504,504,180,112,21,47,324,0,0,0,0,0,0,0,0,0,0,0,0,0
ACSSF,2010e5,wv,000,0034,0001021,070,54,107,07000US541079058899999,"Clay district, Clay district, Wood County, West Virginia",1732,1457,535,115,165,255,922,275,36,5,5,0,0,31,239,166,46,25,95,73
ACSSF,2010e5,wv,000,0034,0001022,070,54,107,07000US541079156099999,"Harris district, Harris district, Wood County, West Virginia",540,501,173,28,12,133,328,39,15,15,0,0,15,0,24,24,0,0,24,0
ACSSF,2010e5,wv,000,0034,0001023,070,54,107,07000US541079198008308,"Blennerhassett CDP, Lubeck district, Wood County, West Virginia",941,685,135,19,8,108,550,256,97,19,4,0,15,78,159,57,0,19,38,102
ACSSF,2010e5,wv,000,0034,0001024,070,54,107,07000US541079198049156,"Lubeck CDP, Lubeck district, Wood County, West Virginia",375,274,130,20,11,99,144,101,83,83,31,0,52,0,18,18,0,0,18,0
ACSSF,2010e5,wv,000,0034,0001025,070,54,107,07000US541079198062140,"Parkersburg city (part), Lubeck district, Wood County, West Virginia",285,266,59,0,21,38,207,19,19,19,19,0,0,0,0,0,0,0,0,0
ACSSF,2010e5,wv,000,0034,0001026,070,54,107,07000US541079198084724,"Washington CDP, Lubeck district, Wood County, West Virginia",475,440,214,69,38,107,226,35,0,0,0,0,0,0,35,9,0,0,9,26
ACSSF,2010e5,wv,000,0034,0001027,070,54,107,07000US541079198099999,"Remainder of Lubeck district, Lubeck district, Wood County, West Virginia",1041,905,386,84,77,225,519,136,10,0,0,0,0,10,126,115,76,7,32,11
ACSSF,2010e5,wv,000,0034,0001028,070,54,107,07000US541079242459458,"North Hills town (part), Parkersburg district, Wood County, West Virginia",70,53,15,0,5,10,38,17,17,17,0,0,17,0,0,0,0,0,0,0
ACSSF,2010e5,wv,000,0034,0001029,070,54,107,07000US541079242462140,"Parkersburg city (part), Parkersburg district, Wood County, West Virginia",5240,3384,1244,259,187,798,2140,1856,389,244,7,107,130,145,1467,727,232,74,421,740
ACSSF,2010e5,wv,000,0034,0001030,070,54,107,07000US541079242483500,"Vienna city (part), Parkersburg district, Wood County, West Virginia",1269,1048,258,43,84,131,790,221,67,13,0,0,13,54,154,55,0,0,55,99
ACSSF,2010e5,wv,000,0034,0001031,070,54,107,07000US541079242499999,"Remainder of Parkersburg district, Parkersburg district, Wood County, West Virginia",640,460,117,6,11,100,343,180,92,92,59,0,33,0,88,37,18,0,19,51
ACSSF,2010e5,wv,000,0034,0001032,070,54,107,07000US541079285654580,"Mineralwells CDP, Slate district, Wood County, West Virginia",495,415,179,0,33,146,236,80,26,0,0,0,0,26,54,41,0,19,22,13
ACSSF,2010e5,wv,000,0034,0001033,070,54,107,07000US541079285699999,"Remainder of Slate district, Slate district, Wood County, West Virginia",813,698,364,83,83,198,334,115,42,14,0,0,14,28,73,59,28,15,16,14
ACSSF,2010e5,wv,000,0034,0001034,070,54,107,07000US541079302499999,"Steele district, Steele district, Wood County, West Virginia",339,288,130,0,9,121,158,51,10,10,0,0,10,0,41,19,19,0,0,22
ACSSF,2010e5,wv,000,0034,0001035,070,54,107,07000US541079318062140,"Parkersburg city (part), Tygart district, Wood County, West Virginia",2686,1895,573,109,125,339,1322,791,106,70,50,0,20,36,685,362,126,49,187,323
ACSSF,2010e5,wv,000,0034,0001036,070,54,107,07000US541079318099999,"Remainder of Tygart district, Tygart district, Wood County, West Virginia",986,813,195,57,27,111,618,173,37,0,0,0,0,37,136,95,12,0,83,41
ACSSF,2010e5,wv,000,0034,0001037,070,54,107,07000US541079338484916,"Waverly CDP, Union district, Wood County, West Virginia",156,141,38,0,0,38,103,15,0,0,0,0,0,0,15,15,0,0,15,0
ACSSF,2010e5,wv,000,0034,0001038,070,54,107,07000US541079338499999,"Remainder of Union district, Union district, Wood County, West Virginia",1317,1157,374,59,41,274,783,160,105,30,22,0,8,75,55,45,0,26,19,10
ACSSF,2010e5,wv,000,0034,0001039,070,54,107,07000US541079344499999,"Walker district, Walker district, Wood County, West Virginia",308,237,81,29,14,38,156,71,46,0,0,0,0,46,25,18,18,0,0,7
ACSSF,2010e5,wv,000,0034,0001040,070,54,107,07000US541079367208836,"Boaz CDP, Williams district, Wood County, West Virginia",504,426,188,44,53,91,238,78,24,24,0,0,24,0,54,54,18,8,28,0
ACSSF,2010e5,wv,000,0034,0001041,070,54,107,07000US541079367259458,"North Hills town (part), Williams district, Wood County, West Virginia",177,156,76,1,24,51,80,21,13,10,10,0,0,3,8,8,0,0,8,0
ACSSF,2010e5,wv,000,0034,0001042,070,54,107,07000US541079367283500,"Vienna city (part), Williams district, Wood County, West Virginia",1747,1500,634,175,94,365,866,247,83,50,35,0,15,33,164,90,23,10,57,74
ACSSF,2010e5,wv,000,0034,0001043,070,54,107,07000US541079367287556,"Williamstown city, Williams district, Wood County, West Virginia",815,649,257,27,24,206,392,166,61,51,0,0,51,10,105,79,0,26,53,26
ACSSF,2010e5,wv,000,0034,0001044,070,54,107,07000US541079367299999,"Remainder of Williams district, Williams district, Wood County, West Virginia",983,793,311,11,71,229,482,190,22,22,11,0,11,0,168,75,34,0,41,93
ACSSF,2010e5,wv,000,0034,0001045,070,54,109,07000US541099079511212,"Bud CDP, District 1, Wyoming County, West Virginia",64,43,0,0,0,0,43,21,0,0,0,0,0,0,21,21,21,0,0,0
ACSSF,2010e5,wv,000,0034,0001046,070,54,109,07000US541099079517836,"Corinne CDP, District 1, Wyoming County, West Virginia",98,63,21,0,0,21,42,35,17,17,0,0,17,0,18,18,0,0,18,0
ACSSF,2010e5,wv,000,0034,0001047,070,54,109,07000US541099079518388,"Covel CDP, District 1, Wyoming County, West Virginia",19,19,0,0,0,0,19,0,0,0,0,0,0,0,0,0,0,0,0,0
ACSSF,2010e5,wv,000,0034,0001048,070,54,109,07000US541099079531756,"Glen Fork CDP, District 1, Wyoming County, West Virginia",39,39,0,0,0,0,39,0,0,0,0,0,0,0,0,0,0,0,0,0
ACSSF,2010e5,wv,000,0034,0001049,070,54,109,07000US541099079540444,"Itmann CDP, District 1, Wyoming County, West Virginia",107,107,0,0,0,0,107,0,0,0,0,0,0,0,0,0,0,0,0,0
ACSSF,2010e5,wv,000,0034,0001050,070,54,109,07000US541099079557148,"Mullens city, District 1, Wyoming County, West Virginia",436,321,134,56,24,54,187,115,20,3,0,0,3,17,95,60,34,0,26,35
ACSSF,2010e5,wv,000,0034,0001051,070,54,109,07000US541099079599999,"District Remainder of 1, District 1, Wyoming County, West Virginia",1189,932,271,33,22,216,661,257,50,37,0,0,37,13,207,135,67,0,68,72
ACSSF,2010e5,wv,000,0034,0001052,070,54,109,07000US541099083109964,"Brenton CDP, District 2, Wyoming County, West Virginia",53,53,40,0,13,27,13,0,0,0,0,0,0,0,0,0,0,0,0,0
ACSSF,2010e5,wv,000,0034,0001053,070,54,109,07000US541099083158756,"New Richmond CDP, District 2, Wyoming County, West Virginia",38,38,18,0,18,0,20,0,0,0,0,0,0,0,0,0,0,0,0,0
ACSSF,2010e5,wv,000,0034,0001054,070,54,109,07000US541099083163940,"Pineville town, District 2, Wyoming County, West Virginia",241,196,43,12,6,25,153,45,8,0,0,0,0,8,37,19,6,0,13,18
ACSSF,2010e5,wv,000,0034,0001055,070,54,109,07000US541099083199999,"District Remainder of 2, District 2, Wyoming County, West Virginia",1775,1501,650,130,80,440,851,274,79,24,0,0,24,55,195,48,0,0,48,147
ACSSF,2010e5,wv,000,0034,0001056,070,54,109,07000US541099086844548,"Kopperston CDP, District 3, Wyoming County, West Virginia",188,174,127,15,29,83,47,14,0,0,0,0,0,0,14,14,0,0,14,0
ACSSF,2010e5,wv,000,0034,0001057,070,54,109,07000US541099086852372,"Matheny CDP, District 3, Wyoming County, West Virginia",172,118,16,16,0,0,102,54,0,0,0,0,0,0,54,12,0,0,12,42
ACSSF,2010e5,wv,000,0034,0001058,070,54,109,07000US541099086860364,"Oceana town, District 3, Wyoming County, West Virginia",435,315,115,16,32,67,200,120,28,17,0,0,17,11,92,54,11,18,25,38
ACSSF,2010e5,wv,000,0034,0001059,070,54,109,07000US541099086899999,"District Remainder of 3, District 3, Wyoming County, West Virginia",1711,1369,408,68,64,276,961,342,117,35,0,0,35,82,225,118,18,22,78,107
ACSSF,2010e5,wv,000,0034,0001060,080,54,001,08000US540019232863292965600,"Census Tract 9656 (part), Philippi city (part), North district, Barbour County, West Virginia",395,259,30,0,20,10,229,136,25,0,0,0,0,25,111,97,31,0,66,14
ACSSF,2010e5,wv,000,0034,0001061,080,54,001,08000US540019232863292965700,"Census Tract 9657 (part), Philippi city (part), North district, Barbour County, West Virginia",64,43,9,0,0,9,34,21,0,0,0,0,0,0,21,0,0,0,0,21
ACSSF,2010e5,wv,000,0034,0001062,080,54,001,08000US540019232899999965600,"Census Tract 9656 (part), Remainder of North district, North district, Barbour County, West Virginia",137,137,43,0,0,43,94,0,0,0,0,0,0,0,0,0,0,0,0,0
ACSSF,2010e5,wv,000,0034,0001063,080,54,001,08000US540019232899999965700,"Census Tract 9657 (part), Remainder of North district, North district, Barbour County, West Virginia",1108,884,227,56,52,119,657,224,113,55,9,32,14,58,111,56,0,51,5,55
ACSSF,2010e5,wv,000,0034,0001064,080,54,001,08000US540019289205788965800,"Census Tract 9658 (part), Belington town, South district, Barbour County, West Virginia",570,409,129,26,22,81,280,161,45,28,9,3,16,17,116,59,3,5,51,57
ACSSF,2010e5,wv,000,0034,0001065,080,54,001,08000US540019289242244965800,"Census Tract 9658 (part), Junior town, South district, Barbour County, West Virginia",93,63,22,0,6,16,41,30,16,9,3,0,6,7,14,4,0,0,4,10
ACSSF,2010e5,wv,000,0034,0001066,080,54,001,08000US540019289299999965500,"Census Tract 9655 (part), Remainder of South district, South district, Barbour County, West Virginia",293,242,74,0,0,74,168,51,10,0,0,0,0,10,41,0,0,0,0,41
ACSSF,2010e5,wv,000,0034,0001067,080,54,001,08000US540019289299999965700,"Census Tract 9657 (part), Remainder of South district, South district, Barbour County, West Virginia",257,216,50,0,0,50,166,41,21,0,0,0,0,21,20,13,0,0,13,7
ACSSF,2010e5,wv,000,0034,0001068,080,54,001,08000US540019289299999965800,"Census Tract 9658 (part), Remainder of South district, South district, Barbour County, West Virginia",310,254,130,31,45,54,124,56,25,0,0,0,0,25,31,10,0,0,10,21
ACSSF,2010e5,wv,000,0034,0001069,080,54,001,08000US540019358814212965500,"Census Tract 9655 (part), Century CDP, West district, Barbour County, West Virginia",21,21,13,0,0,13,8,0,0,0,0,0,0,0,0,0,0,0,0,0
ACSSF,2010e5,wv,000,0034,0001070,080,54,001,08000US540019358829740965500,"Census Tract 9655 (part), Galloway CDP, West district, Barbour County, West Virginia",51,28,0,0,0,0,28,23,0,0,0,0,0,0,23,23,0,0,23,0
ACSSF,2010e5,wv,000,0034,0001071,080,54,001,08000US540019358863292965500,"Census Tract 9655 (part), Philippi city (part), West district, Barbour County, West Virginia",36,0,0,0,0,0,0,36,0,0,0,0,0,0,36,30,0,0,30,6
ACSSF,2010e5,wv,000,0034,0001072,080,54,001,08000US540019358863292965600,"Census Tract 9656 (part), Philippi city (part), West district, Barbour County, West Virginia",199,181,38,28,0,10,143,18,18,18,0,0,18,0,0,0,0,0,0,0
ACSSF,2010e5,wv,000,0034,0001073,080,54,001,08000US540019358899999965500,"Census Tract 9655 (part), Remainder of West district, West district, Barbour County, West Virginia",667,523,125,33,18,74,398,144,68,18,0,0,18,50,76,50,0,50,0,26
ACSSF,2010e5,wv,000,0034,0001074,080,54,001,08000US540019358899999965600,"Census Tract 9656 (part), Remainder of West district, West district, Barbour County, West Virginia",44,44,14,0,0,14,30,0,0,0,0,0,0,0,0,0,0,0,0,0
ACSSF,2010e5,wv,000,0034,0001075,080,54,003,08000US540039000652060971300,"Census Tract 9713 (part), Martinsburg city (part), Adam Stephens district, Berkeley County, West Virginia",107,67,0,0,0,0,67,40,0,0,0,0,0,0,40,40,40,0,0,0
ACSSF,2010e5,wv,000,0034,0001076,080,54,003,08000US540039000652060971400,"Census Tract 9714 (part), Martinsburg city (part), Adam Stephens district, Berkeley County, West Virginia",123,61,16,16,0,0,45,62,0,0,0,0,0,0,62,53,0,0,53,9
ACSSF,2010e5,wv,000,0034,0001077,080,54,003,08000US540039000652060971500,"Census Tract 9715 (part), Martinsburg city (part), Adam Stephens district, Berkeley County, West Virginia",773,440,68,29,22,17,372,333,226,167,45,48,74,59,107,60,14,3,43,47
ACSSF,2010e5,wv,000,0034,0001078,080,54,003,08000US540039000652060971600,"Census Tract 9716 (part), Martinsburg city (part), Adam Stephens district, Berkeley County, West Virginia",1098,919,342,70,130,142,577,179,15,15,0,0,15,0,164,38,12,26,0,126
ACSSF,2010e5,wv,000,0034,0001079,080,54,003,08000US540039000652060971700,"Census Tract 9717 (part), Martinsburg city (part), Adam Stephens district, Berkeley County, West Virginia",1217,624,235,89,31,115,389,593,133,102,28,61,13,31,460,307,169,29,109,153
ACSSF,2010e5,wv,000,0034,0001080,080,54,003,08000US540039000652060972000,"Census Tract 9720 (part), Martinsburg city (part), Adam Stephens district, Berkeley County, West Virginia",11,0,0,0,0,0,0,11,0,0,0,0,0,0,11,11,0,0,11,0
ACSSF,2010e5,wv,000,0034,0001081,080,54,003,08000US540039000699999971300,"Census Tract 9713 (part), Remainder of Adam Stephens district, Adam Stephens district, Berkeley County, West Virginia",9,0,0,0,0,0,0,9,0,0,0,0,0,0,9,0,0,0,0,9
ACSSF,2010e5,wv,000,0034,0001082,080,54,003,08000US540039000699999971400,"Census Tract 9714 (part), Remainder of Adam Stephens district, Adam Stephens district, Berkeley County, West Virginia",0,0,0,0,0,0,0,0,0,0,0,0,0,0,0,0,0,0,0,0
ACSSF,2010e5,wv,000,0034,0001083,080,54,003,08000US540039000699999971500,"Census Tract 9715 (part), Remainder of Adam Stephens district, Adam Stephens district, Berkeley County, West Virginia",32,32,32,0,0,32,0,0,0,0,0,0,0,0,0,0,0,0,0,0
ACSSF,2010e5,wv,000,0034,0001084,080,54,003,08000US540039000699999971600,"Census Tract 9716 (part), Remainder of Adam Stephens district, Adam Stephens district, Berkeley County, West Virginia",20,20,0,0,0,0,20,0,0,0,0,0,0,0,0,0,0,0,0,0
ACSSF,2010e5,wv,000,0034,0001085,080,54,003,08000US540039000699999971700,"Census Tract 9717 (part), Remainder of Adam Stephens district, Adam Stephens district, Berkeley County, West Virginia",68,68,14,0,0,14,54,0,0,0,0,0,0,0,0,0,0,0,0,0
ACSSF,2010e5,wv,000,0034,0001086,080,54,003,08000US540039000699999971900,"Census Tract 9719 (part), Remainder of Adam Stephens district, Adam Stephens district, Berkeley County, West Virginia",58,39,0,0,0,0,39,19,12,12,0,0,12,0,7,0,0,0,0,7
ACSSF,2010e5,wv,000,0034,0001087,080,54,003,08000US540039232236220971201,"Census Tract 9712.01 (part), Hedgesville town (part), Norborne district, Berkeley County, West Virginia",63,47,26,2,3,21,21,16,3,0,0,0,0,3,13,10,4,2,4,3
ACSSF,2010e5,wv,000,0034,0001088,080,54,003,08000US540039232252060971300,"Census Tract 9713 (part), Martinsburg city (part), Norborne district, Berkeley County, West Virginia",297,193,65,0,0,65,128,104,0,0,0,0,0,0,104,104,64,0,40,0
ACSSF,2010e5,wv,000,0034,0001089,080,54,003,08000US540039232252060971600,"Census Tract 9716 (part), Martinsburg city (part), Norborne district, Berkeley County, West Virginia",0,0,0,0,0,0,0,0,0,0,0,0,0,0,0,0,0,0,0,0
ACSSF,2010e5,wv,000,0034,0001090,080,54,003,08000US540039232252060971900,"Census Tract 9719 (part), Martinsburg city (part), Norborne district, Berkeley County, West Virginia",333,270,170,43,25,102,100,63,29,29,0,0,29,0,34,34,25,0,9,0
ACSSF,2010e5,wv,000,0034,0001091,080,54,003,08000US540039232299999971201,"Census Tract 9712.01 (part), Remainder of Norborne district, Norborne district, Berkeley County, West Virginia",1702,1378,574,100,123,351,804,324,163,101,0,43,58,62,161,134,27,14,93,27
ACSSF,2010e5,wv,000,0034,0001092,080,54,003,08000US540039232299999971300,"Census Tract 9713 (part), Remainder of Norborne district, Norborne district, Berkeley County, West Virginia",152,116,57,45,12,0,59,36,5,5,5,0,0,0,31,10,0,0,10,21
ACSSF,2010e5,wv,000,0034,0001093,080,54,003,08000US540039232299999971600,"Census Tract 9716 (part), Remainder of Norborne district, Norborne district, Berkeley County, West Virginia",0,0,0,0,0,0,0,0,0,0,0,0,0,0,0,0,0,0,0,0
ACSSF,2010e5,wv,000,0034,0001094,080,54,003,08000US540039232299999971800,"Census Tract 9718 (part), Remainder of Norborne district, Norborne district, Berkeley County, West Virginia",0,0,0,0,0,0,0,0,0,0,0,0,0,0,0,0,0,0,0,0
ACSSF,2010e5,wv,000,0034,0001095,080,54,003,08000US540039232299999971900,"Census Tract 9719 (part), Remainder of Norborne district, Norborne district, Berkeley County, West Virginia",211,178,80,0,0,80,98,33,0,0,0,0,0,0,33,10,0,0,10,23
ACSSF,2010e5,wv,000,0034,0001096,080,54,003,08000US540039252626716971101,"Census Tract 9711.01 (part), Falling Waters CDP, Potomac district, Berkeley County, West Virginia",233,216,84,0,64,20,132,17,2,0,0,0,0,2,15,8,0,0,8,7
ACSSF,2010e5,wv,000,0034,0001097,080,54,003,08000US540039252652060971300,"Census Tract 9713 (part), Martinsburg city (part), Potomac district, Berkeley County, West Virginia",0,0,0,0,0,0,0,0,0,0,0,0,0,0,0,0,0,0,0,0
ACSSF,2010e5,wv,000,0034,0001098,080,54,003,08000US540039252699999971101,"Census Tract 9711.01 (part), Remainder of Potomac district, Potomac district, Berkeley County, West Virginia",813,679,209,48,24,137,470,134,30,30,14,0,16,0,104,55,9,31,15,49
ACSSF,2010e5,wv,000,0034,0001099,080,54,003,08000US540039252699999971102,"Census Tract 9711.02 (part), Remainder of Potomac district, Potomac district, Berkeley County, West Virginia",2490,2110,811,206,145,460,1299,380,157,134,40,28,66,23,223,70,25,0,45,153
ACSSF,2010e5,wv,000,0034,0001100,080,54,003,08000US540039252699999971300,"Census Tract 9713 (part), Remainder of Potomac district, Potomac district, Berkeley County, West Virginia",682,452,223,51,47,125,229,230,30,30,17,13,0,0,200,108,52,34,22,92
ACSSF,2010e5,wv,000,0034,0001101,080,54,003,08000US540039275440204972101,"Census Tract 9721.01 (part), Inwood CDP, Shenandoah district, Berkeley County, West Virginia",0,0,0,0,0,0,0,0,0,0,0,0,0,0,0,0,0,0,0,0
ACSSF,2010e5,wv,000,0034,0001102,080,54,003,08000US540039275440204972102,"Census Tract 9721.02 (part), Inwood CDP, Shenandoah district, Berkeley County, West Virginia",819,668,217,36,75,106,451,151,87,38,19,19,0,49,64,11,0,0,11,53
ACSSF,2010e5,wv,000,0034,0001103,080,54,003,08000US540039275499999971900,"Census Tract 9719 (part), Remainder of Shenandoah district, Shenandoah district, Berkeley County, West Virginia",633,498,311,69,55,187,187,135,43,16,16,0,0,27,92,64,0,0,64,28
ACSSF,2010e5,wv,000,0034,0001104,080,54,003,08000US540039275499999972000,"Census Tract 9720 (part), Remainder of Shenandoah district, Shenandoah district, Berkeley County, West Virginia",1003,721,349,107,54,188,372,282,118,56,0,23,33,62,164,102,0,5,97,62
ACSSF,2010e5,wv,000,0034,0001105,080,54,003,08000US540039275499999972101,"Census Tract 9721.01 (part), Remainder of Shenandoah district, Shenandoah district, Berkeley County, West Virginia",1231,864,299,72,8,219,565,367,179,130,31,0,99,49,188,50,21,0,29,138
ACSSF,2010e5,wv,000,0034,0001106,080,54,003,08000US540039275499999972102,"Census Tract 9721.02 (part), Remainder of Shenandoah district, Shenandoah district, Berkeley County, West Virginia",1382,1023,438,110,56,272,585,359,89,50,0,0,50,39,270,161,54,0,107,109
ACSSF,2010e5,wv,000,0034,0001107,080,54,003,08000US540039317152060971300,"Census Tract 9713 (part), Martinsburg city (part), Tuscarora district, Berkeley County, West Virginia",0,0,0,0,0,0,0,0,0,0,0,0,0,0,0,0,0,0,0,0
ACSSF,2010e5,wv,000,0034,0001108,080,54,003,08000US540039317152060971400,"Census Tract 9714 (part), Martinsburg city (part), Tuscarora district, Berkeley County, West Virginia",76,29,0,0,0,0,29,47,14,14,14,0,0,0,33,13,13,0,0,20
ACSSF,2010e5,wv,000,0034,0001109,080,54,003,08000US540039317152060971500,"Census Tract 9715 (part), Martinsburg city (part), Tuscarora district, Berkeley County, West Virginia",14,0,0,0,0,0,0,14,0,0,0,0,0,0,14,0,0,0,0,14
ACSSF,2010e5,wv,000,0034,0001110,080,54,003,08000US540039317152060971900,"Census Tract 9719 (part), Martinsburg city (part), Tuscarora district, Berkeley County, West Virginia",0,0,0,0,0,0,0,0,0,0,0,0,0,0,0,0,0,0,0,0
ACSSF,2010e5,wv,000,0034,0001111,080,54,003,08000US540039317152060972000,"Census Tract 9720 (part), Martinsburg city (part), Tuscarora district, Berkeley County, West Virginia",157,136,83,32,18,33,53,21,0,0,0,0,0,0,21,21,0,0,21,0
ACSSF,2010e5,wv,000,0034,0001112,080,54,003,08000US540039317199999971300,"Census Tract 9713 (part), Remainder of Tuscarora district, Tuscarora district, Berkeley County, West Virginia",1072,838,317,77,56,184,521,234,68,29,0,0,29,39,166,99,0,37,62,67
ACSSF,2010e5,wv,000,0034,0001113,080,54,003,08000US540039317199999971400,"Census Tract 9714 (part), Remainder of Tuscarora district, Tuscarora district, Berkeley County, West Virginia",2325,1968,806,247,139,420,1162,357,102,12,3,0,9,90,255,162,87,0,75,93
ACSSF,2010e5,wv,000,0034,0001114,080,54,003,08000US540039317199999971500,"Census Tract 9715 (part), Remainder of Tuscarora district, Tuscarora district, Berkeley County, West Virginia",77,59,25,25,0,0,34,18,0,0,0,0,0,0,18,18,12,0,6,0
ACSSF,2010e5,wv,000,0034,0001115,080,54,003,08000US540039317199999971900,"Census Tract 9719 (part), Remainder of Tuscarora district, Tuscarora district, Berkeley County, West Virginia",74,64,10,10,0,0,54,10,0,0,0,0,0,0,10,0,0,0,0,10
ACSSF,2010e5,wv,000,0034,0001116,080,54,003,08000US540039317199999972000,"Census Tract 9720 (part), Remainder of Tuscarora district, Tuscarora district, Berkeley County, West Virginia",1424,939,522,186,157,179,417,485,50,19,7,0,12,31,435,322,94,98,130,113
ACSSF,2010e5,wv,000,0034,0001117,080,54,003,08000US540039338836220971201,"Census Tract 9712.01 (part), Hedgesville town (part), Valley district, Berkeley County, West Virginia",0,0,0,0,0,0,0,0,0,0,0,0,0,0,0,0,0,0,0,0
ACSSF,2010e5,wv,000,0034,0001118,080,54,003,08000US540039338899999971102,"Census Tract 9711.02 (part), Remainder of Valley district, Valley district, Berkeley County, West Virginia",0,0,0,0,0,0,0,0,0,0,0,0,0,0,0,0,0,0,0,0
ACSSF,2010e5,wv,000,0034,0001119,080,54,003,08000US540039338899999971201,"Census Tract 9712.01 (part), Remainder of Valley district, Valley district, Berkeley County, West Virginia",778,604,166,33,30,103,438,174,54,37,0,0,37,17,120,6,6,0,0,114
ACSSF,2010e5,wv,000,0034,0001120,080,54,003,08000US540039338899999971202,"Census Tract 9712.02, Remainder of Valley district, Valley district, Berkeley County, West Virginia",1785,1415,531,96,115,320,884,370,142,48,22,0,26,94,228,89,15,24,50,139
ACSSF,2010e5,wv,000,0034,0001121,080,54,003,08000US540039338899999971800,"Census Tract 9718 (part), Remainder of Valley district, Valley district, Berkeley County, West Virginia",2165,1662,674,138,209,327,988,503,245,143,55,38,50,102,258,122,67,0,55,136
ACSSF,2010e5,wv,000,0034,0001122,080,54,003,08000US540039338899999971900,"Census Tract 9719 (part), Remainder of Valley district, Valley district, Berkeley County, West Virginia",968,826,226,41,34,151,600,142,22,22,22,0,0,0,120,71,13,0,58,49
ACSSF,2010e5,wv,000,0034,0001123,080,54,003,08000US540039338899999972102,"Census Tract 9721.02 (part), Remainder of Valley district, Valley district, Berkeley County, West Virginia",0,0,0,0,0,0,0,0,0,0,0,0,0,0,0,0,0,0,0,0
ACSSF,2010e5,wv,000,0034,0001124,080,54,005,08000US540059076217380958501,"Census Tract 9585.01 (part), Comfort CDP, District 1, Boone County, West Virginia",26,15,0,0,0,0,15,11,0,0,0,0,0,0,11,0,0,0,0,11
ACSSF,2010e5,wv,000,0034,0001125,080,54,005,08000US540059076217380958600,"Census Tract 9586 (part), Comfort CDP, District 1, Boone County, West Virginia",107,107,85,0,0,85,22,0,0,0,0,0,0,0,0,0,0,0,0,0
ACSSF,2010e5,wv,000,0034,0001126,080,54,005,08000US540059076266484958501,"Census Tract 9585.01 (part), Racine CDP, District 1, Boone County, West Virginia",86,86,32,32,0,0,54,0,0,0,0,0,0,0,0,0,0,0,0,0
ACSSF,2010e5,wv,000,0034,0001127,080,54,005,08000US540059076266484958600,"Census Tract 9586 (part), Racine CDP, District 1, Boone County, West Virginia",0,0,0,0,0,0,0,0,0,0,0,0,0,0,0,0,0,0,0,0
ACSSF,2010e5,wv,000,0034,0001128,080,54,005,08000US540059076278964958501,"Census Tract 9585.01 (part), Sylvester town, District 1, Boone County, West Virginia",42,42,14,8,0,6,28,0,0,0,0,0,0,0,0,0,0,0,0,0
ACSSF,2010e5,wv,000,0034,0001129,080,54,005,08000US540059076278964958600,"Census Tract 9586 (part), Sylvester town, District 1, Boone County, West Virginia",0,0,0,0,0,0,0,0,0,0,0,0,0,0,0,0,0,0,0,0
ACSSF,2010e5,wv,000,0034,0001130,080,54,005,08000US540059076286836958501,"Census Tract 9585.01 (part), Whitesville town, District 1, Boone County, West Virginia",96,82,36,4,0,32,46,14,0,0,0,0,0,0,14,5,5,0,0,9
ACSSF,2010e5,wv,000,0034,0001131,080,54,005,08000US540059076286836958600,"Census Tract 9586 (part), Whitesville town, District 1, Boone County, West Virginia",45,34,23,4,4,15,11,11,0,0,0,0,0,0,11,6,0,0,6,5
ACSSF,2010e5,wv,000,0034,0001132,080,54,005,08000US540059076299999958200,"Census Tract 9582 (part), District Remainder of 1, District 1, Boone County, West Virginia",841,644,234,27,30,177,410,197,43,0,0,0,0,43,154,70,7,0,63,84
ACSSF,2010e5,wv,000,0034,0001133,080,54,005,08000US540059076299999958501,"Census Tract 9585.01 (part), District Remainder of 1, District 1, Boone County, West Virginia",690,457,259,19,77,163,198,233,80,0,0,0,0,80,153,0,0,0,0,153
ACSSF,2010e5,wv,000,0034,0001134,080,54,005,08000US540059076299999958502,"Census Tract 9585.02 (part), District Remainder of 1, District 1, Boone County, West Virginia",0,0,0,0,0,0,0,0,0,0,0,0,0,0,0,0,0,0,0,0
ACSSF,2010e5,wv,000,0034,0001135,080,54,005,08000US540059076299999958600,"Census Tract 9586 (part), District Remainder of 1, District 1, Boone County, West Virginia",601,443,167,21,51,95,276,158,78,27,0,0,27,51,80,80,21,49,10,0
ACSSF,2010e5,wv,000,0034,0001136,080,54,005,08000US540059079633580958800,"Census Tract 9588 (part), Greenview CDP, District 2, Boone County, West Virginia",117,81,32,0,32,0,49,36,0,0,0,0,0,0,36,36,0,0,36,0
ACSSF,2010e5,wv,000,0034,0001137,080,54,005,08000US540059079650524958502,"Census Tract 9585.02 (part), Madison city (part), District 2, Boone County, West Virginia",115,57,43,0,43,0,14,58,33,14,0,0,14,19,25,0,0,0,0,25
ACSSF,2010e5,wv,000,0034,0001138,080,54,005,08000US540059079650524958800,"Census Tract 9588 (part), Madison city (part), District 2, Boone County, West Virginia",65,65,8,0,0,8,57,0,0,0,0,0,0,0,0,0,0,0,0,0
ACSSF,2010e5,wv,000,0034,0001139,080,54,005,08000US540059079681484958502,"Census Tract 9585.02 (part), Twilight CDP, District 2, Boone County, West Virginia",0,0,0,0,0,0,0,0,0,0,0,0,0,0,0,0,0,0,0,0
ACSSF,2010e5,wv,000,0034,0001140,080,54,005,08000US540059079681484958700,"Census Tract 9587 (part), Twilight CDP, District 2, Boone County, West Virginia",0,0,0,0,0,0,0,0,0,0,0,0,0,0,0,0,0,0,0,0
ACSSF,2010e5,wv,000,0034,0001141,080,54,005,08000US540059079682852958502,"Census Tract 9585.02 (part), Van CDP, District 2, Boone County, West Virginia",0,0,0,0,0,0,0,0,0,0,0,0,0,0,0,0,0,0,0,0
ACSSF,2010e5,wv,000,0034,0001142,080,54,005,08000US540059079682852958700,"Census Tract 9587 (part), Van CDP, District 2, Boone County, West Virginia",15,15,0,0,0,0,15,0,0,0,0,0,0,0,0,0,0,0,0,0
ACSSF,2010e5,wv,000,0034,0001143,080,54,005,08000US540059079682852958800,"Census Tract 9588 (part), Van CDP, District 2, Boone County, West Virginia",47,32,0,0,0,0,32,15,15,0,0,0,0,15,0,0,0,0,0,0
ACSSF,2010e5,wv,000,0034,0001144,080,54,005,08000US540059079699999958300,"Census Tract 9583 (part), District Remainder of 2, District 2, Boone County, West Virginia",508,424,163,19,0,144,261,84,52,18,0,0,18,34,32,15,15,0,0,17
ACSSF,2010e5,wv,000,0034,0001145,080,54,005,08000US540059079699999958502,"Census Tract 9585.02 (part), District Remainder of 2, District 2, Boone County, West Virginia",249,213,56,35,0,21,157,36,20,20,20,0,0,0,16,0,0,0,0,16
ACSSF,2010e5,wv,000,0034,0001146,080,54,005,08000US540059079699999958700,"Census Tract 9587 (part), District Remainder of 2, District 2, Boone County, West Virginia",447,341,186,43,30,113,155,106,35,35,17,0,18,0,71,0,0,0,0,71
ACSSF,2010e5,wv,000,0034,0001147,080,54,005,08000US540059079699999958800,"Census Tract 9588 (part), District Remainder of 2, District 2, Boone County, West Virginia",455,406,126,10,45,71,280,49,18,18,0,0,18,0,31,31,17,0,14,0
ACSSF,2010e5,wv,000,0034,0001148,080,54,005,08000US540059083220212958200,"Census Tract 9582 (part), Danville town, District 3, Boone County, West Virginia",0,0,0,0,0,0,0,0,0,0,0,0,0,0,0,0,0,0,0,0
ACSSF,2010e5,wv,000,0034,0001149,080,54,005,08000US540059083220212958300,"Census Tract 9583 (part), Danville town, District 3, Boone County, West Virginia",11,11,0,0,0,0,11,0,0,0,0,0,0,0,0,0,0,0,0,0
ACSSF,2010e5,wv,000,0034,0001150,080,54,005,08000US540059083220212958400,"Census Tract 9584 (part), Danville town, District 3, Boone County, West Virginia",73,55,15,6,4,5,40,18,0,0,0,0,0,0,18,9,0,9,0,9
ACSSF,2010e5,wv,000,0034,0001151,080,54,005,08000US540059083220212958502,"Census Tract 9585.02 (part), Danville town, District 3, Boone County, West Virginia",161,131,58,0,9,49,73,30,6,6,0,0,6,0,24,19,0,0,19,5
ACSSF,2010e5,wv,000,0034,0001152,080,54,005,08000US540059083250524958400,"Census Tract 9584 (part), Madison city (part), District 3, Boone County, West Virginia",384,322,126,48,10,68,196,62,11,0,0,0,0,11,51,31,7,0,24,20
ACSSF,2010e5,wv,000,0034,0001153,080,54,005,08000US540059083250524958502,"Census Tract 9585.02 (part), Madison city (part), District 3, Boone County, West Virginia",320,237,59,0,11,48,178,83,0,0,0,0,0,0,83,16,0,0,16,67
ACSSF,2010e5,wv,000,0034,0001154,080,54,005,08000US540059083250524958800,"Census Tract 9588 (part), Madison city (part), District 3, Boone County, West Virginia",26,0,0,0,0,0,0,26,26,0,0,0,0,26,0,0,0,0,0,0
ACSSF,2010e5,wv,000,0034,0001155,080,54,005,08000US540059083299999958200,"Census Tract 9582 (part), District Remainder of 3, District 3, Boone County, West Virginia",380,271,133,15,28,90,138,109,37,11,0,0,11,26,72,62,0,0,62,10
ACSSF,2010e5,wv,000,0034,0001156,080,54,005,08000US540059083299999958300,"Census Tract 9583 (part), District Remainder of 3, District 3, Boone County, West Virginia",596,504,104,25,43,36,400,92,37,7,7,0,0,30,55,8,0,0,8,47
ACSSF,2010e5,wv,000,0034,0001157,080,54,005,08000US540059083299999958400,"Census Tract 9584 (part), District Remainder of 3, District 3, Boone County, West Virginia",215,160,42,22,0,20,118,55,0,0,0,0,0,0,55,28,0,0,28,27
ACSSF,2010e5,wv,000,0034,0001158,080,54,005,08000US540059083299999958502,"Census Tract 9585.02 (part), District Remainder of 3, District 3, Boone County, West Virginia",278,278,86,0,16,70,192,0,0,0,0,0,0,0,0,0,0,0,0,0
ACSSF,2010e5,wv,000,0034,0001159,080,54,005,08000US540059083299999958800,"Census Tract 9588 (part), District Remainder of 3, District 3, Boone County, West Virginia",184,184,50,29,0,21,134,0,0,0,0,0,0,0,0,0,0,0,0,0
ACSSF,2010e5,wv,000,0034,0001160,080,54,007,08000US540079096827868967900,"Census Tract 9679 (part), Flatwoods town (part), Eastern district, Braxton County, West Virginia",16,14,3,0,3,0,11,2,0,0,0,0,0,0,2,0,0,0,0,2
ACSSF,2010e5,wv,000,0034,0001161,080,54,007,08000US540079096878580968100,"Census Tract 9681 (part), Sutton town (part), Eastern district, Braxton County, West Virginia",251,157,31,4,3,24,126,94,4,4,0,4,0,0,90,58,20,18,20,32
ACSSF,2010e5,wv,000,0034,0001162,080,54,007,08000US540079096899999967900,"Census Tract 9679 (part), Remainder of Eastern district, Eastern district, Braxton County, West Virginia",254,223,87,16,34,37,136,31,12,0,0,0,0,12,19,11,0,0,11,8
ACSSF,2010e5,wv,000,0034,0001163,080,54,007,08000US540079096899999968100,"Census Tract 9681 (part), Remainder of Eastern district, Eastern district, Braxton County, West Virginia",238,225,59,0,21,38,166,13,13,5,0,0,5,8,0,0,0,0,0,0
ACSSF,2010e5,wv,000,0034,0001164,080,54,007,08000US540079234611716967900,"Census Tract 9679 (part), Burnsville town, Northern district, Braxton County, West Virginia",150,101,32,10,0,22,69,49,14,8,0,0,8,6,35,10,0,4,6,25
ACSSF,2010e5,wv,000,0034,0001165,080,54,007,08000US540079234627868967900,"Census Tract 9679 (part), Flatwoods town (part), Northern district, Braxton County, West Virginia",22,20,6,0,0,6,14,2,0,0,0,0,0,0,2,0,0,0,0,2
ACSSF,2010e5,wv,000,0034,0001166,080,54,007,08000US540079234699999967900,"Census Tract 9679 (part), Remainder of Northern district, Northern district, Braxton County, West Virginia",749,644,166,42,22,102,478,105,25,0,0,0,0,25,80,23,11,0,12,57
ACSSF,2010e5,wv,000,0034,0001167,080,54,007,08000US540079234699999968000,"Census Tract 9680 (part), Remainder of Northern district, Northern district, Braxton County, West Virginia",10,10,10,0,0,10,0,0,0,0,0,0,0,0,0,0,0,0,0,0
ACSSF,2010e5,wv,000,0034,0001168,080,54,007,08000US540079292299999968000,"Census Tract 9680 (part), Southern district, Southern district, Braxton County, West Virginia",470,324,125,15,44,66,199,146,56,46,0,0,46,10,90,50,10,21,19,40
ACSSF,2010e5,wv,000,0034,0001169,080,54,007,08000US540079292299999968100,"Census Tract 9681 (part), Southern district, Southern district, Braxton County, West Virginia",692,577,182,11,32,139,395,115,50,14,0,0,14,36,65,51,12,0,39,14
ACSSF,2010e5,wv,000,0034,0001170,080,54,007,08000US540079359730220968000,"Census Tract 9680 (part), Gassaway town, Western district, Braxton County, West Virginia",217,169,52,15,8,29,117,48,0,0,0,0,0,0,48,39,18,3,18,9
ACSSF,2010e5,wv,000,0034,0001171,080,54,007,08000US540079359778580968100,"Census Tract 9681 (part), Sutton town (part), Western district, Braxton County, West Virginia",60,37,6,1,5,0,31,23,16,3,0,0,3,13,7,0,0,0,0,7
ACSSF,2010e5,wv,000,0034,0001172,080,54,007,08000US540079359799999967900,"Census Tract 9679 (part), Remainder of Western district, Western district, Braxton County, West Virginia",24,24,0,0,0,0,24,0,0,0,0,0,0,0,0,0,0,0,0,0
ACSSF,2010e5,wv,000,0034,0001173,080,54,007,08000US540079359799999968000,"Census Tract 9680 (part), Remainder of Western district, Western district, Braxton County, West Virginia",636,585,116,6,0,110,469,51,8,8,0,0,8,0,43,43,10,0,33,0
ACSSF,2010e5,wv,000,0034,0001174,080,54,007,08000US540079359799999968100,"Census Tract 9681 (part), Remainder of Western district, Western district, Braxton County, West Virginia",115,88,6,0,0,6,82,27,15,0,0,0,0,15,12,12,0,0,12,0
ACSSF,2010e5,wv,000,0034,0001175,080,54,009,08000US540099110428204031102,"Census Tract 311.02 (part), Follansbee city (part), Follansbee district, Brooke County, West Virginia",487,403,112,0,24,88,291,84,35,10,0,0,10,25,49,30,0,0,30,19
ACSSF,2010e5,wv,000,0034,0001176,080,54,009,08000US540099110428204031200,"Census Tract 312 (part), Follansbee city (part), Follansbee district, Brooke County, West Virginia",335,240,43,12,21,10,197,95,38,29,29,0,0,9,57,27,0,0,27,30
ACSSF,2010e5,wv,000,0034,0001177,080,54,009,08000US540099110438476031102,"Census Tract 311.02 (part), Hooverson Heights CDP (part), Follansbee district, Brooke County, West Virginia",80,80,60,0,0,60,20,0,0,0,0,0,0,0,0,0,0,0,0,0
ACSSF,2010e5,wv,000,0034,0001178,080,54,009,08000US540099110438476031200,"Census Tract 312 (part), Hooverson Heights CDP (part), Follansbee district, Brooke County, West Virginia",602,477,184,37,61,86,293,125,22,10,0,0,10,12,103,48,23,9,16,55
ACSSF,2010e5,wv,000,0034,0001179,080,54,009,08000US540099110499999031101,"Census Tract 311.01 (part), Remainder of Follansbee district, Follansbee district, Brooke County, West Virginia",37,37,0,0,0,0,37,0,0,0,0,0,0,0,0,0,0,0,0,0
ACSSF,2010e5,wv,000,0034,0001180,080,54,009,08000US540099110499999031102,"Census Tract 311.02 (part), Remainder of Follansbee district, Follansbee district, Brooke County, West Virginia",0,0,0,0,0,0,0,0,0,0,0,0,0,0,0,0,0,0,0,0
ACSSF,2010e5,wv,000,0034,0001181,080,54,009,08000US540099110499999031200,"Census Tract 312 (part), Remainder of Follansbee district, Follansbee district, Brooke County, West Virginia",0,0,0,0,0,0,0,0,0,0,0,0,0,0,0,0,0,0,0,0
ACSSF,2010e5,wv,000,0034,0001182,080,54,009,08000US540099110499999031400,"Census Tract 314 (part), Remainder of Follansbee district, Follansbee district, Brooke County, West Virginia",478,335,84,0,21,63,251,143,20,0,0,0,0,20,123,81,64,0,17,42
ACSSF,2010e5,wv,000,0034,0001183,080,54,009,08000US540099110499999031600,"Census Tract 316 (part), Remainder of Follansbee district, Follansbee district, Brooke County, West Virginia",372,283,102,40,14,48,181,89,14,6,0,0,6,8,75,23,10,0,13,52
ACSSF,2010e5,wv,000,0034,0001184,080,54,009,08000US540099110499999031700,"Census Tract 317 (part), Remainder of Follansbee district, Follansbee district, Brooke County, West Virginia",156,156,67,49,0,18,89,0,0,0,0,0,0,0,0,0,0,0,0,0
ACSSF,2010e5,wv,000,0034,0001185,080,54,009,08000US540099355228204031102,"Census Tract 311.02 (part), Follansbee city (part), Weirton district, Brooke County, West Virginia",0,0,0,0,0,0,0,0,0,0,0,0,0,0,0,0,0,0,0,0
ACSSF,2010e5,wv,000,0034,0001186,080,54,009,08000US540099355238476031102,"Census Tract 311.02 (part), Hooverson Heights CDP (part), Weirton district, Brooke County, West Virginia",139,100,0,0,0,0,100,39,39,17,0,0,17,22,0,0,0,0,0,0
ACSSF,2010e5,wv,000,0034,0001187,080,54,009,08000US540099355285156031101,"Census Tract 311.01 (part), Weirton city (part), Weirton district, Brooke County, West Virginia",1059,622,173,11,38,124,449,437,100,11,0,0,11,89,337,238,28,70,140,99
ACSSF,2010e5,wv,000,0034,0001188,080,54,009,08000US540099355299999031101,"Census Tract 311.01 (part), Remainder of Weirton district, Weirton district, Brooke County, West Virginia",282,226,0,0,0,0,226,56,0,0,0,0,0,0,56,56,0,56,0,0
ACSSF,2010e5,wv,000,0034,0001189,080,54,009,08000US540099355299999031102,"Census Tract 311.02 (part), Remainder of Weirton district, Weirton district, Brooke County, West Virginia",603,495,196,0,140,56,299,108,64,34,0,0,34,30,44,32,17,0,15,12
ACSSF,2010e5,wv,000,0034,0001190,080,54,009,08000US540099356405452031700,"Census Tract 317 (part), Beech Bottom village, Wellsburg district, Brooke County, West Virginia",111,76,22,6,5,11,54,35,7,0,0,0,0,7,28,16,4,0,12,12
ACSSF,2010e5,wv,000,0034,0001191,080,54,009,08000US540099356406844031600,"Census Tract 316 (part), Bethany town, Wellsburg district, Brooke County, West Virginia",115,92,21,4,0,17,71,23,7,7,0,0,7,0,16,0,0,0,0,16
ACSSF,2010e5,wv,000,0034,0001192,080,54,009,08000US540099356485324031400,"Census Tract 314 (part), Wellsburg city, Wellsburg district, Brooke County, West Virginia",693,474,164,7,44,113,310,219,99,92,17,20,55,7,120,102,20,1,81,18
ACSSF,2010e5,wv,000,0034,0001193,080,54,009,08000US540099356487892031700,"Census Tract 317 (part), Windsor Heights village, Wellsburg district, Brooke County, West Virginia",109,94,36,16,12,8,58,15,9,3,0,0,3,6,6,2,0,2,0,4
ACSSF,2010e5,wv,000,0034,0001194,080,54,009,08000US540099356499999031400,"Census Tract 314 (part), Remainder of Wellsburg district, Wellsburg district, Brooke County, West Virginia",68,40,0,0,0,0,40,28,0,0,0,0,0,0,28,28,0,0,28,0
ACSSF,2010e5,wv,000,0034,0001195,080,54,009,08000US540099356499999031600,"Census Tract 316 (part), Remainder of Wellsburg district, Wellsburg district, Brooke County, West Virginia",534,501,128,0,34,94,373,33,14,0,0,0,0,14,19,0,0,0,0,19
ACSSF,2010e5,wv,000,0034,0001196,080,54,009,08000US540099356499999031700,"Census Tract 317 (part), Remainder of Wellsburg district, Wellsburg district, Brooke County, West Virginia",318,248,50,0,12,38,198,70,29,22,10,0,12,7,41,41,0,0,41,0
ACSSF,2010e5,wv,000,0034,0001197,080,54,011,08000US540119076439460000900,"Census Tract 9 (part), Huntington city (part), District 1, Cabell County, West Virginia",280,197,67,18,6,43,130,83,9,0,0,0,0,9,74,74,8,0,66,0
ACSSF,2010e5,wv,000,0034,0001198,080,54,011,08000US540119076439460001000,"Census Tract 10, Huntington city (part), District 1, Cabell County, West Virginia",641,362,55,16,14,25,307,279,82,27,0,0,27,55,197,176,11,84,81,21
ACSSF,2010e5,wv,000,0034,0001199,080,54,011,08000US540119076439460001100,"Census Tract 11, Huntington city (part), District 1, Cabell County, West Virginia",597,404,196,89,13,94,208,193,70,53,47,0,6,17,123,33,11,22,0,90
ACSSF,2010e5,wv,000,0034,0001200,080,54,011,08000US540119076439460001200,"Census Tract 12 (part), Huntington city (part), District 1, Cabell County, West Virginia",476,266,102,37,4,61,164,210,30,18,0,0,18,12,180,66,39,0,27,114
ACSSF,2010e5,wv,000,0034,0001201,080,54,011,08000US540119076439460001500,"Census Tract 15 (part), Huntington city (part), District 1, Cabell County, West Virginia",294,193,18,18,0,0,175,101,24,24,24,0,0,0,77,18,7,7,4,59
ACSSF,2010e5,wv,000,0034,0001202,080,54,011,08000US540119076439460002000,"Census Tract 20 (part), Huntington city (part), District 1, Cabell County, West Virginia",785,629,216,32,26,158,413,156,0,0,0,0,0,0,156,110,0,0,110,46
ACSSF,2010e5,wv,000,0034,0001203,080,54,011,08000US540119076439460002100,"Census Tract 21 (part), Huntington city (part), District 1, Cabell County, West Virginia",495,426,133,55,0,78,293,69,6,6,0,0,6,0,63,14,0,0,14,49
ACSSF,2010e5,wv,000,0034,0001204,080,54,011,08000US540119076439460010102,"Census Tract 101.02 (part), Huntington city (part), District 1, Cabell County, West Virginia",21,21,0,0,0,0,21,0,0,0,0,0,0,0,0,0,0,0,0,0
ACSSF,2010e5,wv,000,0034,0001205,080,54,011,08000US540119076499999002000,"Census Tract 20 (part), District Remainder of 1, District 1, Cabell County, West Virginia",7,7,0,0,0,0,7,0,0,0,0,0,0,0,0,0,0,0,0,0
ACSSF,2010e5,wv,000,0034,0001206,080,54,011,08000US540119076499999002100,"Census Tract 21 (part), District Remainder of 1, District 1, Cabell County, West Virginia",33,33,16,0,0,16,17,0,0,0,0,0,0,0,0,0,0,0,0,0
ACSSF,2010e5,wv,000,0034,0001207,080,54,011,08000US540119076499999010102,"Census Tract 101.02 (part), District Remainder of 1, District 1, Cabell County, West Virginia",1261,987,370,15,95,260,617,274,60,47,32,0,15,13,214,111,19,0,92,103
ACSSF,2010e5,wv,000,0034,0001208,080,54,011,08000US540119079839460000500,"Census Tract 5 (part), Huntington city (part), District 2, Cabell County, West Virginia",8,0,0,0,0,0,0,8,0,0,0,0,0,0,8,0,0,0,0,8
ACSSF,2010e5,wv,000,0034,0001209,080,54,011,08000US540119079839460000600,"Census Tract 6 (part), Huntington city (part), District 2, Cabell County, West Virginia",76,31,0,0,0,0,31,45,36,0,0,0,0,36,9,9,0,0,9,0
ACSSF,2010e5,wv,000,0034,0001210,080,54,011,08000US540119079839460000900,"Census Tract 9 (part), Huntington city (part), District 2, Cabell County, West Virginia",0,0,0,0,0,0,0,0,0,0,0,0,0,0,0,0,0,0,0,0
ACSSF,2010e5,wv,000,0034,0001211,080,54,011,08000US540119079839460001200,"Census Tract 12 (part), Huntington city (part), District 2, Cabell County, West Virginia",305,231,95,5,20,70,136,74,11,11,11,0,0,0,63,43,26,0,17,20
ACSSF,2010e5,wv,000,0034,0001212,080,54,011,08000US540119079839460001300,"Census Tract 13, Huntington city (part), District 2, Cabell County, West Virginia",588,352,136,29,18,89,216,236,51,14,0,0,14,37,185,86,0,12,74,99
ACSSF,2010e5,wv,000,0034,0001213,080,54,011,08000US540119079839460001400,"Census Tract 14, Huntington city (part), District 2, Cabell County, West Virginia",575,358,81,44,29,8,277,217,30,22,0,0,22,8,187,93,12,31,50,94
ACSSF,2010e5,wv,000,0034,0001214,080,54,011,08000US540119079839460001500,"Census Tract 15 (part), Huntington city (part), District 2, Cabell County, West Virginia",252,50,0,0,0,0,50,202,63,38,0,0,38,25,139,78,55,9,14,61
ACSSF,2010e5,wv,000,0034,0001215,080,54,011,08000US540119079839460001600,"Census Tract 16, Huntington city (part), District 2, Cabell County, West Virginia",295,182,112,0,0,112,70,113,0,0,0,0,0,0,113,92,0,0,92,21
ACSSF,2010e5,wv,000,0034,0001216,080,54,011,08000US540119079839460001800,"Census Tract 18 (part), Huntington city (part), District 2, Cabell County, West Virginia",400,147,40,21,0,19,107,253,83,76,0,0,76,7,170,73,22,0,51,97
ACSSF,2010e5,wv,000,0034,0001217,080,54,011,08000US540119079839460002100,"Census Tract 21 (part), Huntington city (part), District 2, Cabell County, West Virginia",364,330,130,50,38,42,200,34,0,0,0,0,0,0,34,25,0,0,25,9
ACSSF,2010e5,wv,000,0034,0001218,080,54,011,08000US540119079839460010102,"Census Tract 101.02 (part), Huntington city (part), District 2, Cabell County, West Virginia",0,0,0,0,0,0,0,0,0,0,0,0,0,0,0,0,0,0,0,0
ACSSF,2010e5,wv,000,0034,0001219,080,54,011,08000US540119079839460010900,"Census Tract 109, Huntington city (part), District 2, Cabell County, West Virginia",273,181,93,43,50,0,88,92,42,7,0,0,7,35,50,0,0,0,0,50
ACSSF,2010e5,wv,000,0034,0001220,080,54,011,08000US540119083404276010300,"Census Tract 103 (part), Barboursville village (part), District 3, Cabell County, West Virginia",0,0,0,0,0,0,0,0,0,0,0,0,0,0,0,0,0,0,0,0
ACSSF,2010e5,wv,000,0034,0001221,080,54,011,08000US540119083404276010400,"Census Tract 104 (part), Barboursville village (part), District 3, Cabell County, West Virginia",0,0,0,0,0,0,0,0,0,0,0,0,0,0,0,0,0,0,0,0
ACSSF,2010e5,wv,000,0034,0001222,080,54,011,08000US540119083439460000101,"Census Tract 1.01 (part), Huntington city (part), District 3, Cabell County, West Virginia",431,255,66,33,0,33,189,176,21,13,13,0,0,8,155,84,0,71,13,71
ACSSF,2010e5,wv,000,0034,0001223,080,54,011,08000US540119083439460000102,"Census Tract 1.02 (part), Huntington city (part), District 3, Cabell County, West Virginia",171,125,54,0,0,54,71,46,22,12,0,0,12,10,24,0,0,0,0,24
ACSSF,2010e5,wv,000,0034,0001224,080,54,011,08000US540119083439460000200,"Census Tract 2 (part), Huntington city (part), District 3, Cabell County, West Virginia",608,438,108,15,43,50,330,170,72,22,0,0,22,50,98,70,0,21,49,28
ACSSF,2010e5,wv,000,0034,0001225,080,54,011,08000US540119083439460000300,"Census Tract 3, Huntington city (part), District 3, Cabell County, West Virginia",637,366,112,70,32,10,254,271,29,19,9,0,10,10,242,139,39,29,71,103
ACSSF,2010e5,wv,000,0034,0001226,080,54,011,08000US540119083439460000400,"Census Tract 4, Huntington city (part), District 3, Cabell County, West Virginia",461,245,57,9,28,20,188,216,53,35,23,0,12,18,163,65,23,0,42,98
ACSSF,2010e5,wv,000,0034,0001227,080,54,011,08000US540119083439460000500,"Census Tract 5 (part), Huntington city (part), District 3, Cabell County, West Virginia",73,19,0,0,0,0,19,54,8,0,0,0,0,8,46,0,0,0,0,46
ACSSF,2010e5,wv,000,0034,0001228,080,54,011,08000US540119083439460000600,"Census Tract 6 (part), Huntington city (part), District 3, Cabell County, West Virginia",0,0,0,0,0,0,0,0,0,0,0,0,0,0,0,0,0,0,0,0
ACSSF,2010e5,wv,000,0034,0001229,080,54,011,08000US540119083439460001800,"Census Tract 18 (part), Huntington city (part), District 3, Cabell County, West Virginia",534,268,80,34,12,34,188,266,45,30,0,0,30,15,221,152,48,27,77,69
ACSSF,2010e5,wv,000,0034,0001230,080,54,011,08000US540119083439460001900,"Census Tract 19, Huntington city (part), District 3, Cabell County, West Virginia",572,510,148,25,32,91,362,62,28,28,0,0,28,0,34,24,0,18,6,10
ACSSF,2010e5,wv,000,0034,0001231,080,54,011,08000US540119083439460002000,"Census Tract 20 (part), Huntington city (part), District 3, Cabell County, West Virginia",194,187,60,24,9,27,127,7,0,0,0,0,0,0,7,7,0,0,7,0
ACSSF,2010e5,wv,000,0034,0001232,080,54,011,08000US540119083439460010102,"Census Tract 101.02 (part), Huntington city (part), District 3, Cabell County, West Virginia",0,0,0,0,0,0,0,0,0,0,0,0,0,0,0,0,0,0,0,0
ACSSF,2010e5,wv,000,0034,0001233,080,54,011,08000US540119083446420010300,"Census Tract 103 (part), Lesage CDP (part), District 3, Cabell County, West Virginia",93,67,56,47,0,9,11,26,0,0,0,0,0,0,26,26,26,0,0,0
ACSSF,2010e5,wv,000,0034,0001234,080,54,011,08000US540119083499999000101,"Census Tract 1.01 (part), District Remainder of 3, District 3, Cabell County, West Virginia",75,19,13,0,13,0,6,56,13,0,0,0,0,13,43,43,10,8,25,0
ACSSF,2010e5,wv,000,0034,0001235,080,54,011,08000US540119083499999000200,"Census Tract 2 (part), District Remainder of 3, District 3, Cabell County, West Virginia",237,119,19,19,0,0,100,118,42,27,0,0,27,15,76,65,16,0,49,11
ACSSF,2010e5,wv,000,0034,0001236,080,54,011,08000US540119083499999010300,"Census Tract 103 (part), District Remainder of 3, District 3, Cabell County, West Virginia",229,222,108,48,8,52,114,7,7,7,0,0,7,0,0,0,0,0,0,0
ACSSF,2010e5,wv,000,0034,0001237,080,54,011,08000US540119083499999010400,"Census Tract 104 (part), District Remainder of 3, District 3, Cabell County, West Virginia",0,0,0,0,0,0,0,0,0,0,0,0,0,0,0,0,0,0,0,0
ACSSF,2010e5,wv,000,0034,0001238,080,54,011,08000US540119087004276000102,"Census Tract 1.02 (part), Barboursville village (part), District 4, Cabell County, West Virginia",0,0,0,0,0,0,0,0,0,0,0,0,0,0,0,0,0,0,0,0
ACSSF,2010e5,wv,000,0034,0001239,080,54,011,08000US540119087004276010102,"Census Tract 101.02 (part), Barboursville village (part), District 4, Cabell County, West Virginia",29,13,13,13,0,0,0,16,16,0,0,0,0,16,0,0,0,0,0,0
ACSSF,2010e5,wv,000,0034,0001240,080,54,011,08000US540119087004276010201,"Census Tract 102.01 (part), Barboursville village (part), District 4, Cabell County, West Virginia",0,0,0,0,0,0,0,0,0,0,0,0,0,0,0,0,0,0,0,0
ACSSF,2010e5,wv,000,0034,0001241,080,54,011,08000US540119087004276010202,"Census Tract 102.02 (part), Barboursville village (part), District 4, Cabell County, West Virginia",71,71,36,36,0,0,35,0,0,0,0,0,0,0,0,0,0,0,0,0
ACSSF,2010e5,wv,000,0034,0001242,080,54,011,08000US540119087004276010300,"Census Tract 103 (part), Barboursville village (part), District 4, Cabell County, West Virginia",0,0,0,0,0,0,0,0,0,0,0,0,0,0,0,0,0,0,0,0
ACSSF,2010e5,wv,000,0034,0001243,080,54,011,08000US540119087004276010400,"Census Tract 104 (part), Barboursville village (part), District 4, Cabell County, West Virginia",1066,905,180,14,74,92,725,161,13,13,0,0,13,0,148,102,0,0,102,46
ACSSF,2010e5,wv,000,0034,0001244,080,54,011,08000US540119087039460000102,"Census Tract 1.02 (part), Huntington city (part), District 4, Cabell County, West Virginia",17,17,0,0,0,0,17,0,0,0,0,0,0,0,0,0,0,0,0,0
ACSSF,2010e5,wv,000,0034,0001245,080,54,011,08000US540119087039460010102,"Census Tract 101.02 (part), Huntington city (part), District 4, Cabell County, West Virginia",11,11,11,11,0,0,0,0,0,0,0,0,0,0,0,0,0,0,0,0
ACSSF,2010e5,wv,000,0034,0001246,080,54,011,08000US540119087039460010202,"Census Tract 102.02 (part), Huntington city (part), District 4, Cabell County, West Virginia",13,13,0,0,0,0,13,0,0,0,0,0,0,0,0,0,0,0,0,0
ACSSF,2010e5,wv,000,0034,0001247,080,54,011,08000US540119087062488010201,"Census Tract 102.01 (part), Pea Ridge CDP, District 4, Cabell County, West Virginia",1213,1064,356,57,127,172,708,149,36,0,0,0,0,36,113,31,0,0,31,82
ACSSF,2010e5,wv,000,0034,0001248,080,54,011,08000US540119087062488010202,"Census Tract 102.02 (part), Pea Ridge CDP, District 4, Cabell County, West Virginia",459,383,90,0,26,64,293,76,17,17,0,0,17,0,59,0,0,0,0,59
ACSSF,2010e5,wv,000,0034,0001249,080,54,011,08000US540119087071476010500,"Census Tract 105 (part), Salt Rock CDP (part), District 4, Cabell County, West Virginia",14,14,0,0,0,0,14,0,0,0,0,0,0,0,0,0,0,0,0,0
ACSSF,2010e5,wv,000,0034,0001250,080,54,011,08000US540119087099999000101,"Census Tract 1.01 (part), District Remainder of 4, District 4, Cabell County, West Virginia",0,0,0,0,0,0,0,0,0,0,0,0,0,0,0,0,0,0,0,0
ACSSF,2010e5,wv,000,0034,0001251,080,54,011,08000US540119087099999000102,"Census Tract 1.02 (part), District Remainder of 4, District 4, Cabell County, West Virginia",388,273,117,38,14,65,156,115,10,10,0,10,0,0,105,96,28,11,57,9
ACSSF,2010e5,wv,000,0034,0001252,080,54,011,08000US540119087099999010102,"Census Tract 101.02 (part), District Remainder of 4, District 4, Cabell County, West Virginia",517,476,107,31,17,59,369,41,0,0,0,0,0,0,41,26,0,0,26,15
ACSSF,2010e5,wv,000,0034,0001253,080,54,011,08000US540119087099999010201,"Census Tract 102.01 (part), District Remainder of 4, District 4, Cabell County, West Virginia",273,143,57,57,0,0,86,130,0,0,0,0,0,0,130,130,64,41,25,0
ACSSF,2010e5,wv,000,0034,0001254,080,54,011,08000US540119087099999010202,"Census Tract 102.02 (part), District Remainder of 4, District 4, Cabell County, West Virginia",728,584,287,0,11,276,297,144,16,0,0,0,0,16,128,79,0,16,63,49
ACSSF,2010e5,wv,000,0034,0001255,080,54,011,08000US540119087099999010300,"Census Tract 103 (part), District Remainder of 4, District 4, Cabell County, West Virginia",47,47,38,15,13,10,9,0,0,0,0,0,0,0,0,0,0,0,0,0
ACSSF,2010e5,wv,000,0034,0001256,080,54,011,08000US540119087099999010400,"Census Tract 104 (part), District Remainder of 4, District 4, Cabell County, West Virginia",229,180,85,51,0,34,95,49,13,13,0,0,13,0,36,36,36,0,0,0
ACSSF,2010e5,wv,000,0034,0001257,080,54,011,08000US540119087099999010500,"Census Tract 105 (part), District Remainder of 4, District 4, Cabell County, West Virginia",1241,1034,315,25,55,235,719,207,37,37,0,0,37,0,170,91,0,81,10,79
ACSSF,2010e5,wv,000,0034,0001258,080,54,011,08000US540119087099999010600,"Census Tract 106 (part), District Remainder of 4, District 4, Cabell County, West Virginia",443,360,156,6,49,101,204,83,32,0,0,0,0,32,51,39,30,0,9,12
ACSSF,2010e5,wv,000,0034,0001259,080,54,011,08000US540119088204276010300,"Census Tract 103 (part), Barboursville village (part), District 5, Cabell County, West Virginia",13,13,0,0,0,0,13,0,0,0,0,0,0,0,0,0,0,0,0,0
ACSSF,2010e5,wv,000,0034,0001260,080,54,011,08000US540119088204276010400,"Census Tract 104 (part), Barboursville village (part), District 5, Cabell County, West Virginia",0,0,0,0,0,0,0,0,0,0,0,0,0,0,0,0,0,0,0,0
ACSSF,2010e5,wv,000,0034,0001261,080,54,011,08000US540119088219516010600,"Census Tract 106 (part), Culloden CDP (part), District 5, Cabell County, West Virginia",79,55,39,0,0,39,16,24,15,0,0,0,0,15,9,0,0,0,0,9
ACSSF,2010e5,wv,000,0034,0001262,080,54,011,08000US540119088219516010800,"Census Tract 108 (part), Culloden CDP (part), District 5, Cabell County, West Virginia",637,535,226,55,47,124,309,102,43,0,0,0,0,43,59,29,0,0,29,30
ACSSF,2010e5,wv,000,0034,0001263,080,54,011,08000US540119088246420010300,"Census Tract 103 (part), Lesage CDP (part), District 5, Cabell County, West Virginia",227,171,54,10,0,44,117,56,0,0,0,0,0,0,56,11,0,0,11,45
ACSSF,2010e5,wv,000,0034,0001264,080,54,011,08000US540119088246420010700,"Census Tract 107 (part), Lesage CDP (part), District 5, Cabell County, West Virginia",78,78,12,0,0,12,66,0,0,0,0,0,0,0,0,0,0,0,0,0
ACSSF,2010e5,wv,000,0034,0001265,080,54,011,08000US540119088254484010700,"Census Tract 107 (part), Milton town, District 5, Cabell County, West Virginia",0,0,0,0,0,0,0,0,0,0,0,0,0,0,0,0,0,0,0,0
ACSSF,2010e5,wv,000,0034,0001266,080,54,011,08000US540119088254484010800,"Census Tract 108 (part), Milton town, District 5, Cabell County, West Virginia",675,497,189,44,70,75,308,178,35,6,6,0,0,29,143,74,19,0,55,69
ACSSF,2010e5,wv,000,0034,0001267,080,54,011,08000US540119088271476010500,"Census Tract 105 (part), Salt Rock CDP (part), District 5, Cabell County, West Virginia",58,58,22,22,0,0,36,0,0,0,0,0,0,0,0,0,0,0,0,0
ACSSF,2010e5,wv,000,0034,0001268,080,54,011,08000US540119088299999010300,"Census Tract 103 (part), District Remainder of 5, District 5, Cabell County, West Virginia",257,200,37,6,8,23,163,57,22,0,0,0,0,22,35,0,0,0,0,35
ACSSF,2010e5,wv,000,0034,0001269,080,54,011,08000US540119088299999010400,"Census Tract 104 (part), District Remainder of 5, District 5, Cabell County, West Virginia",421,330,118,96,0,22,212,91,44,16,16,0,0,28,47,47,12,0,35,0
ACSSF,2010e5,wv,000,0034,0001270,080,54,011,08000US540119088299999010500,"Census Tract 105 (part), District Remainder of 5, District 5, Cabell County, West Virginia",279,247,89,10,20,59,158,32,0,0,0,0,0,0,32,10,0,10,0,22
ACSSF,2010e5,wv,000,0034,0001271,080,54,011,08000US540119088299999010600,"Census Tract 106 (part), District Remainder of 5, District 5, Cabell County, West Virginia",574,366,125,47,19,59,241,208,34,14,0,0,14,20,174,108,0,0,108,66
ACSSF,2010e5,wv,000,0034,0001272,080,54,011,08000US540119088299999010700,"Census Tract 107 (part), District Remainder of 5, District 5, Cabell County, West Virginia",1894,1618,591,52,137,402,1027,276,75,57,11,0,46,18,201,128,8,0,120,73
ACSSF,2010e5,wv,000,0034,0001273,080,54,011,08000US540119088299999010800,"Census Tract 108 (part), District Remainder of 5, District 5, Cabell County, West Virginia",403,337,61,15,0,46,276,66,0,0,0,0,0,0,66,43,43,0,0,23
ACSSF,2010e5,wv,000,0034,0001274,080,54,013,08000US540139076699999962600,"Census Tract 9626 (part), District 1, District 1, Calhoun County, West Virginia",324,268,9,0,0,9,259,56,27,0,0,0,0,27,29,19,0,0,19,10
ACSSF,2010e5,wv,000,0034,0001275,080,54,013,08000US540139080099999962600,"Census Tract 9626 (part), District 2, District 2, Calhoun County, West Virginia",214,156,39,0,0,39,117,58,37,24,11,0,13,13,21,0,0,0,0,21
ACSSF,2010e5,wv,000,0034,0001276,080,54,013,08000US540139080099999962700,"Census Tract 9627 (part), District 2, District 2, Calhoun County, West Virginia",170,105,31,0,18,13,74,65,39,39,13,26,0,0,26,13,0,0,13,13
ACSSF,2010e5,wv,000,0034,0001277,080,54,013,08000US540139083632884962600,"Census Tract 9626 (part), Grantsville town, District 3, Calhoun County, West Virginia",198,144,58,8,25,25,86,54,31,0,0,0,0,31,23,3,3,0,0,20
ACSSF,2010e5,wv,000,0034,0001278,080,54,013,08000US540139083699999962600,"Census Tract 9626 (part), District Remainder of 3, District 3, Calhoun County, West Virginia",145,111,35,0,14,21,76,34,12,12,12,0,0,0,22,22,0,0,22,0
ACSSF,2010e5,wv,000,0034,0001279,080,54,013,08000US540139083699999962700,"Census Tract 9627 (part), District Remainder of 3, District 3, Calhoun County, West Virginia",20,20,0,0,0,0,20,0,0,0,0,0,0,0,0,0,0,0,0,0
ACSSF,2010e5,wv,000,0034,0001280,080,54,013,08000US540139087399999962600,"Census Tract 9626 (part), District 4, District 4, Calhoun County, West Virginia",92,41,22,0,0,22,19,51,0,0,0,0,0,0,51,0,0,0,0,51
ACSSF,2010e5,wv,000,0034,0001281,080,54,013,08000US540139087399999962700,"Census Tract 9627 (part), District 4, District 4, Calhoun County, West Virginia",407,285,83,0,0,83,202,122,54,45,27,18,0,9,68,20,0,0,20,48
ACSSF,2010e5,wv,000,0034,0001282,080,54,013,08000US540139088599999962700,"Census Tract 9627 (part), District 5, District 5, Calhoun County, West Virginia",493,407,187,0,49,138,220,86,38,0,0,0,0,38,48,20,20,0,0,28
ACSSF,2010e5,wv,000,0034,0001283,080,54,015,08000US540159089199999957900,"Census Tract 9579 (part), District A, District A, Clay County, West Virginia",684,458,151,14,55,82,307,226,70,18,0,0,18,52,156,78,10,0,68,78
ACSSF,2010e5,wv,000,0034,0001284,080,54,015,08000US540159089199999958000,"Census Tract 9580 (part), District A, District A, Clay County, West Virginia",81,71,37,0,20,17,34,10,10,0,0,0,0,10,0,0,0,0,0,0
ACSSF,2010e5,wv,000,0034,0001285,080,54,015,08000US540159089315676958000,"Census Tract 9580 (part), Clay town, District B, Clay County, West Virginia",100,84,35,0,0,35,49,16,0,0,0,0,0,0,16,7,0,0,7,9
ACSSF,2010e5,wv,000,0034,0001286,080,54,015,08000US540159089399999957900,"Census Tract 9579 (part), District Remainder of B, District B, Clay County, West Virginia",154,154,47,0,8,39,107,0,0,0,0,0,0,0,0,0,0,0,0,0
ACSSF,2010e5,wv,000,0034,0001287,080,54,015,08000US540159089399999958000,"Census Tract 9580 (part), District Remainder of B, District B, Clay County, West Virginia",464,334,141,58,17,66,193,130,50,14,14,0,0,36,80,16,0,16,0,64
ACSSF,2010e5,wv,000,0034,0001288,080,54,015,08000US540159089399999958100,"Census Tract 9581 (part), District Remainder of B, District B, Clay County, West Virginia",175,136,103,27,12,64,33,39,20,20,0,0,20,0,19,19,0,19,0,0
ACSSF,2010e5,wv,000,0034,0001289,080,54,015,08000US540159089599999957900,"Census Tract 9579 (part), District C, District C, Clay County, West Virginia",16,16,0,0,0,0,16,0,0,0,0,0,0,0,0,0,0,0,0,0
ACSSF,2010e5,wv,000,0034,0001290,080,54,015,08000US540159089599999958000,"Census Tract 9580 (part), District C, District C, Clay County, West Virginia",324,293,93,0,14,79,200,31,0,0,0,0,0,0,31,20,0,0,20,11
ACSSF,2010e5,wv,000,0034,0001291,080,54,015,08000US540159089599999958100,"Census Tract 9581 (part), District C, District C, Clay County, West Virginia",430,384,164,0,28,136,220,46,24,0,0,0,0,24,22,8,0,8,0,14
ACSSF,2010e5,wv,000,0034,0001292,080,54,017,08000US540179013899999965000,"Census Tract 9650 (part), Beech district, Beech district, Doddridge County, West Virginia",643,516,173,0,29,144,343,127,76,57,36,0,21,19,51,0,0,0,0,51
ACSSF,2010e5,wv,000,0034,0001293,080,54,017,08000US540179013899999965100,"Census Tract 9651 (part), Beech district, Beech district, Doddridge County, West Virginia",47,10,0,0,0,0,10,37,0,0,0,0,0,0,37,37,0,37,0,0
ACSSF,2010e5,wv,000,0034,0001294,080,54,017,08000US540179209486116965100,"Census Tract 9651 (part), West Union town (part), Maple district, Doddridge County, West Virginia",72,53,11,4,7,0,42,19,7,3,0,3,0,4,12,0,0,0,0,12
ACSSF,2010e5,wv,000,0034,0001295,080,54,017,08000US540179209499999965000,"Census Tract 9650 (part), Remainder of Maple district, Maple district, Doddridge County, West Virginia",76,40,0,0,0,0,40,36,0,0,0,0,0,0,36,0,0,0,0,36
ACSSF,2010e5,wv,000,0034,0001296,080,54,017,08000US540179209499999965100,"Census Tract 9651 (part), Remainder of Maple district, Maple district, Doddridge County, West Virginia",191,143,62,0,10,52,81,48,0,0,0,0,0,0,48,23,0,0,23,25
ACSSF,2010e5,wv,000,0034,0001297,080,54,017,08000US540179237499999965000,"Census Tract 9650 (part), Oak district, Oak district, Doddridge County, West Virginia",393,338,73,0,21,52,265,55,23,23,15,0,8,0,32,22,0,0,22,10
ACSSF,2010e5,wv,000,0034,0001298,080,54,017,08000US540179237499999965100,"Census Tract 9651 (part), Oak district, Oak district, Doddridge County, West Virginia",66,66,0,0,0,0,66,0,0,0,0,0,0,0,0,0,0,0,0,0
ACSSF,2010e5,wv,000,0034,0001299,080,54,017,08000US540179246686116965100,"Census Tract 9651 (part), West Union town (part), Pine district, Doddridge County, West Virginia",108,81,31,4,2,25,50,27,9,5,5,0,0,4,18,11,0,0,11,7
ACSSF,2010e5,wv,000,0034,0001300,080,54,017,08000US540179246699999965000,"Census Tract 9650 (part), Remainder of Pine district, Pine district, Doddridge County, West Virginia",0,0,0,0,0,0,0,0,0,0,0,0,0,0,0,0,0,0,0,0
ACSSF,2010e5,wv,000,0034,0001301,080,54,017,08000US540179246699999965100,"Census Tract 9651 (part), Remainder of Pine district, Pine district, Doddridge County, West Virginia",403,235,91,26,0,65,144,168,63,38,38,0,0,25,105,65,0,0,65,40
ACSSF,2010e5,wv,000,0034,0001302,080,54,019,08000US540199228001996020900,"Census Tract 209 (part), Ansted town, New Haven district, Fayette County, West Virginia",445,364,128,42,20,66,236,81,17,3,0,0,3,14,64,40,14,4,22,24
ACSSF,2010e5,wv,000,0034,0001303,080,54,019,08000US540199228027028020100,"Census Tract 201 (part), Fayetteville town (part), New Haven district, Fayette County, West Virginia",701,525,243,37,47,159,282,176,80,35,0,5,30,45,96,48,0,13,35,48
ACSSF,2010e5,wv,000,0034,0001304,080,54,019,08000US540199228027028020202,"Census Tract 202.02 (part), Fayetteville town (part), New Haven district, Fayette County, West Virginia",54,54,0,0,0,0,54,0,0,0,0,0,0,0,0,0,0,0,0,0
ACSSF,2010e5,wv,000,0034,0001305,080,54,019,08000US540199228037036020900,"Census Tract 209 (part), Hico CDP, New Haven district, Fayette County, West Virginia",32,32,16,0,0,16,16,0,0,0,0,0,0,0,0,0,0,0,0,0
ACSSF,2010e5,wv,000,0034,0001306,080,54,019,08000US540199228037036021000,"Census Tract 210 (part), Hico CDP, New Haven district, Fayette County, West Virginia",28,18,0,0,0,0,18,10,0,0,0,0,0,0,10,0,0,0,0,10
ACSSF,2010e5,wv,000,0034,0001307,080,54,019,08000US540199228052780021100,"Census Tract 211 (part), Meadow Bridge town, New Haven district, Fayette County, West Virginia",93,69,11,3,5,3,58,24,0,0,0,0,0,0,24,15,0,7,8,9
ACSSF,2010e5,wv,000,0034,0001308,080,54,019,08000US540199228060028020202,"Census Tract 202.02 (part), Oak Hill city (part), New Haven district, Fayette County, West Virginia",52,52,0,0,0,0,52,0,0,0,0,0,0,0,0,0,0,0,0,0
ACSSF,2010e5,wv,000,0034,0001309,080,54,019,08000US540199228065668021100,"Census Tract 211 (part), Prince CDP, New Haven district, Fayette County, West Virginia",74,26,0,0,0,0,26,48,0,0,0,0,0,0,48,34,0,0,34,14
ACSSF,2010e5,wv,000,0034,0001310,080,54,019,08000US540199228099999020100,"Census Tract 201 (part), Remainder of New Haven district, New Haven district, Fayette County, West Virginia",675,540,187,15,59,113,353,135,27,27,27,0,0,0,108,45,0,16,29,63
ACSSF,2010e5,wv,000,0034,0001311,080,54,019,08000US540199228099999020201,"Census Tract 202.01 (part), Remainder of New Haven district, New Haven district, Fayette County, West Virginia",0,0,0,0,0,0,0,0,0,0,0,0,0,0,0,0,0,0,0,0
ACSSF,2010e5,wv,000,0034,0001312,080,54,019,08000US540199228099999020202,"Census Tract 202.02 (part), Remainder of New Haven district, New Haven district, Fayette County, West Virginia",38,38,17,0,17,0,21,0,0,0,0,0,0,0,0,0,0,0,0,0
ACSSF,2010e5,wv,000,0034,0001313,080,54,019,08000US540199228099999020900,"Census Tract 209 (part), Remainder of New Haven district, New Haven district, Fayette County, West Virginia",557,516,162,52,7,103,354,41,27,27,13,0,14,0,14,4,0,0,4,10
ACSSF,2010e5,wv,000,0034,0001314,080,54,019,08000US540199228099999021000,"Census Tract 210 (part), Remainder of New Haven district, New Haven district, Fayette County, West Virginia",776,651,241,50,20,171,410,125,22,0,0,0,0,22,103,61,4,31,26,42
ACSSF,2010e5,wv,000,0034,0001315,080,54,019,08000US540199228099999021100,"Census Tract 211 (part), Remainder of New Haven district, New Haven district, Fayette County, West Virginia",641,451,113,29,26,58,338,190,63,0,0,0,0,63,127,56,18,15,23,71
ACSSF,2010e5,wv,000,0034,0001316,080,54,019,08000US540199247231876020400,"Census Tract 204 (part), Glen Jean CDP, Plateau district, Fayette County, West Virginia",89,55,0,0,0,0,55,34,0,0,0,0,0,0,34,0,0,0,0,34
ACSSF,2010e5,wv,000,0034,0001317,080,54,019,08000US540199247237444020400,"Census Tract 204 (part), Hilltop CDP, Plateau district, Fayette County, West Virginia",132,54,17,0,0,17,37,78,0,0,0,0,0,0,78,69,0,0,69,9
ACSSF,2010e5,wv,000,0034,0001318,080,54,019,08000US540199247254508020201,"Census Tract 202.01 (part), Minden CDP, Plateau district, Fayette County, West Virginia",36,18,0,0,0,0,18,18,0,0,0,0,0,0,18,0,0,0,0,18
ACSSF,2010e5,wv,000,0034,0001319,080,54,019,08000US540199247256404020500,"Census Tract 205 (part), Mount Hope city (part), Plateau district, Fayette County, West Virginia",361,232,78,14,21,43,154,129,29,12,0,0,12,17,100,58,33,0,25,42
ACSSF,2010e5,wv,000,0034,0001320,080,54,019,08000US540199247260028020201,"Census Tract 202.01 (part), Oak Hill city (part), Plateau district, Fayette County, West Virginia",445,350,50,0,19,31,300,95,0,0,0,0,0,0,95,72,0,10,62,23
ACSSF,2010e5,wv,000,0034,0001321,080,54,019,08000US540199247260028020202,"Census Tract 202.02 (part), Oak Hill city (part), Plateau district, Fayette County, West Virginia",634,453,158,50,38,70,295,181,47,0,0,0,0,47,134,48,12,23,13,86
ACSSF,2010e5,wv,000,0034,0001322,080,54,019,08000US540199247260028020300,"Census Tract 203 (part), Oak Hill city (part), Plateau district, Fayette County, West Virginia",843,605,277,42,67,168,328,238,140,94,83,0,11,46,98,48,13,0,35,50
ACSSF,2010e5,wv,000,0034,0001323,080,54,019,08000US540199247260028020400,"Census Tract 204 (part), Oak Hill city (part), Plateau district, Fayette County, West Virginia",330,214,37,8,0,29,177,116,15,0,0,0,0,15,101,43,0,0,43,58
ACSSF,2010e5,wv,000,0034,0001324,080,54,019,08000US540199247260028020600,"Census Tract 206 (part), Oak Hill city (part), Plateau district, Fayette County, West Virginia",0,0,0,0,0,0,0,0,0,0,0,0,0,0,0,0,0,0,0,0
ACSSF,2010e5,wv,000,0034,0001325,080,54,019,08000US540199247280284021100,"Census Tract 211 (part), Thurmond town, Plateau district, Fayette County, West Virginia",2,2,0,0,0,0,2,0,0,0,0,0,0,0,0,0,0,0,0,0
ACSSF,2010e5,wv,000,0034,0001326,080,54,019,08000US540199247299999020100,"Census Tract 201 (part), Remainder of Plateau district, Plateau district, Fayette County, West Virginia",0,0,0,0,0,0,0,0,0,0,0,0,0,0,0,0,0,0,0,0
ACSSF,2010e5,wv,000,0034,0001327,080,54,019,08000US540199247299999020201,"Census Tract 202.01 (part), Remainder of Plateau district, Plateau district, Fayette County, West Virginia",697,596,229,34,26,169,367,101,29,8,8,0,0,21,72,36,0,0,36,36
ACSSF,2010e5,wv,000,0034,0001328,080,54,019,08000US540199247299999020202,"Census Tract 202.02 (part), Remainder of Plateau district, Plateau district, Fayette County, West Virginia",380,227,79,18,0,61,148,153,45,0,0,0,0,45,108,54,0,0,54,54
ACSSF,2010e5,wv,000,0034,0001329,080,54,019,08000US540199247299999020300,"Census Tract 203 (part), Remainder of Plateau district, Plateau district, Fayette County, West Virginia",23,23,0,0,0,0,23,0,0,0,0,0,0,0,0,0,0,0,0,0
ACSSF,2010e5,wv,000,0034,0001330,080,54,019,08000US540199247299999020400,"Census Tract 204 (part), Remainder of Plateau district, Plateau district, Fayette County, West Virginia",423,352,59,0,30,29,293,71,26,26,0,0,26,0,45,31,0,0,31,14
ACSSF,2010e5,wv,000,0034,0001331,080,54,019,08000US540199247299999020500,"Census Tract 205 (part), Remainder of Plateau district, Plateau district, Fayette County, West Virginia",213,180,48,35,0,13,132,33,11,0,0,0,0,11,22,7,7,0,0,15
ACSSF,2010e5,wv,000,0034,0001332,080,54,019,08000US540199247299999020600,"Census Tract 206 (part), Remainder of Plateau district, Plateau district, Fayette County, West Virginia",0,0,0,0,0,0,0,0,0,0,0,0,0,0,0,0,0,0,0,0
ACSSF,2010e5,wv,000,0034,0001333,080,54,019,08000US540199247299999021100,"Census Tract 211 (part), Remainder of Plateau district, Plateau district, Fayette County, West Virginia",0,0,0,0,0,0,0,0,0,0,0,0,0,0,0,0,0,0,0,0
ACSSF,2010e5,wv,000,0034,0001334,080,54,019,08000US540199339605068020700,"Census Tract 207 (part), Beards Fork CDP, Valley district, Fayette County, West Virginia",52,36,0,0,0,0,36,16,0,0,0,0,0,0,16,0,0,0,0,16
ACSSF,2010e5,wv,000,0034,0001335,080,54,019,08000US540199339609100020800,"Census Tract 208 (part), Boomer CDP, Valley district, Fayette County, West Virginia",235,138,36,0,9,27,102,97,66,34,17,0,17,32,31,0,0,0,0,31
ACSSF,2010e5,wv,000,0034,0001336,080,54,019,08000US540199339614630020800,"Census Tract 208 (part), Charlton Heights CDP, Valley district, Fayette County, West Virginia",75,59,19,0,19,0,40,16,0,0,0,0,0,0,16,0,0,0,0,16
ACSSF,2010e5,wv,000,0034,0001337,080,54,019,08000US540199339620764020700,"Census Tract 207 (part), Deep Water CDP, Valley district, Fayette County, West Virginia",35,13,13,0,0,13,0,22,12,0,0,0,0,12,10,10,0,0,10,0
ACSSF,2010e5,wv,000,0034,0001338,080,54,019,08000US540199339621628020800,"Census Tract 208 (part), Dixie CDP (part), Valley district, Fayette County, West Virginia",40,40,0,0,0,0,40,0,0,0,0,0,0,0,0,0,0,0,0,0
ACSSF,2010e5,wv,000,0034,0001339,080,54,019,08000US540199339626812020800,"Census Tract 208 (part), Falls View CDP, Valley district, Fayette County, West Virginia",42,25,0,0,0,0,25,17,17,0,0,0,0,17,0,0,0,0,0,0
ACSSF,2010e5,wv,000,0034,0001340,080,54,019,08000US540199339627028020100,"Census Tract 201 (part), Fayetteville town (part), Valley district, Fayette County, West Virginia",0,0,0,0,0,0,0,0,0,0,0,0,0,0,0,0,0,0,0,0
ACSSF,2010e5,wv,000,0034,0001341,080,54,019,08000US540199339630364020800,"Census Tract 208 (part), Gauley Bridge town, Valley district, Fayette County, West Virginia",175,102,27,0,3,24,75,73,9,0,0,0,0,9,64,42,11,6,25,22
ACSSF,2010e5,wv,000,0034,0001342,080,54,019,08000US540199339630364020900,"Census Tract 209 (part), Gauley Bridge town, Valley district, Fayette County, West Virginia",0,0,0,0,0,0,0,0,0,0,0,0,0,0,0,0,0,0,0,0
ACSSF,2010e5,wv,000,0034,0001343,080,54,019,08000US540199339631732020800,"Census Tract 208 (part), Glen Ferris CDP, Valley district, Fayette County, West Virginia",15,15,15,0,0,15,0,0,0,0,0,0,0,0,0,0,0,0,0,0
ACSSF,2010e5,wv,000,0034,0001344,080,54,019,08000US540199339643828020700,"Census Tract 207 (part), Kimberly CDP, Valley district, Fayette County, West Virginia",90,68,15,0,0,15,53,22,22,0,0,0,0,22,0,0,0,0,0,0
ACSSF,2010e5,wv,000,0034,0001345,080,54,019,08000US540199339643852020600,"Census Tract 206 (part), Kincaid CDP, Valley district, Fayette County, West Virginia",42,31,15,0,0,15,16,11,0,0,0,0,0,0,11,0,0,0,0,11
ACSSF,2010e5,wv,000,0034,0001346,080,54,019,08000US540199339643852020700,"Census Tract 207 (part), Kincaid CDP, Valley district, Fayette County, West Virginia",51,34,0,0,0,0,34,17,0,0,0,0,0,0,17,0,0,0,0,17
ACSSF,2010e5,wv,000,0034,0001347,080,54,019,08000US540199339655468020700,"Census Tract 207 (part), Montgomery city (part), Valley district, Fayette County, West Virginia",169,70,28,3,10,15,42,99,9,3,3,0,0,6,90,31,7,10,14,59
ACSSF,2010e5,wv,000,0034,0001348,080,54,019,08000US540199339656212020700,"Census Tract 207 (part), Mount Carbon CDP, Valley district, Fayette County, West Virginia",110,110,13,0,0,13,97,0,0,0,0,0,0,0,0,0,0,0,0,0
ACSSF,2010e5,wv,000,0034,0001349,080,54,019,08000US540199339656404020400,"Census Tract 204 (part), Mount Hope city (part), Valley district, Fayette County, West Virginia",0,0,0,0,0,0,0,0,0,0,0,0,0,0,0,0,0,0,0,0
ACSSF,2010e5,wv,000,0034,0001350,080,54,019,08000US540199339656404020600,"Census Tract 206 (part), Mount Hope city (part), Valley district, Fayette County, West Virginia",0,0,0,0,0,0,0,0,0,0,0,0,0,0,0,0,0,0,0,0
ACSSF,2010e5,wv,000,0034,0001351,080,54,019,08000US540199339660028020202,"Census Tract 202.02 (part), Oak Hill city (part), Valley district, Fayette County, West Virginia",0,0,0,0,0,0,0,0,0,0,0,0,0,0,0,0,0,0,0,0
ACSSF,2010e5,wv,000,0034,0001352,080,54,019,08000US540199339660028020400,"Census Tract 204 (part), Oak Hill city (part), Valley district, Fayette County, West Virginia",0,0,0,0,0,0,0,0,0,0,0,0,0,0,0,0,0,0,0,0
ACSSF,2010e5,wv,000,0034,0001353,080,54,019,08000US540199339660028020600,"Census Tract 206 (part), Oak Hill city (part), Valley district, Fayette County, West Virginia",0,0,0,0,0,0,0,0,0,0,0,0,0,0,0,0,0,0,0,0
ACSSF,2010e5,wv,000,0034,0001354,080,54,019,08000US540199339661660020600,"Census Tract 206 (part), Page CDP, Valley district, Fayette County, West Virginia",42,26,0,0,0,0,26,16,0,0,0,0,0,0,16,16,0,0,16,0
ACSSF,2010e5,wv,000,0034,0001355,080,54,019,08000US540199339661660020700,"Census Tract 207 (part), Page CDP, Valley district, Fayette County, West Virginia",0,0,0,0,0,0,0,0,0,0,0,0,0,0,0,0,0,0,0,0
ACSSF,2010e5,wv,000,0034,0001356,080,54,019,08000US540199339662356020600,"Census Tract 206 (part), Pax town, Valley district, Fayette County, West Virginia",37,29,12,2,0,10,17,8,0,0,0,0,0,0,8,6,2,0,4,2
ACSSF,2010e5,wv,000,0034,0001357,080,54,019,08000US540199339665284020700,"Census Tract 207 (part), Powellton CDP, Valley district, Fayette County, West Virginia",144,130,29,15,0,14,101,14,0,0,0,0,0,0,14,0,0,0,0,14
ACSSF,2010e5,wv,000,0034,0001358,080,54,019,08000US540199339672292020400,"Census Tract 204 (part), Scarbro CDP, Valley district, Fayette County, West Virginia",155,117,18,18,0,0,99,38,0,0,0,0,0,0,38,0,0,0,0,38
ACSSF,2010e5,wv,000,0034,0001359,080,54,019,08000US540199339674740020800,"Census Tract 208 (part), Smithers city (part), Valley district, Fayette County, West Virginia",209,75,15,3,0,12,60,134,44,27,22,0,5,17,90,38,5,8,25,52
ACSSF,2010e5,wv,000,0034,0001360,080,54,019,08000US540199339699999020100,"Census Tract 201 (part), Remainder of Valley district, Valley district, Fayette County, West Virginia",130,130,15,0,15,0,115,0,0,0,0,0,0,0,0,0,0,0,0,0
ACSSF,2010e5,wv,000,0034,0001361,080,54,019,08000US540199339699999020202,"Census Tract 202.02 (part), Remainder of Valley district, Valley district, Fayette County, West Virginia",12,12,0,0,0,0,12,0,0,0,0,0,0,0,0,0,0,0,0,0
ACSSF,2010e5,wv,000,0034,0001362,080,54,019,08000US540199339699999020400,"Census Tract 204 (part), Remainder of Valley district, Valley district, Fayette County, West Virginia",325,246,102,11,0,91,144,79,22,14,0,0,14,8,57,18,0,0,18,39
ACSSF,2010e5,wv,000,0034,0001363,080,54,019,08000US540199339699999020600,"Census Tract 206 (part), Remainder of Valley district, Valley district, Fayette County, West Virginia",391,315,162,15,78,69,153,76,0,0,0,0,0,0,76,14,0,0,14,62
ACSSF,2010e5,wv,000,0034,0001364,080,54,019,08000US540199339699999020700,"Census Tract 207 (part), Remainder of Valley district, Valley district, Fayette County, West Virginia",480,266,118,14,14,90,148,214,117,82,16,0,66,35,97,33,0,16,17,64
ACSSF,2010e5,wv,000,0034,0001365,080,54,019,08000US540199339699999020800,"Census Tract 208 (part), Remainder of Valley district, Valley district, Fayette County, West Virginia",380,325,91,11,16,64,234,55,15,15,0,15,0,0,40,0,0,0,0,40
ACSSF,2010e5,wv,000,0034,0001366,080,54,019,08000US540199339699999020900,"Census Tract 209 (part), Remainder of Valley district, Valley district, Fayette County, West Virginia",134,106,18,0,8,10,88,28,0,0,0,0,0,0,28,0,0,0,0,28
ACSSF,2010e5,wv,000,0034,0001367,080,54,021,08000US540219040899999967700,"Census Tract 9677 (part), Center district, Center district, Gilmer County, West Virginia",409,282,28,0,0,28,254,127,15,0,0,0,0,15,112,76,10,0,66,36
ACSSF,2010e5,wv,000,0034,0001368,080,54,021,08000US540219040899999967800,"Census Tract 9678 (part), Center district, Center district, Gilmer County, West Virginia",0,0,0,0,0,0,0,0,0,0,0,0,0,0,0,0,0,0,0,0
ACSSF,2010e5,wv,000,0034,0001369,080,54,021,08000US540219053432044967800,"Census Tract 9678 (part), Glenville town, City district, Gilmer County, West Virginia",325,189,104,13,17,74,85,136,25,8,0,0,8,17,111,41,3,23,15,70
ACSSF,2010e5,wv,000,0034,0001370,080,54,021,08000US540219053499999967700,"Census Tract 9677 (part), Remainder of City district, City district, Gilmer County, West Virginia",48,48,13,0,0,13,35,0,0,0,0,0,0,0,0,0,0,0,0,0
ACSSF,2010e5,wv,000,0034,0001371,080,54,021,08000US540219053499999967800,"Census Tract 9678 (part), Remainder of City district, City district, Gilmer County, West Virginia",19,19,19,0,0,19,0,0,0,0,0,0,0,0,0,0,0,0,0,0
ACSSF,2010e5,wv,000,0034,0001372,080,54,021,08000US540219075899999967700,"Census Tract 9677 (part), De Kalb-Troy district, De Kalb-Troy district, Gilmer County, West Virginia",372,311,175,32,19,124,136,61,43,6,0,0,6,37,18,0,0,0,0,18
ACSSF,2010e5,wv,000,0034,0001373,080,54,021,08000US540219075899999967800,"Census Tract 9678 (part), De Kalb-Troy district, De Kalb-Troy district, Gilmer County, West Virginia",85,74,0,0,0,0,74,11,0,0,0,0,0,0,11,11,0,0,11,0
ACSSF,2010e5,wv,000,0034,0001374,080,54,021,08000US540219123671620967700,"Census Tract 9677 (part), Sand Fork town, Glenville district, Gilmer County, West Virginia",85,46,26,5,14,7,20,39,5,5,0,5,0,0,34,13,8,5,0,21
ACSSF,2010e5,wv,000,0034,0001375,080,54,021,08000US540219123699999967700,"Census Tract 9677 (part), Remainder of Glenville district, Glenville district, Gilmer County, West Virginia",107,92,0,0,0,0,92,15,0,0,0,0,0,0,15,0,0,0,0,15
ACSSF,2010e5,wv,000,0034,0001376,080,54,021,08000US540219123699999967800,"Census Tract 9678 (part), Remainder of Glenville district, Glenville district, Gilmer County, West Virginia",99,94,30,20,0,10,64,5,0,0,0,0,0,0,5,0,0,0,0,5
ACSSF,2010e5,wv,000,0034,0001377,080,54,023,08000US540239129662956969600,"Census Tract 9696 (part), Petersburg city (part), Grant district, Grant County, West Virginia",0,0,0,0,0,0,0,0,0,0,0,0,0,0,0,0,0,0,0,0
ACSSF,2010e5,wv,000,0034,0001378,080,54,023,08000US540239129699999969400,"Census Tract 9694 (part), Remainder of Grant district, Grant district, Grant County, West Virginia",238,227,95,12,0,83,132,11,0,0,0,0,0,0,11,0,0,0,0,11
ACSSF,2010e5,wv,000,0034,0001379,080,54,023,08000US540239129699999969500,"Census Tract 9695 (part), Remainder of Grant district, Grant district, Grant County, West Virginia",670,580,247,145,33,69,333,90,0,0,0,0,0,0,90,59,14,14,31,31
ACSSF,2010e5,wv,000,0034,0001380,080,54,023,08000US540239129699999969600,"Census Tract 9696 (part), Remainder of Grant district, Grant district, Grant County, West Virginia",208,151,24,0,0,24,127,57,0,0,0,0,0,0,57,46,46,0,0,11
ACSSF,2010e5,wv,000,0034,0001381,080,54,023,08000US540239220862956969500,"Census Tract 9695 (part), Petersburg city (part), Milroy district, Grant County, West Virginia",0,0,0,0,0,0,0,0,0,0,0,0,0,0,0,0,0,0,0,0
ACSSF,2010e5,wv,000,0034,0001382,080,54,023,08000US540239220862956969600,"Census Tract 9696 (part), Petersburg city (part), Milroy district, Grant County, West Virginia",731,512,163,41,30,92,349,219,65,50,50,0,0,15,154,96,10,0,86,58
ACSSF,2010e5,wv,000,0034,0001383,080,54,023,08000US540239220899999969500,"Census Tract 9695 (part), Remainder of Milroy district, Milroy district, Grant County, West Virginia",107,91,30,0,16,14,61,16,16,16,0,0,16,0,0,0,0,0,0,0
ACSSF,2010e5,wv,000,0034,0001384,080,54,023,08000US540239220899999969600,"Census Tract 9696 (part), Remainder of Milroy district, Milroy district, Grant County, West Virginia",410,272,56,21,0,35,216,138,67,38,0,0,38,29,71,71,20,0,51,0
ACSSF,2010e5,wv,000,0034,0001385,080,54,023,08000US540239321604924969400,"Census Tract 9694 (part), Bayard town, Union district, Grant County, West Virginia",110,90,43,10,0,33,47,20,4,4,0,0,4,0,16,8,8,0,0,8
ACSSF,2010e5,wv,000,0034,0001386,080,54,023,08000US540239321699999969400,"Census Tract 9694 (part), Remainder of Union district, Union district, Grant County, West Virginia",604,556,172,33,81,58,384,48,0,0,0,0,0,0,48,22,13,0,9,26
ACSSF,2010e5,wv,000,0034,0001387,080,54,023,08000US540239321699999969500,"Census Tract 9695 (part), Remainder of Union district, Union district, Grant County, West Virginia",373,310,78,21,12,45,232,63,32,0,0,0,0,32,31,19,0,0,19,12
ACSSF,2010e5,wv,000,0034,0001388,080,54,025,08000US540259044926428950600,"Census Tract 9506 (part), Fairlea CDP, Central district, Greenbrier County, West Virginia",316,259,119,82,24,13,140,57,0,0,0,0,0,0,57,0,0,0,0,57
ACSSF,2010e5,wv,000,0034,0001389,080,54,025,08000US540259044926428950700,"Census Tract 9507 (part), Fairlea CDP, Central district, Greenbrier County, West Virginia",298,201,81,14,42,25,120,97,43,0,0,0,0,43,54,42,0,42,0,12
ACSSF,2010e5,wv,000,0034,0001390,080,54,025,08000US540259044946636950400,"Census Tract 9504 (part), Lewisburg city, Central district, Greenbrier County, West Virginia",119,119,63,24,0,39,56,0,0,0,0,0,0,0,0,0,0,0,0,0
ACSSF,2010e5,wv,000,0034,0001391,080,54,025,08000US540259044946636950600,"Census Tract 9506 (part), Lewisburg city, Central district, Greenbrier County, West Virginia",877,772,211,73,48,90,561,105,38,0,0,0,0,38,67,28,0,0,28,39
ACSSF,2010e5,wv,000,0034,0001392,080,54,025,08000US540259044970156950700,"Census Tract 9507 (part), Ronceverte city (part), Central district, Greenbrier County, West Virginia",178,136,40,7,10,23,96,42,3,3,0,0,3,0,39,17,9,0,8,22
ACSSF,2010e5,wv,000,0034,0001393,080,54,025,08000US540259044999999950100,"Census Tract 9501 (part), Remainder of Central district, Central district, Greenbrier County, West Virginia",0,0,0,0,0,0,0,0,0,0,0,0,0,0,0,0,0,0,0,0
ACSSF,2010e5,wv,000,0034,0001394,080,54,025,08000US540259044999999950400,"Census Tract 9504 (part), Remainder of Central district, Central district, Greenbrier County, West Virginia",1260,940,339,0,117,222,601,320,59,35,35,0,0,24,261,103,38,0,65,158
ACSSF,2010e5,wv,000,0034,0001395,080,54,025,08000US540259044999999950500,"Census Tract 9505 (part), Remainder of Central district, Central district, Greenbrier County, West Virginia",132,101,32,14,0,18,69,31,4,0,0,0,0,4,27,27,27,0,0,0
ACSSF,2010e5,wv,000,0034,0001396,080,54,025,08000US540259044999999950600,"Census Tract 9506 (part), Remainder of Central district, Central district, Greenbrier County, West Virginia",166,166,88,24,0,64,78,0,0,0,0,0,0,0,0,0,0,0,0,0
ACSSF,2010e5,wv,000,0034,0001397,080,54,025,08000US540259044999999950700,"Census Tract 9507 (part), Remainder of Central district, Central district, Greenbrier County, West Virginia",215,124,39,12,0,27,85,91,15,0,0,0,0,15,76,64,0,0,64,12
ACSSF,2010e5,wv,000,0034,0001398,080,54,025,08000US540259097200772950500,"Census Tract 9505 (part), Alderson town (part), Eastern district, Greenbrier County, West Virginia",239,156,47,21,11,15,109,83,7,4,0,0,4,3,76,43,25,5,13,33
ACSSF,2010e5,wv,000,0034,0001399,080,54,025,08000US540259097200772950700,"Census Tract 9507 (part), Alderson town (part), Eastern district, Greenbrier County, West Virginia",41,0,0,0,0,0,0,41,41,41,41,0,0,0,0,0,0,0,0,0
ACSSF,2010e5,wv,000,0034,0001400,080,54,025,08000US540259097226692950100,"Census Tract 9501 (part), Falling Spring town, Eastern district, Greenbrier County, West Virginia",8,8,2,0,0,2,6,0,0,0,0,0,0,0,0,0,0,0,0,0
ACSSF,2010e5,wv,000,0034,0001401,080,54,025,08000US540259097226692950200,"Census Tract 9502 (part), Falling Spring town, Eastern district, Greenbrier County, West Virginia",42,36,9,0,4,5,27,6,3,3,0,3,0,0,3,0,0,0,0,3
ACSSF,2010e5,wv,000,0034,0001402,080,54,025,08000US540259097226692950400,"Census Tract 9504 (part), Falling Spring town, Eastern district, Greenbrier County, West Virginia",1,1,0,0,0,0,1,0,0,0,0,0,0,0,0,0,0,0,0,0
ACSSF,2010e5,wv,000,0034,0001403,080,54,025,08000US540259097270156950700,"Census Tract 9507 (part), Ronceverte city (part), Eastern district, Greenbrier County, West Virginia",280,212,69,23,20,26,143,68,18,3,0,0,3,15,50,17,3,3,11,33
ACSSF,2010e5,wv,000,0034,0001404,080,54,025,08000US540259097286812950100,"Census Tract 9501 (part), White Sulphur Springs city, Eastern district, Greenbrier County, West Virginia",747,455,127,22,46,59,328,292,107,83,0,21,62,24,185,117,38,36,43,68
ACSSF,2010e5,wv,000,0034,0001405,080,54,025,08000US540259097286812950700,"Census Tract 9507 (part), White Sulphur Springs city, Eastern district, Greenbrier County, West Virginia",0,0,0,0,0,0,0,0,0,0,0,0,0,0,0,0,0,0,0,0
ACSSF,2010e5,wv,000,0034,0001406,080,54,025,08000US540259097299999950100,"Census Tract 9501 (part), Remainder of Eastern district, Eastern district, Greenbrier County, West Virginia",760,552,75,22,25,28,477,208,19,19,0,0,19,0,189,43,28,15,0,146
ACSSF,2010e5,wv,000,0034,0001407,080,54,025,08000US540259097299999950200,"Census Tract 9502 (part), Remainder of Eastern district, Eastern district, Greenbrier County, West Virginia",147,130,27,0,0,27,103,17,17,0,0,0,0,17,0,0,0,0,0,0
ACSSF,2010e5,wv,000,0034,0001408,080,54,025,08000US540259097299999950400,"Census Tract 9504 (part), Remainder of Eastern district, Eastern district, Greenbrier County, West Virginia",0,0,0,0,0,0,0,0,0,0,0,0,0,0,0,0,0,0,0,0
ACSSF,2010e5,wv,000,0034,0001409,080,54,025,08000US540259097299999950500,"Census Tract 9505 (part), Remainder of Eastern district, Eastern district, Greenbrier County, West Virginia",180,168,97,55,0,42,71,12,0,0,0,0,0,0,12,0,0,0,0,12
ACSSF,2010e5,wv,000,0034,0001410,080,54,025,08000US540259097299999950700,"Census Tract 9507 (part), Remainder of Eastern district, Eastern district, Greenbrier County, West Virginia",862,623,200,30,14,156,423,239,76,12,0,0,12,64,163,133,0,0,133,30
ACSSF,2010e5,wv,000,0034,0001411,080,54,025,08000US540259360166412950200,"Census Tract 9502 (part), Quinwood town, Western district, Greenbrier County, West Virginia",84,56,13,0,0,13,43,28,14,10,6,0,4,4,14,10,0,0,10,4
ACSSF,2010e5,wv,000,0034,0001412,080,54,025,08000US540259360166412950300,"Census Tract 9503 (part), Quinwood town, Western district, Greenbrier County, West Virginia",9,9,0,0,0,0,9,0,0,0,0,0,0,0,0,0,0,0,0,0
ACSSF,2010e5,wv,000,0034,0001413,080,54,025,08000US540259360166652950300,"Census Tract 9503 (part), Rainelle town, Western district, Greenbrier County, West Virginia",431,310,119,69,0,50,191,121,30,0,0,0,0,30,91,48,18,23,7,43
ACSSF,2010e5,wv,000,0034,0001414,080,54,025,08000US540259360170828950200,"Census Tract 9502 (part), Rupert town, Western district, Greenbrier County, West Virginia",281,167,50,16,3,31,117,114,25,15,0,0,15,10,89,67,8,0,59,22
ACSSF,2010e5,wv,000,0034,0001415,080,54,025,08000US540259360199999950200,"Census Tract 9502 (part), Remainder of Western district, Western district, Greenbrier County, West Virginia",697,591,150,26,30,94,441,106,40,0,0,0,0,40,66,52,0,0,52,14
ACSSF,2010e5,wv,000,0034,0001416,080,54,025,08000US540259360199999950300,"Census Tract 9503 (part), Remainder of Western district, Western district, Greenbrier County, West Virginia",753,555,261,84,90,87,294,198,72,15,0,0,15,57,126,46,0,0,46,80
ACSSF,2010e5,wv,000,0034,0001417,080,54,025,08000US540259360199999950400,"Census Tract 9504 (part), Remainder of Western district, Western district, Greenbrier County, West Virginia",502,350,132,40,0,92,218,152,73,54,11,0,43,19,79,39,0,0,39,40
ACSSF,2010e5,wv,000,0034,0001418,080,54,025,08000US540259360199999950500,"Census Tract 9505 (part), Remainder of Western district, Western district, Greenbrier County, West Virginia",352,308,89,0,34,55,219,44,13,13,0,0,13,0,31,9,0,0,9,22
ACSSF,2010e5,wv,000,0034,0001419,080,54,027,08000US540279020413108968200,"Census Tract 9682 (part), Capon Bridge town (part), Bloomery district, Hampshire County, West Virginia",1,0,0,0,0,0,0,1,0,0,0,0,0,0,1,0,0,0,0,1
ACSSF,2010e5,wv,000,0034,0001420,080,54,027,08000US540279020413108968600,"Census Tract 9686 (part), Capon Bridge town (part), Bloomery district, Hampshire County, West Virginia",11,11,4,4,0,0,7,0,0,0,0,0,0,0,0,0,0,0,0,0
ACSSF,2010e5,wv,000,0034,0001421,080,54,027,08000US540279020499999968200,"Census Tract 9682 (part), Remainder of Bloomery district, Bloomery district, Hampshire County, West Virginia",689,558,170,22,17,131,388,131,118,102,0,0,102,16,13,0,0,0,0,13
ACSSF,2010e5,wv,000,0034,0001422,080,54,027,08000US540279020499999968600,"Census Tract 9686 (part), Remainder of Bloomery district, Bloomery district, Hampshire County, West Virginia",36,23,10,0,0,10,13,13,13,13,0,0,13,0,0,0,0,0,0,0
ACSSF,2010e5,wv,000,0034,0001423,080,54,027,08000US540279036013108968600,"Census Tract 9686 (part), Capon Bridge town (part), Capon district, Hampshire County, West Virginia",91,44,18,7,6,5,26,47,0,0,0,0,0,0,47,32,0,0,32,15
ACSSF,2010e5,wv,000,0034,0001424,080,54,027,08000US540279036099999968600,"Census Tract 9686 (part), Remainder of Capon district, Capon district, Hampshire County, West Virginia",513,414,120,0,21,99,294,99,26,14,0,0,14,12,73,47,0,0,47,26
ACSSF,2010e5,wv,000,0034,0001425,080,54,027,08000US540279124899999968200,"Census Tract 9682 (part), Gore district, Gore district, Hampshire County, West Virginia",559,466,147,18,16,113,319,93,13,0,0,0,0,13,80,0,0,0,0,80
ACSSF,2010e5,wv,000,0034,0001426,080,54,027,08000US540279124899999968300,"Census Tract 9683 (part), Gore district, Gore district, Hampshire County, West Virginia",598,401,84,0,10,74,317,197,64,54,16,0,38,10,133,76,0,0,76,57
ACSSF,2010e5,wv,000,0034,0001427,080,54,027,08000US540279218499999968400,"Census Tract 9684 (part), Mill Creek district, Mill Creek district, Hampshire County, West Virginia",348,294,76,30,0,46,218,54,6,0,0,0,0,6,48,31,13,18,0,17
ACSSF,2010e5,wv,000,0034,0001428,080,54,027,08000US540279267670084968400,"Census Tract 9684 (part), Romney city, Romney district, Hampshire County, West Virginia",288,210,59,9,16,34,151,78,18,8,0,0,8,10,60,30,0,0,30,30
ACSSF,2010e5,wv,000,0034,0001429,080,54,027,08000US540279267670084968500,"Census Tract 9685 (part), Romney city, Romney district, Hampshire County, West Virginia",100,77,29,17,0,12,48,23,0,0,0,0,0,0,23,0,0,0,0,23
ACSSF,2010e5,wv,000,0034,0001430,080,54,027,08000US540279267699999968300,"Census Tract 9683 (part), Remainder of Romney district, Romney district, Hampshire County, West Virginia",33,33,0,0,0,0,33,0,0,0,0,0,0,0,0,0,0,0,0,0
ACSSF,2010e5,wv,000,0034,0001431,080,54,027,08000US540279267699999968400,"Census Tract 9684 (part), Remainder of Romney district, Romney district, Hampshire County, West Virginia",301,192,46,0,19,27,146,109,11,0,0,0,0,11,98,85,11,21,53,13
ACSSF,2010e5,wv,000,0034,0001432,080,54,027,08000US540279267699999968500,"Census Tract 9685 (part), Remainder of Romney district, Romney district, Hampshire County, West Virginia",168,108,53,0,0,53,55,60,0,0,0,0,0,0,60,21,0,0,21,39
ACSSF,2010e5,wv,000,0034,0001433,080,54,027,08000US540279282099999968500,"Census Tract 9685 (part), Sherman district, Sherman district, Hampshire County, West Virginia",769,592,220,46,42,132,372,177,9,0,0,0,0,9,168,140,0,36,104,28
ACSSF,2010e5,wv,000,0034,0001434,080,54,027,08000US540279282099999968600,"Census Tract 9686 (part), Sherman district, Sherman district, Hampshire County, West Virginia",506,349,201,27,135,39,148,157,83,0,0,0,0,83,74,53,33,0,20,21
ACSSF,2010e5,wv,000,0034,0001435,080,54,027,08000US540279298833436968300,"Census Tract 9683 (part), Green Spring CDP, Springfield district, Hampshire County, West Virginia",30,30,13,0,0,13,17,0,0,0,0,0,0,0,0,0,0,0,0,0
ACSSF,2010e5,wv,000,0034,0001436,080,54,027,08000US540279298833436968400,"Census Tract 9684 (part), Green Spring CDP, Springfield district, Hampshire County, West Virginia",13,13,0,0,0,0,13,0,0,0,0,0,0,0,0,0,0,0,0,0
ACSSF,2010e5,wv,000,0034,0001437,080,54,027,08000US540279298876084968300,"Census Tract 9683 (part), Springfield CDP, Springfield district, Hampshire County, West Virginia",88,56,12,0,12,0,44,32,0,0,0,0,0,0,32,0,0,0,0,32
ACSSF,2010e5,wv,000,0034,0001438,080,54,027,08000US540279298876084968400,"Census Tract 9684 (part), Springfield CDP, Springfield district, Hampshire County, West Virginia",84,84,38,38,0,0,46,0,0,0,0,0,0,0,0,0,0,0,0,0
ACSSF,2010e5,wv,000,0034,0001439,080,54,027,08000US540279298899999968200,"Census Tract 9682 (part), Remainder of Springfield district, Springfield district, Hampshire County, West Virginia",0,0,0,0,0,0,0,0,0,0,0,0,0,0,0,0,0,0,0,0
ACSSF,2010e5,wv,000,0034,0001440,080,54,027,08000US540279298899999968300,"Census Tract 9683 (part), Remainder of Springfield district, Springfield district, Hampshire County, West Virginia",434,282,119,0,16,103,163,152,18,0,0,0,0,18,134,84,0,0,84,50
ACSSF,2010e5,wv,000,0034,0001441,080,54,027,08000US540279298899999968400,"Census Tract 9684 (part), Remainder of Springfield district, Springfield district, Hampshire County, West Virginia",144,113,22,0,0,22,91,31,0,0,0,0,0,0,31,31,0,19,12,0
ACSSF,2010e5,wv,000,0034,0001442,080,54,029,08000US540299031285156020600,"Census Tract 206, Weirton city (part), Butler district, Hancock County, West Virginia",1293,989,243,57,37,149,746,304,84,25,17,0,8,59,220,109,0,50,59,111
ACSSF,2010e5,wv,000,0034,0001443,080,54,029,08000US540299031285156020700,"Census Tract 207, Weirton city (part), Butler district, Hancock County, West Virginia",1221,950,324,81,71,172,626,271,81,32,0,0,32,49,190,122,0,37,85,68
ACSSF,2010e5,wv,000,0034,0001444,080,54,029,08000US540299031285156021300,"Census Tract 213 (part), Weirton city (part), Butler district, Hancock County, West Virginia",46,14,0,0,0,0,14,32,0,0,0,0,0,0,32,21,0,0,21,11
ACSSF,2010e5,wv,000,0034,0001445,080,54,029,08000US540299031285156021400,"Census Tract 214 (part), Weirton city (part), Butler district, Hancock County, West Virginia",483,343,116,0,40,76,227,140,9,9,0,0,9,0,131,86,0,25,61,45
ACSSF,2010e5,wv,000,0034,0001446,080,54,029,08000US540299054058372021200,"Census Tract 212 (part), New Cumberland city, Clay district, Hancock County, West Virginia",346,227,78,24,12,42,149,119,53,47,0,16,31,6,66,24,3,0,21,42
ACSSF,2010e5,wv,000,0034,0001447,080,54,029,08000US540299054085156021300,"Census Tract 213 (part), Weirton city (part), Clay district, Hancock County, West Virginia",831,438,213,77,52,84,225,393,71,49,38,0,11,22,322,156,48,32,76,166
ACSSF,2010e5,wv,000,0034,0001448,080,54,029,08000US540299054085156021400,"Census Tract 214 (part), Weirton city (part), Clay district, Hancock County, West Virginia",597,427,132,44,28,60,295,170,99,54,28,0,26,45,71,27,19,0,8,44
ACSSF,2010e5,wv,000,0034,0001449,080,54,029,08000US540299054099999021100,"Census Tract 211 (part), Remainder of Clay district, Clay district, Hancock County, West Virginia",899,787,300,37,91,172,487,112,70,0,0,0,0,70,42,8,0,0,8,34
ACSSF,2010e5,wv,000,0034,0001450,080,54,029,08000US540299054099999021200,"Census Tract 212 (part), Remainder of Clay district, Clay district, Hancock County, West Virginia",163,126,21,0,0,21,105,37,18,0,0,0,0,18,19,0,0,0,0,19
ACSSF,2010e5,wv,000,0034,0001451,080,54,029,08000US540299054099999021300,"Census Tract 213 (part), Remainder of Clay district, Clay district, Hancock County, West Virginia",0,0,0,0,0,0,0,0,0,0,0,0,0,0,0,0,0,0,0,0
ACSSF,2010e5,wv,000,0034,0001452,080,54,029,08000US540299130815076021500,"Census Tract 215 (part), Chester city, Grant district, Hancock County, West Virginia",666,539,213,40,41,132,326,127,54,54,9,0,45,0,73,37,5,16,16,36
ACSSF,2010e5,wv,000,0034,0001453,080,54,029,08000US540299130858420020900,"Census Tract 209 (part), Newell CDP, Grant district, Hancock County, West Virginia",289,195,53,27,0,26,142,94,29,29,0,0,29,0,65,48,0,0,48,17
ACSSF,2010e5,wv,000,0034,0001454,080,54,029,08000US540299130858420021500,"Census Tract 215 (part), Newell CDP, Grant district, Hancock County, West Virginia",23,23,0,0,0,0,23,0,0,0,0,0,0,0,0,0,0,0,0,0
ACSSF,2010e5,wv,000,0034,0001455,080,54,029,08000US540299130899999020900,"Census Tract 209 (part), Remainder of Grant district, Grant district, Hancock County, West Virginia",614,517,117,11,46,60,400,97,10,10,10,0,0,0,87,54,0,0,54,33
ACSSF,2010e5,wv,000,0034,0001456,080,54,029,08000US540299130899999021100,"Census Tract 211 (part), Remainder of Grant district, Grant district, Hancock County, West Virginia",364,318,116,27,65,24,202,46,14,14,0,0,14,0,32,0,0,0,0,32
ACSSF,2010e5,wv,000,0034,0001457,080,54,029,08000US540299130899999021200,"Census Tract 212 (part), Remainder of Grant district, Grant district, Hancock County, West Virginia",431,407,142,99,0,43,265,24,24,24,24,0,0,0,0,0,0,0,0,0
ACSSF,2010e5,wv,000,0034,0001458,080,54,029,08000US540299130899999021500,"Census Tract 215 (part), Remainder of Grant district, Grant district, Hancock County, West Virginia",616,466,178,0,15,163,288,150,24,7,0,0,7,17,126,38,0,20,18,88
ACSSF,2010e5,wv,000,0034,0001459,080,54,031,08000US540319037284580970100,"Census Tract 9701 (part), Wardensville town, Capon district, Hardy County, West Virginia",93,74,22,4,0,18,52,19,6,6,4,0,2,0,13,13,0,4,9,0
ACSSF,2010e5,wv,000,0034,0001460,080,54,031,08000US540319037299999970100,"Census Tract 9701 (part), Remainder of Capon district, Capon district, Hardy County, West Virginia",548,461,54,10,14,30,407,87,22,22,0,0,22,0,65,36,17,19,0,29
ACSSF,2010e5,wv,000,0034,0001461,080,54,031,08000US540319037299999970200,"Census Tract 9702 (part), Remainder of Capon district, Capon district, Hardy County, West Virginia",38,38,38,0,0,38,0,0,0,0,0,0,0,0,0,0,0,0,0,0
ACSSF,2010e5,wv,000,0034,0001462,080,54,031,08000US540319196899999970100,"Census Tract 9701 (part), Lost River district, Lost River district, Hardy County, West Virginia",18,18,0,0,0,0,18,0,0,0,0,0,0,0,0,0,0,0,0,0
ACSSF,2010e5,wv,000,0034,0001463,080,54,031,08000US540319196899999970200,"Census Tract 9702 (part), Lost River district, Lost River district, Hardy County, West Virginia",370,309,22,0,0,22,287,61,36,13,13,0,0,23,25,25,0,0,25,0
ACSSF,2010e5,wv,000,0034,0001464,080,54,031,08000US540319196899999970300,"Census Tract 9703 (part), Lost River district, Lost River district, Hardy County, West Virginia",207,144,18,10,0,8,126,63,0,0,0,0,0,0,63,0,0,0,0,63
ACSSF,2010e5,wv,000,0034,0001465,080,54,031,08000US540319223255588970200,"Census Tract 9702 (part), Moorefield town (part), Moorefield district, Hardy County, West Virginia",227,167,40,0,0,40,127,60,8,0,0,0,0,8,52,30,6,0,24,22
ACSSF,2010e5,wv,000,0034,0001466,080,54,031,08000US540319223255588970300,"Census Tract 9703 (part), Moorefield town (part), Moorefield district, Hardy County, West Virginia",127,88,15,7,0,8,73,39,5,0,0,0,0,5,34,34,0,8,26,0
ACSSF,2010e5,wv,000,0034,0001467,080,54,031,08000US540319223299999970200,"Census Tract 9702 (part), Remainder of Moorefield district, Moorefield district, Hardy County, West Virginia",57,32,0,0,0,0,32,25,0,0,0,0,0,0,25,0,0,0,0,25
ACSSF,2010e5,wv,000,0034,0001468,080,54,031,08000US540319223299999970300,"Census Tract 9703 (part), Remainder of Moorefield district, Moorefield district, Hardy County, West Virginia",41,16,16,0,16,0,0,25,25,0,0,0,0,25,0,0,0,0,0,0
ACSSF,2010e5,wv,000,0034,0001469,080,54,031,08000US540319238255588970200,"Census Tract 9702 (part), Moorefield town (part), Old Fields district, Hardy County, West Virginia",160,102,11,0,7,4,91,58,5,0,0,0,0,5,53,39,0,30,9,14
ACSSF,2010e5,wv,000,0034,0001470,080,54,031,08000US540319238299999970100,"Census Tract 9701 (part), Remainder of Old Fields district, Old Fields district, Hardy County, West Virginia",356,290,16,0,9,7,274,66,14,0,0,0,0,14,52,36,16,0,20,16
ACSSF,2010e5,wv,000,0034,0001471,080,54,031,08000US540319238299999970200,"Census Tract 9702 (part), Remainder of Old Fields district, Old Fields district, Hardy County, West Virginia",147,129,48,0,28,20,81,18,0,0,0,0,0,0,18,18,0,18,0,0
ACSSF,2010e5,wv,000,0034,0001472,080,54,031,08000US540319238299999970300,"Census Tract 9703 (part), Remainder of Old Fields district, Old Fields district, Hardy County, West Virginia",0,0,0,0,0,0,0,0,0,0,0,0,0,0,0,0,0,0,0,0
ACSSF,2010e5,wv,000,0034,0001473,080,54,031,08000US540319292855588970300,"Census Tract 9703 (part), Moorefield town (part), South Fork district, Hardy County, West Virginia",0,0,0,0,0,0,0,0,0,0,0,0,0,0,0,0,0,0,0,0
ACSSF,2010e5,wv,000,0034,0001474,080,54,031,08000US540319292899999970100,"Census Tract 9701 (part), Remainder of South Fork district, South Fork district, Hardy County, West Virginia",0,0,0,0,0,0,0,0,0,0,0,0,0,0,0,0,0,0,0,0
ACSSF,2010e5,wv,000,0034,0001475,080,54,031,08000US540319292899999970200,"Census Tract 9702 (part), Remainder of South Fork district, South Fork district, Hardy County, West Virginia",26,26,0,0,0,0,26,0,0,0,0,0,0,0,0,0,0,0,0,0
ACSSF,2010e5,wv,000,0034,0001476,080,54,031,08000US540319292899999970300,"Census Tract 9703 (part), Remainder of South Fork district, South Fork district, Hardy County, West Virginia",601,543,195,37,41,117,348,58,27,18,0,0,18,9,31,31,16,0,15,0
ACSSF,2010e5,wv,000,0034,0001477,080,54,033,08000US540339097501900031100,"Census Tract 311 (part), Anmoore town (part), Eastern district, Harrison County, West Virginia",32,17,6,0,0,6,11,15,0,0,0,0,0,0,15,0,0,0,0,15
ACSSF,2010e5,wv,000,0034,0001478,080,54,033,08000US540339097510180030800,"Census Tract 308 (part), Bridgeport city (part), Eastern district, Harrison County, West Virginia",0,0,0,0,0,0,0,0,0,0,0,0,0,0,0,0,0,0,0,0
ACSSF,2010e5,wv,000,0034,0001479,080,54,033,08000US540339097510180031100,"Census Tract 311 (part), Bridgeport city (part), Eastern district, Harrison County, West Virginia",63,57,17,0,0,17,40,6,0,0,0,0,0,0,6,0,0,0,0,6
ACSSF,2010e5,wv,000,0034,0001480,080,54,033,08000US540339097510180032000,"Census Tract 320 (part), Bridgeport city (part), Eastern district, Harrison County, West Virginia",0,0,0,0,0,0,0,0,0,0,0,0,0,0,0,0,0,0,0,0
ACSSF,2010e5,wv,000,0034,0001481,080,54,033,08000US540339097510180032101,"Census Tract 321.01 (part), Bridgeport city (part), Eastern district, Harrison County, West Virginia",251,204,100,6,38,56,104,47,17,17,0,0,17,0,30,22,0,22,0,8
ACSSF,2010e5,wv,000,0034,0001482,080,54,033,08000US540339097510180032102,"Census Tract 321.02 (part), Bridgeport city (part), Eastern district, Harrison County, West Virginia",1840,1502,491,89,93,309,1011,338,120,74,17,0,57,46,218,89,0,0,89,129
ACSSF,2010e5,wv,000,0034,0001483,080,54,033,08000US540339097515628030300,"Census Tract 303 (part), Clarksburg city (part), Eastern district, Harrison County, West Virginia",0,0,0,0,0,0,0,0,0,0,0,0,0,0,0,0,0,0,0,0
ACSSF,2010e5,wv,000,0034,0001484,080,54,033,08000US540339097515628030400,"Census Tract 304 (part), Clarksburg city (part), Eastern district, Harrison County, West Virginia",0,0,0,0,0,0,0,0,0,0,0,0,0,0,0,0,0,0,0,0
ACSSF,2010e5,wv,000,0034,0001485,080,54,033,08000US540339097515628030800,"Census Tract 308 (part), Clarksburg city (part), Eastern district, Harrison County, West Virginia",6,0,0,0,0,0,0,6,6,0,0,0,0,6,0,0,0,0,0,0
ACSSF,2010e5,wv,000,0034,0001486,080,54,033,08000US540339097515628031000,"Census Tract 310 (part), Clarksburg city (part), Eastern district, Harrison County, West Virginia",0,0,0,0,0,0,0,0,0,0,0,0,0,0,0,0,0,0,0,0
ACSSF,2010e5,wv,000,0034,0001487,080,54,033,08000US540339097515628031100,"Census Tract 311 (part), Clarksburg city (part), Eastern district, Harrison County, West Virginia",0,0,0,0,0,0,0,0,0,0,0,0,0,0,0,0,0,0,0,0
ACSSF,2010e5,wv,000,0034,0001488,080,54,033,08000US540339097515628032000,"Census Tract 320 (part), Clarksburg city (part), Eastern district, Harrison County, West Virginia",0,0,0,0,0,0,0,0,0,0,0,0,0,0,0,0,0,0,0,0
ACSSF,2010e5,wv,000,0034,0001489,080,54,033,08000US540339097521316030300,"Census Tract 303 (part), Despard CDP (part), Eastern district, Harrison County, West Virginia",198,110,39,0,27,12,71,88,0,0,0,0,0,0,88,46,0,0,46,42
ACSSF,2010e5,wv,000,0034,0001490,080,54,033,08000US540339097536628030800,"Census Tract 308 (part), Hepzibah CDP, Eastern district, Harrison County, West Virginia",192,179,49,0,21,28,130,13,13,13,13,0,0,0,0,0,0,0,0,0
ACSSF,2010e5,wv,000,0034,0001491,080,54,033,08000US540339097575796030800,"Census Tract 308 (part), Spelter CDP, Eastern district, Harrison County, West Virginia",88,61,30,21,0,9,31,27,0,0,0,0,0,0,27,0,0,0,0,27
ACSSF,2010e5,wv,000,0034,0001492,080,54,033,08000US540339097599999030300,"Census Tract 303 (part), Remainder of Eastern district, Eastern district, Harrison County, West Virginia",0,0,0,0,0,0,0,0,0,0,0,0,0,0,0,0,0,0,0,0
ACSSF,2010e5,wv,000,0034,0001493,080,54,033,08000US540339097599999030800,"Census Tract 308 (part), Remainder of Eastern district, Eastern district, Harrison County, West Virginia",139,67,30,0,14,16,37,72,20,11,0,0,11,9,52,37,0,7,30,15
ACSSF,2010e5,wv,000,0034,0001494,080,54,033,08000US540339097599999031000,"Census Tract 310 (part), Remainder of Eastern district, Eastern district, Harrison County, West Virginia",0,0,0,0,0,0,0,0,0,0,0,0,0,0,0,0,0,0,0,0
ACSSF,2010e5,wv,000,0034,0001495,080,54,033,08000US540339097599999031100,"Census Tract 311 (part), Remainder of Eastern district, Eastern district, Harrison County, West Virginia",12,0,0,0,0,0,0,12,0,0,0,0,0,0,12,0,0,0,0,12
ACSSF,2010e5,wv,000,0034,0001496,080,54,033,08000US540339097599999032000,"Census Tract 320 (part), Remainder of Eastern district, Eastern district, Harrison County, West Virginia",51,33,11,0,0,11,22,18,0,0,0,0,0,0,18,0,0,0,0,18
ACSSF,2010e5,wv,000,0034,0001497,080,54,033,08000US540339097599999032101,"Census Tract 321.01 (part), Remainder of Eastern district, Eastern district, Harrison County, West Virginia",617,475,207,44,21,142,268,142,0,0,0,0,0,0,142,64,0,0,64,78
ACSSF,2010e5,wv,000,0034,0001498,080,54,033,08000US540339097599999032102,"Census Tract 321.02 (part), Remainder of Eastern district, Eastern district, Harrison County, West Virginia",18,0,0,0,0,0,0,18,0,0,0,0,0,0,18,18,0,0,18,0
ACSSF,2010e5,wv,000,0034,0001499,080,54,033,08000US540339235210180032000,"Census Tract 320 (part), Bridgeport city (part), Northern district, Harrison County, West Virginia",20,20,0,0,0,0,20,0,0,0,0,0,0,0,0,0,0,0,0,0
ACSSF,2010e5,wv,000,0034,0001500,080,54,033,08000US540339235225516031800,"Census Tract 318 (part), Enterprise CDP, Northern district, Harrison County, West Virginia",343,222,54,0,20,34,168,121,24,0,0,0,0,24,97,19,19,0,0,78
ACSSF,2010e5,wv,000,0034,0001501,080,54,033,08000US540339235234180032000,"Census Tract 320 (part), Gypsy CDP, Northern district, Harrison County, West Virginia",18,0,0,0,0,0,0,18,0,0,0,0,0,0,18,0,0,0,0,18
ACSSF,2010e5,wv,000,0034,0001502,080,54,033,08000US540339235249252030800,"Census Tract 308 (part), Lumberport town (part), Northern district, Harrison County, West Virginia",259,193,62,16,0,46,131,66,14,10,0,5,5,4,52,17,0,4,13,35
ACSSF,2010e5,wv,000,0034,0001503,080,54,033,08000US540339235273636031900,"Census Tract 319 (part), Shinnston city, Northern district, Harrison County, West Virginia",682,523,172,9,56,107,351,159,24,11,0,0,11,13,135,27,17,10,0,108
ACSSF,2010e5,wv,000,0034,0001504,080,54,033,08000US540339235273636032000,"Census Tract 320 (part), Shinnston city, Northern district, Harrison County, West Virginia",0,0,0,0,0,0,0,0,0,0,0,0,0,0,0,0,0,0,0,0
ACSSF,2010e5,wv,000,0034,0001505,080,54,033,08000US540339235299999030800,"Census Tract 308 (part), Remainder of Northern district, Northern district, Harrison County, West Virginia",341,262,66,0,15,51,196,79,32,0,0,0,0,32,47,26,0,0,26,21
ACSSF,2010e5,wv,000,0034,0001506,080,54,033,08000US540339235299999031500,"Census Tract 315 (part), Remainder of Northern district, Northern district, Harrison County, West Virginia",0,0,0,0,0,0,0,0,0,0,0,0,0,0,0,0,0,0,0,0
ACSSF,2010e5,wv,000,0034,0001507,080,54,033,08000US540339235299999031700,"Census Tract 317 (part), Remainder of Northern district, Northern district, Harrison County, West Virginia",507,448,202,35,31,136,246,59,14,0,0,0,0,14,45,18,0,0,18,27
ACSSF,2010e5,wv,000,0034,0001508,080,54,033,08000US540339235299999031800,"Census Tract 318 (part), Remainder of Northern district, Northern district, Harrison County, West Virginia",447,387,107,37,33,37,280,60,36,12,0,0,12,24,24,14,0,0,14,10
ACSSF,2010e5,wv,000,0034,0001509,080,54,033,08000US540339235299999031900,"Census Tract 319 (part), Remainder of Northern district, Northern district, Harrison County, West Virginia",0,0,0,0,0,0,0,0,0,0,0,0,0,0,0,0,0,0,0,0
ACSSF,2010e5,wv,000,0034,0001510,080,54,033,08000US540339235299999032000,"Census Tract 320 (part), Remainder of Northern district, Northern district, Harrison County, West Virginia",529,398,120,24,14,82,278,131,29,29,0,0,29,0,102,94,36,8,50,8
ACSSF,2010e5,wv,000,0034,0001511,080,54,033,08000US540339235299999032101,"Census Tract 321.01 (part), Remainder of Northern district, Northern district, Harrison County, West Virginia",14,14,14,14,0,0,0,0,0,0,0,0,0,0,0,0,0,0,0,0
ACSSF,2010e5,wv,000,0034,0001512,080,54,033,08000US540339236815628030100,"Census Tract 301 (part), Clarksburg city (part), North Urban district, Harrison County, West Virginia",354,195,53,44,0,9,142,159,0,0,0,0,0,0,159,72,0,17,55,87
ACSSF,2010e5,wv,000,0034,0001513,080,54,033,08000US540339236815628030200,"Census Tract 302 (part), Clarksburg city (part), North Urban district, Harrison County, West Virginia",665,411,132,16,44,72,279,254,44,28,12,0,16,16,210,117,11,31,75,93
ACSSF,2010e5,wv,000,0034,0001514,080,54,033,08000US540339236815628030300,"Census Tract 303 (part), Clarksburg city (part), North Urban district, Harrison County, West Virginia",282,165,127,25,19,83,38,117,8,8,0,0,8,0,109,65,9,35,21,44
ACSSF,2010e5,wv,000,0034,0001515,080,54,033,08000US540339236815628030400,"Census Tract 304 (part), Clarksburg city (part), North Urban district, Harrison County, West Virginia",66,47,19,0,0,19,28,19,9,0,0,0,0,9,10,0,0,0,0,10
ACSSF,2010e5,wv,000,0034,0001516,080,54,033,08000US540339236815628030601,"Census Tract 306.01 (part), Clarksburg city (part), North Urban district, Harrison County, West Virginia",350,270,53,30,0,23,217,80,23,0,0,0,0,23,57,46,46,0,0,11
ACSSF,2010e5,wv,000,0034,0001517,080,54,033,08000US540339236815628030800,"Census Tract 308 (part), Clarksburg city (part), North Urban district, Harrison County, West Virginia",41,28,8,0,0,8,20,13,0,0,0,0,0,0,13,0,0,0,0,13
ACSSF,2010e5,wv,000,0034,0001518,080,54,033,08000US540339236815628031000,"Census Tract 310 (part), Clarksburg city (part), North Urban district, Harrison County, West Virginia",0,0,0,0,0,0,0,0,0,0,0,0,0,0,0,0,0,0,0,0
ACSSF,2010e5,wv,000,0034,0001519,080,54,033,08000US540339236821316030300,"Census Tract 303 (part), Despard CDP (part), North Urban district, Harrison County, West Virginia",18,10,0,0,0,0,10,8,0,0,0,0,0,0,8,0,0,0,0,8
ACSSF,2010e5,wv,000,0034,0001520,080,54,033,08000US540339236849252030800,"Census Tract 308 (part), Lumberport town (part), North Urban district, Harrison County, West Virginia",59,7,3,3,0,0,4,52,15,15,15,0,0,0,37,36,4,0,32,1
ACSSF,2010e5,wv,000,0034,0001521,080,54,033,08000US540339236899999030200,"Census Tract 302 (part), Remainder of North Urban district, North Urban district, Harrison County, West Virginia",47,47,9,0,0,9,38,0,0,0,0,0,0,0,0,0,0,0,0,0
ACSSF,2010e5,wv,000,0034,0001522,080,54,033,08000US540339236899999030300,"Census Tract 303 (part), Remainder of North Urban district, North Urban district, Harrison County, West Virginia",39,0,0,0,0,0,0,39,0,0,0,0,0,0,39,39,0,26,13,0
ACSSF,2010e5,wv,000,0034,0001523,080,54,033,08000US540339236899999030601,"Census Tract 306.01 (part), Remainder of North Urban district, North Urban district, Harrison County, West Virginia",229,157,36,18,0,18,121,72,59,0,0,0,0,59,13,0,0,0,0,13
ACSSF,2010e5,wv,000,0034,0001524,080,54,033,08000US540339236899999030602,"Census Tract 306.02 (part), Remainder of North Urban district, North Urban district, Harrison County, West Virginia",0,0,0,0,0,0,0,0,0,0,0,0,0,0,0,0,0,0,0,0
ACSSF,2010e5,wv,000,0034,0001525,080,54,033,08000US540339236899999030700,"Census Tract 307 (part), Remainder of North Urban district, North Urban district, Harrison County, West Virginia",151,115,62,18,20,24,53,36,23,0,0,0,0,23,13,13,0,13,0,0
ACSSF,2010e5,wv,000,0034,0001526,080,54,033,08000US540339236899999030800,"Census Tract 308 (part), Remainder of North Urban district, North Urban district, Harrison County, West Virginia",319,191,95,0,56,39,96,128,14,0,0,0,0,14,114,83,35,14,34,31
ACSSF,2010e5,wv,000,0034,0001527,080,54,033,08000US540339236899999031000,"Census Tract 310 (part), Remainder of North Urban district, North Urban district, Harrison County, West Virginia",0,0,0,0,0,0,0,0,0,0,0,0,0,0,0,0,0,0,0,0
ACSSF,2010e5,wv,000,0034,0001528,080,54,033,08000US540339236899999031500,"Census Tract 315 (part), Remainder of North Urban district, North Urban district, Harrison County, West Virginia",15,15,15,15,0,0,0,0,0,0,0,0,0,0,0,0,0,0,0,0
ACSSF,2010e5,wv,000,0034,0001529,080,54,033,08000US540339236899999031700,"Census Tract 317 (part), Remainder of North Urban district, North Urban district, Harrison County, West Virginia",171,145,0,0,0,0,145,26,11,0,0,0,0,11,15,0,0,0,0,15
ACSSF,2010e5,wv,000,0034,0001530,080,54,033,08000US540339292301900031000,"Census Tract 310 (part), Anmoore town (part), Southern district, Harrison County, West Virginia",0,0,0,0,0,0,0,0,0,0,0,0,0,0,0,0,0,0,0,0
ACSSF,2010e5,wv,000,0034,0001531,080,54,033,08000US540339292301900031100,"Census Tract 311 (part), Anmoore town (part), Southern district, Harrison County, West Virginia",270,140,82,55,6,21,58,130,29,19,0,0,19,10,101,87,0,0,87,14
ACSSF,2010e5,wv,000,0034,0001532,080,54,033,08000US540339292310180031100,"Census Tract 311 (part), Bridgeport city (part), Southern district, Harrison County, West Virginia",12,12,12,0,0,12,0,0,0,0,0,0,0,0,0,0,0,0,0,0
ACSSF,2010e5,wv,000,0034,0001533,080,54,033,08000US540339292310180032101,"Census Tract 321.01 (part), Bridgeport city (part), Southern district, Harrison County, West Virginia",120,105,42,0,30,12,63,15,0,0,0,0,0,0,15,0,0,0,0,15
ACSSF,2010e5,wv,000,0034,0001534,080,54,033,08000US540339292315628030400,"Census Tract 304 (part), Clarksburg city (part), Southern district, Harrison County, West Virginia",0,0,0,0,0,0,0,0,0,0,0,0,0,0,0,0,0,0,0,0
ACSSF,2010e5,wv,000,0034,0001535,080,54,033,08000US540339292315628030500,"Census Tract 305 (part), Clarksburg city (part), Southern district, Harrison County, West Virginia",94,94,30,30,0,0,64,0,0,0,0,0,0,0,0,0,0,0,0,0
ACSSF,2010e5,wv,000,0034,0001536,080,54,033,08000US540339292315628031000,"Census Tract 310 (part), Clarksburg city (part), Southern district, Harrison County, West Virginia",229,67,0,0,0,0,67,162,62,24,0,0,24,38,100,81,27,0,54,19
ACSSF,2010e5,wv,000,0034,0001537,080,54,033,08000US540339292315628031100,"Census Tract 311 (part), Clarksburg city (part), Southern district, Harrison County, West Virginia",0,0,0,0,0,0,0,0,0,0,0,0,0,0,0,0,0,0,0,0
ACSSF,2010e5,wv,000,0034,0001538,080,54,033,08000US540339292348748031300,"Census Tract 313 (part), Lost Creek town, Southern district, Harrison County, West Virginia",133,76,27,0,6,21,49,57,4,4,4,0,0,0,53,29,4,7,18,24
ACSSF,2010e5,wv,000,0034,0001539,080,54,033,08000US540339292359836030400,"Census Tract 304 (part), Nutter Fort town, Southern district, Harrison County, West Virginia",0,0,0,0,0,0,0,0,0,0,0,0,0,0,0,0,0,0,0,0
ACSSF,2010e5,wv,000,0034,0001540,080,54,033,08000US540339292359836030500,"Census Tract 305 (part), Nutter Fort town, Southern district, Harrison County, West Virginia",455,357,93,17,0,76,264,98,26,19,0,0,19,7,72,26,0,0,26,46
ACSSF,2010e5,wv,000,0034,0001541,080,54,033,08000US540339292377188031000,"Census Tract 310 (part), Stonewood city, Southern district, Harrison County, West Virginia",596,432,121,24,37,60,311,164,13,0,0,0,0,13,151,66,8,0,58,85
ACSSF,2010e5,wv,000,0034,0001542,080,54,033,08000US540339292377188031100,"Census Tract 311 (part), Stonewood city, Southern district, Harrison County, West Virginia",0,0,0,0,0,0,0,0,0,0,0,0,0,0,0,0,0,0,0,0
ACSSF,2010e5,wv,000,0034,0001543,080,54,033,08000US540339292399999030500,"Census Tract 305 (part), Remainder of Southern district, Southern district, Harrison County, West Virginia",302,283,97,0,16,81,186,19,19,19,0,0,19,0,0,0,0,0,0,0
ACSSF,2010e5,wv,000,0034,0001544,080,54,033,08000US540339292399999031000,"Census Tract 310 (part), Remainder of Southern district, Southern district, Harrison County, West Virginia",244,129,30,30,0,0,99,115,14,0,0,0,0,14,101,86,16,0,70,15
ACSSF,2010e5,wv,000,0034,0001545,080,54,033,08000US540339292399999031100,"Census Tract 311 (part), Remainder of Southern district, Southern district, Harrison County, West Virginia",275,232,70,17,12,41,162,43,0,0,0,0,0,0,43,27,14,0,13,16
ACSSF,2010e5,wv,000,0034,0001546,080,54,033,08000US540339292399999031200,"Census Tract 312, Remainder of Southern district, Southern district, Harrison County, West Virginia",836,775,314,56,11,247,461,61,23,0,0,0,0,23,38,12,12,0,0,26
ACSSF,2010e5,wv,000,0034,0001547,080,54,033,08000US540339292399999031300,"Census Tract 313 (part), Remainder of Southern district, Southern district, Harrison County, West Virginia",305,252,99,10,24,65,153,53,31,0,0,0,0,31,22,4,4,0,0,18
ACSSF,2010e5,wv,000,0034,0001548,080,54,033,08000US540339292399999032101,"Census Tract 321.01 (part), Remainder of Southern district, Southern district, Harrison County, West Virginia",0,0,0,0,0,0,0,0,0,0,0,0,0,0,0,0,0,0,0,0
ACSSF,2010e5,wv,000,0034,0001549,080,54,033,08000US540339293215628030100,"Census Tract 301 (part), Clarksburg city (part), South Urban district, Harrison County, West Virginia",404,319,95,23,31,41,224,85,19,0,0,0,0,19,66,66,16,0,50,0
ACSSF,2010e5,wv,000,0034,0001550,080,54,033,08000US540339293215628030400,"Census Tract 304 (part), Clarksburg city (part), South Urban district, Harrison County, West Virginia",641,446,233,65,40,128,213,195,66,52,0,0,52,14,129,27,22,5,0,102
ACSSF,2010e5,wv,000,0034,0001551,080,54,033,08000US540339293215628030500,"Census Tract 305 (part), Clarksburg city (part), South Urban district, Harrison County, West Virginia",72,27,0,0,0,0,27,45,0,0,0,0,0,0,45,0,0,0,0,45
ACSSF,2010e5,wv,000,0034,0001552,080,54,033,08000US540339293215628030601,"Census Tract 306.01 (part), Clarksburg city (part), South Urban district, Harrison County, West Virginia",33,33,10,10,0,0,23,0,0,0,0,0,0,0,0,0,0,0,0,0
ACSSF,2010e5,wv,000,0034,0001553,080,54,033,08000US540339293215628030602,"Census Tract 306.02 (part), Clarksburg city (part), South Urban district, Harrison County, West Virginia",920,684,296,24,25,247,388,236,46,46,0,15,31,0,190,92,67,9,16,98
ACSSF,2010e5,wv,000,0034,0001554,080,54,033,08000US540339293215628031000,"Census Tract 310 (part), Clarksburg city (part), South Urban district, Harrison County, West Virginia",0,0,0,0,0,0,0,0,0,0,0,0,0,0,0,0,0,0,0,0
ACSSF,2010e5,wv,000,0034,0001555,080,54,033,08000US540339293299999030100,"Census Tract 301 (part), Remainder of South Urban district, South Urban district, Harrison County, West Virginia",0,0,0,0,0,0,0,0,0,0,0,0,0,0,0,0,0,0,0,0
ACSSF,2010e5,wv,000,0034,0001556,080,54,033,08000US540339293299999030400,"Census Tract 304 (part), Remainder of South Urban district, South Urban district, Harrison County, West Virginia",0,0,0,0,0,0,0,0,0,0,0,0,0,0,0,0,0,0,0,0
ACSSF,2010e5,wv,000,0034,0001557,080,54,033,08000US540339293299999030500,"Census Tract 305 (part), Remainder of South Urban district, South Urban district, Harrison County, West Virginia",185,173,60,0,0,60,113,12,0,0,0,0,0,0,12,0,0,0,0,12
ACSSF,2010e5,wv,000,0034,0001558,080,54,033,08000US540339293299999030601,"Census Tract 306.01 (part), Remainder of South Urban district, South Urban district, Harrison County, West Virginia",0,0,0,0,0,0,0,0,0,0,0,0,0,0,0,0,0,0,0,0
ACSSF,2010e5,wv,000,0034,0001559,080,54,033,08000US540339293299999030602,"Census Tract 306.02 (part), Remainder of South Urban district, South Urban district, Harrison County, West Virginia",518,338,141,17,19,105,197,180,0,0,0,0,0,0,180,83,18,0,65,97
ACSSF,2010e5,wv,000,0034,0001560,080,54,033,08000US540339293299999030700,"Census Tract 307 (part), Remainder of South Urban district, South Urban district, Harrison County, West Virginia",131,122,46,8,38,0,76,9,0,0,0,0,0,0,9,0,0,0,0,9
ACSSF,2010e5,wv,000,0034,0001561,080,54,033,08000US540339295271380031600,"Census Tract 316 (part), Salem city, Southwest district, Harrison County, West Virginia",389,269,77,22,7,48,192,120,27,11,7,0,4,16,93,72,18,5,49,21
ACSSF,2010e5,wv,000,0034,0001562,080,54,033,08000US540339295285924031400,"Census Tract 314 (part), West Milford town, Southwest district, Harrison County, West Virginia",323,229,87,7,6,74,142,94,16,5,0,0,5,11,78,49,15,0,34,29
ACSSF,2010e5,wv,000,0034,0001563,080,54,033,08000US540339295288276030700,"Census Tract 307 (part), Wolf Summit CDP, Southwest district, Harrison County, West Virginia",67,67,16,0,16,0,51,0,0,0,0,0,0,0,0,0,0,0,0,0
ACSSF,2010e5,wv,000,0034,0001564,080,54,033,08000US540339295299999030500,"Census Tract 305 (part), Remainder of Southwest district, Southwest district, Harrison County, West Virginia",287,228,96,20,16,60,132,59,0,0,0,0,0,0,59,59,50,0,9,0
ACSSF,2010e5,wv,000,0034,0001565,080,54,033,08000US540339295299999030602,"Census Tract 306.02 (part), Remainder of Southwest district, Southwest district, Harrison County, West Virginia",33,33,0,0,0,0,33,0,0,0,0,0,0,0,0,0,0,0,0,0
ACSSF,2010e5,wv,000,0034,0001566,080,54,033,08000US540339295299999030700,"Census Tract 307 (part), Remainder of Southwest district, Southwest district, Harrison County, West Virginia",271,200,76,12,14,50,124,71,12,0,0,0,0,12,59,14,14,0,0,45
ACSSF,2010e5,wv,000,0034,0001567,080,54,033,08000US540339295299999031300,"Census Tract 313 (part), Remainder of Southwest district, Southwest district, Harrison County, West Virginia",325,271,105,41,6,58,166,54,29,11,0,0,11,18,25,13,0,0,13,12
ACSSF,2010e5,wv,000,0034,0001568,080,54,033,08000US540339295299999031400,"Census Tract 314 (part), Remainder of Southwest district, Southwest district, Harrison County, West Virginia",484,428,134,11,4,119,294,56,15,15,0,0,15,0,41,9,0,0,9,32
ACSSF,2010e5,wv,000,0034,0001569,080,54,033,08000US540339295299999031500,"Census Tract 315 (part), Remainder of Southwest district, Southwest district, Harrison County, West Virginia",317,306,73,0,31,42,233,11,0,0,0,0,0,0,11,0,0,0,0,11
ACSSF,2010e5,wv,000,0034,0001570,080,54,033,08000US540339295299999031600,"Census Tract 316 (part), Remainder of Southwest district, Southwest district, Harrison County, West Virginia",224,164,111,0,13,98,53,60,0,0,0,0,0,0,60,47,0,0,47,13
ACSSF,2010e5,wv,000,0034,0001571,080,54,035,08000US540359097668596963500,"Census Tract 9635 (part), Ripley city (part), Eastern district, Jackson County, West Virginia",0,0,0,0,0,0,0,0,0,0,0,0,0,0,0,0,0,0,0,0
ACSSF,2010e5,wv,000,0034,0001572,080,54,035,08000US540359097668596963600,"Census Tract 9636 (part), Ripley city (part), Eastern district, Jackson County, West Virginia",730,646,260,118,34,108,386,84,17,17,17,0,0,0,67,37,11,0,26,30
ACSSF,2010e5,wv,000,0034,0001573,080,54,035,08000US540359097699999963600,"Census Tract 9636 (part), Remainder of Eastern district, Eastern district, Jackson County, West Virginia",52,38,0,0,0,0,38,14,0,0,0,0,0,0,14,0,0,0,0,14
ACSSF,2010e5,wv,000,0034,0001574,080,54,035,08000US540359097699999963700,"Census Tract 9637 (part), Remainder of Eastern district, Eastern district, Jackson County, West Virginia",1985,1555,680,106,120,454,875,430,185,120,49,36,35,65,245,139,35,24,80,106
ACSSF,2010e5,wv,000,0034,0001575,080,54,035,08000US540359235367108963300,"Census Tract 9633 (part), Ravenswood city, Northern district, Jackson County, West Virginia",1033,769,251,47,65,139,518,264,59,34,17,0,17,25,205,157,22,0,135,48
ACSSF,2010e5,wv,000,0034,0001576,080,54,035,08000US540359235399999963200,"Census Tract 9632 (part), Remainder of Northern district, Northern district, Jackson County, West Virginia",1307,1144,376,60,82,234,768,163,68,35,12,0,23,33,95,65,42,0,23,30
ACSSF,2010e5,wv,000,0034,0001577,080,54,035,08000US540359235399999963300,"Census Tract 9633 (part), Remainder of Northern district, Northern district, Jackson County, West Virginia",225,154,14,0,14,0,140,71,24,24,24,0,0,0,47,47,0,0,47,0
ACSSF,2010e5,wv,000,0034,0001578,080,54,035,08000US540359235399999963400,"Census Tract 9634 (part), Remainder of Northern district, Northern district, Jackson County, West Virginia",0,0,0,0,0,0,0,0,0,0,0,0,0,0,0,0,0,0,0,0
ACSSF,2010e5,wv,000,0034,0001579,080,54,035,08000US540359360568596963500,"Census Tract 9635 (part), Ripley city (part), Western district, Jackson County, West Virginia",30,30,0,0,0,0,30,0,0,0,0,0,0,0,0,0,0,0,0,0
ACSSF,2010e5,wv,000,0034,0001580,080,54,035,08000US540359360568596963600,"Census Tract 9636 (part), Ripley city (part), Western district, Jackson County, West Virginia",73,15,0,0,0,0,15,58,42,42,0,0,42,0,16,0,0,0,0,16
ACSSF,2010e5,wv,000,0034,0001581,080,54,035,08000US540359360599999963200,"Census Tract 9632 (part), Remainder of Western district, Western district, Jackson County, West Virginia",136,76,15,0,0,15,61,60,0,0,0,0,0,0,60,35,0,0,35,25
ACSSF,2010e5,wv,000,0034,0001582,080,54,035,08000US540359360599999963400,"Census Tract 9634 (part), Remainder of Western district, Western district, Jackson County, West Virginia",1172,885,298,44,83,171,587,287,37,21,0,0,21,16,250,63,0,14,49,187
ACSSF,2010e5,wv,000,0034,0001583,080,54,035,08000US540359360599999963500,"Census Tract 9635 (part), Remainder of Western district, Western district, Jackson County, West Virginia",830,663,164,57,26,81,499,167,79,66,0,0,66,13,88,33,0,0,33,55
ACSSF,2010e5,wv,000,0034,0001584,080,54,035,08000US540359360599999963600,"Census Tract 9636 (part), Remainder of Western district, Western district, Jackson County, West Virginia",269,244,90,41,38,11,154,25,0,0,0,0,0,0,25,11,0,0,11,14
ACSSF,2010e5,wv,000,0034,0001585,080,54,035,08000US540359360599999963700,"Census Tract 9637 (part), Remainder of Western district, Western district, Jackson County, West Virginia",572,503,298,69,73,156,205,69,34,34,0,0,34,0,35,26,0,12,14,9
ACSSF,2010e5,wv,000,0034,0001586,080,54,037,08000US540379050414610972401,"Census Tract 9724.01 (part), Charles Town city (part), Charles Town district, Jefferson County, West Virginia",26,0,0,0,0,0,0,26,0,0,0,0,0,0,26,0,0,0,0,26
ACSSF,2010e5,wv,000,0034,0001587,080,54,037,08000US540379050414610972501,"Census Tract 9725.01 (part), Charles Town city (part), Charles Town district, Jefferson County, West Virginia",54,23,23,0,0,23,0,31,31,31,0,0,31,0,0,0,0,0,0,0
ACSSF,2010e5,wv,000,0034,0001588,080,54,037,08000US540379050414610972503,"Census Tract 9725.03 (part), Charles Town city (part), Charles Town district, Jefferson County, West Virginia",0,0,0,0,0,0,0,0,0,0,0,0,0,0,0,0,0,0,0,0
ACSSF,2010e5,wv,000,0034,0001589,080,54,037,08000US540379050414610972505,"Census Tract 9725.05 (part), Charles Town city (part), Charles Town district, Jefferson County, West Virginia",622,542,276,63,74,139,266,80,0,0,0,0,0,0,80,0,0,0,0,80
ACSSF,2010e5,wv,000,0034,0001590,080,54,037,08000US540379050414610972506,"Census Tract 9725.06 (part), Charles Town city (part), Charles Town district, Jefferson County, West Virginia",280,244,154,98,26,30,90,36,36,9,0,0,9,27,0,0,0,0,0,0
ACSSF,2010e5,wv,000,0034,0001591,080,54,037,08000US540379050466988972401,"Census Tract 9724.01 (part), Ranson corporation (part), Charles Town district, Jefferson County, West Virginia",761,413,185,57,86,42,228,348,112,16,16,0,0,96,236,146,19,17,110,90
ACSSF,2010e5,wv,000,0034,0001592,080,54,037,08000US540379050466988972402,"Census Tract 9724.02 (part), Ranson corporation (part), Charles Town district, Jefferson County, West Virginia",225,126,29,0,0,29,97,99,0,0,0,0,0,0,99,66,46,20,0,33
ACSSF,2010e5,wv,000,0034,0001593,080,54,037,08000US540379050466988972503,"Census Tract 9725.03 (part), Ranson corporation (part), Charles Town district, Jefferson County, West Virginia",31,31,31,10,4,17,0,0,0,0,0,0,0,0,0,0,0,0,0,0
ACSSF,2010e5,wv,000,0034,0001594,080,54,037,08000US540379050466988972505,"Census Tract 9725.05 (part), Ranson corporation (part), Charles Town district, Jefferson County, West Virginia",0,0,0,0,0,0,0,0,0,0,0,0,0,0,0,0,0,0,0,0
ACSSF,2010e5,wv,000,0034,0001595,080,54,037,08000US540379050499999972401,"Census Tract 9724.01 (part), Remainder of Charles Town district, Charles Town district, Jefferson County, West Virginia",0,0,0,0,0,0,0,0,0,0,0,0,0,0,0,0,0,0,0,0
ACSSF,2010e5,wv,000,0034,0001596,080,54,037,08000US540379050499999972402,"Census Tract 9724.02 (part), Remainder of Charles Town district, Charles Town district, Jefferson County, West Virginia",0,0,0,0,0,0,0,0,0,0,0,0,0,0,0,0,0,0,0,0
ACSSF,2010e5,wv,000,0034,0001597,080,54,037,08000US540379050499999972501,"Census Tract 9725.01 (part), Remainder of Charles Town district, Charles Town district, Jefferson County, West Virginia",0,0,0,0,0,0,0,0,0,0,0,0,0,0,0,0,0,0,0,0
ACSSF,2010e5,wv,000,0034,0001598,080,54,037,08000US540379050499999972503,"Census Tract 9725.03 (part), Remainder of Charles Town district, Charles Town district, Jefferson County, West Virginia",490,407,224,34,36,154,183,83,59,29,6,0,23,30,24,10,0,0,10,14
ACSSF,2010e5,wv,000,0034,0001599,080,54,037,08000US540379050499999972505,"Census Tract 9725.05 (part), Remainder of Charles Town district, Charles Town district, Jefferson County, West Virginia",62,50,50,0,50,0,0,12,0,0,0,0,0,0,12,0,0,0,0,12
ACSSF,2010e5,wv,000,0034,0001600,080,54,037,08000US540379050499999972506,"Census Tract 9725.06 (part), Remainder of Charles Town district, Charles Town district, Jefferson County, West Virginia",319,210,69,17,18,34,141,109,32,32,0,0,32,0,77,66,12,0,54,11
ACSSF,2010e5,wv,000,0034,0001601,080,54,037,08000US540379154808932972601,"Census Tract 9726.01 (part), Bolivar town, Harpers Ferry district, Jefferson County, West Virginia",197,162,59,5,9,45,103,35,3,0,0,0,0,3,32,11,3,0,8,21
ACSSF,2010e5,wv,000,0034,0001602,080,54,037,08000US540379154808932972602,"Census Tract 9726.02 (part), Bolivar town, Harpers Ferry district, Jefferson County, West Virginia",0,0,0,0,0,0,0,0,0,0,0,0,0,0,0,0,0,0,0,0
ACSSF,2010e5,wv,000,0034,0001603,080,54,037,08000US540379154814610972503,"Census Tract 9725.03 (part), Charles Town city (part), Harpers Ferry district, Jefferson County, West Virginia",0,0,0,0,0,0,0,0,0,0,0,0,0,0,0,0,0,0,0,0
ACSSF,2010e5,wv,000,0034,0001604,080,54,037,08000US540379154814610972506,"Census Tract 9725.06 (part), Charles Town city (part), Harpers Ferry district, Jefferson County, West Virginia",0,0,0,0,0,0,0,0,0,0,0,0,0,0,0,0,0,0,0,0
ACSSF,2010e5,wv,000,0034,0001605,080,54,037,08000US540379154814610972601,"Census Tract 9726.01 (part), Charles Town city (part), Harpers Ferry district, Jefferson County, West Virginia",0,0,0,0,0,0,0,0,0,0,0,0,0,0,0,0,0,0,0,0
ACSSF,2010e5,wv,000,0034,0001606,080,54,037,08000US540379154835284972601,"Census Tract 9726.01 (part), Harpers Ferry town, Harpers Ferry district, Jefferson County, West Virginia",60,60,14,9,0,5,46,0,0,0,0,0,0,0,0,0,0,0,0,0
ACSSF,2010e5,wv,000,0034,0001607,080,54,037,08000US540379154835284972602,"Census Tract 9726.02 (part), Harpers Ferry town, Harpers Ferry district, Jefferson County, West Virginia",0,0,0,0,0,0,0,0,0,0,0,0,0,0,0,0,0,0,0,0
ACSSF,2010e5,wv,000,0034,0001608,080,54,037,08000US540379154835284972701,"Census Tract 9727.01 (part), Harpers Ferry town, Harpers Ferry district, Jefferson County, West Virginia",0,0,0,0,0,0,0,0,0,0,0,0,0,0,0,0,0,0,0,0
ACSSF,2010e5,wv,000,0034,0001609,080,54,037,08000US540379154866988972402,"Census Tract 9724.02 (part), Ranson corporation (part), Harpers Ferry district, Jefferson County, West Virginia",89,75,33,17,0,16,42,14,14,14,0,0,14,0,0,0,0,0,0,0
ACSSF,2010e5,wv,000,0034,0001610,080,54,037,08000US540379154873444972204,"Census Tract 9722.04 (part), Shenandoah Junction CDP (part), Harpers Ferry district, Jefferson County, West Virginia",151,95,37,26,0,11,58,56,16,0,0,0,0,16,40,40,0,10,30,0
ACSSF,2010e5,wv,000,0034,0001611,080,54,037,08000US540379154873444972402,"Census Tract 9724.02 (part), Shenandoah Junction CDP (part), Harpers Ferry district, Jefferson County, West Virginia",19,19,0,0,0,0,19,0,0,0,0,0,0,0,0,0,0,0,0,0
ACSSF,2010e5,wv,000,0034,0001612,080,54,037,08000US540379154899999972203,"Census Tract 9722.03 (part), Remainder of Harpers Ferry district, Harpers Ferry district, Jefferson County, West Virginia",0,0,0,0,0,0,0,0,0,0,0,0,0,0,0,0,0,0,0,0
ACSSF,2010e5,wv,000,0034,0001613,080,54,037,08000US540379154899999972402,"Census Tract 9724.02 (part), Remainder of Harpers Ferry district, Harpers Ferry district, Jefferson County, West Virginia",85,85,23,0,23,0,62,0,0,0,0,0,0,0,0,0,0,0,0,0
ACSSF,2010e5,wv,000,0034,0001614,080,54,037,08000US540379154899999972503,"Census Tract 9725.03 (part), Remainder of Harpers Ferry district, Harpers Ferry district, Jefferson County, West Virginia",86,86,52,11,0,41,34,0,0,0,0,0,0,0,0,0,0,0,0,0
ACSSF,2010e5,wv,000,0034,0001615,080,54,037,08000US540379154899999972506,"Census Tract 9725.06 (part), Remainder of Harpers Ferry district, Harpers Ferry district, Jefferson County, West Virginia",112,72,58,0,58,0,14,40,0,0,0,0,0,0,40,27,0,0,27,13
ACSSF,2010e5,wv,000,0034,0001616,080,54,037,08000US540379154899999972601,"Census Tract 9726.01 (part), Remainder of Harpers Ferry district, Harpers Ferry district, Jefferson County, West Virginia",207,175,34,0,12,22,141,32,0,0,0,0,0,0,32,0,0,0,0,32
ACSSF,2010e5,wv,000,0034,0001617,080,54,037,08000US540379154899999972602,"Census Tract 9726.02 (part), Remainder of Harpers Ferry district, Harpers Ferry district, Jefferson County, West Virginia",685,670,324,56,83,185,346,15,0,0,0,0,0,0,15,0,0,0,0,15
ACSSF,2010e5,wv,000,0034,0001618,080,54,037,08000US540379154899999972701,"Census Tract 9727.01 (part), Remainder of Harpers Ferry district, Harpers Ferry district, Jefferson County, West Virginia",854,734,242,108,32,102,492,120,55,0,0,0,0,55,65,50,0,0,50,15
ACSSF,2010e5,wv,000,0034,0001619,080,54,037,08000US540379174014610972501,"Census Tract 9725.01 (part), Charles Town city (part), Kabletown district, Jefferson County, West Virginia",144,106,82,28,15,39,24,38,17,0,0,0,0,17,21,0,0,0,0,21
ACSSF,2010e5,wv,000,0034,0001620,080,54,037,08000US540379174014610972800,"Census Tract 9728 (part), Charles Town city (part), Kabletown district, Jefferson County, West Virginia",16,16,16,0,0,16,0,0,0,0,0,0,0,0,0,0,0,0,0,0
ACSSF,2010e5,wv,000,0034,0001621,080,54,037,08000US540379174073252972702,"Census Tract 9727.02 (part), Shannondale CDP, Kabletown district, Jefferson County, West Virginia",697,646,311,77,33,201,335,51,17,17,0,17,0,0,34,34,0,0,34,0
ACSSF,2010e5,wv,000,0034,0001622,080,54,037,08000US540379174099999972501,"Census Tract 9725.01 (part), Remainder of Kabletown district, Kabletown district, Jefferson County, West Virginia",1293,980,412,117,37,258,568,313,149,101,101,0,0,48,164,95,30,9,56,69
ACSSF,2010e5,wv,000,0034,0001623,080,54,037,08000US540379174099999972506,"Census Tract 9725.06 (part), Remainder of Kabletown district, Kabletown district, Jefferson County, West Virginia",37,37,0,0,0,0,37,0,0,0,0,0,0,0,0,0,0,0,0,0
ACSSF,2010e5,wv,000,0034,0001624,080,54,037,08000US540379174099999972702,"Census Tract 9727.02 (part), Remainder of Kabletown district, Kabletown district, Jefferson County, West Virginia",170,136,19,8,11,0,117,34,0,0,0,0,0,0,34,34,10,0,24,0
ACSSF,2010e5,wv,000,0034,0001625,080,54,037,08000US540379174099999972800,"Census Tract 9728 (part), Remainder of Kabletown district, Kabletown district, Jefferson County, West Virginia",926,841,464,97,124,243,377,85,10,10,0,0,10,0,75,41,24,0,17,34
ACSSF,2010e5,wv,000,0034,0001626,080,54,037,08000US540379216014610972501,"Census Tract 9725.01 (part), Charles Town city (part), Middleway district, Jefferson County, West Virginia",0,0,0,0,0,0,0,0,0,0,0,0,0,0,0,0,0,0,0,0
ACSSF,2010e5,wv,000,0034,0001627,080,54,037,08000US540379216053692972800,"Census Tract 9728 (part), Middleway CDP, Middleway district, Jefferson County, West Virginia",51,40,9,0,0,9,31,11,0,0,0,0,0,0,11,0,0,0,0,11
ACSSF,2010e5,wv,000,0034,0001628,080,54,037,08000US540379216066988972300,"Census Tract 9723 (part), Ranson corporation (part), Middleway district, Jefferson County, West Virginia",0,0,0,0,0,0,0,0,0,0,0,0,0,0,0,0,0,0,0,0
ACSSF,2010e5,wv,000,0034,0001629,080,54,037,08000US540379216066988972401,"Census Tract 9724.01 (part), Ranson corporation (part), Middleway district, Jefferson County, West Virginia",0,0,0,0,0,0,0,0,0,0,0,0,0,0,0,0,0,0,0,0
ACSSF,2010e5,wv,000,0034,0001630,080,54,037,08000US540379216066988972402,"Census Tract 9724.02 (part), Ranson corporation (part), Middleway district, Jefferson County, West Virginia",14,0,0,0,0,0,0,14,0,0,0,0,0,0,14,14,0,14,0,0
ACSSF,2010e5,wv,000,0034,0001631,080,54,037,08000US540379216066988972501,"Census Tract 9725.01 (part), Ranson corporation (part), Middleway district, Jefferson County, West Virginia",0,0,0,0,0,0,0,0,0,0,0,0,0,0,0,0,0,0,0,0
ACSSF,2010e5,wv,000,0034,0001632,080,54,037,08000US540379216073444972204,"Census Tract 9722.04 (part), Shenandoah Junction CDP (part), Middleway district, Jefferson County, West Virginia",0,0,0,0,0,0,0,0,0,0,0,0,0,0,0,0,0,0,0,0
ACSSF,2010e5,wv,000,0034,0001633,080,54,037,08000US540379216073444972402,"Census Tract 9724.02 (part), Shenandoah Junction CDP (part), Middleway district, Jefferson County, West Virginia",0,0,0,0,0,0,0,0,0,0,0,0,0,0,0,0,0,0,0,0
ACSSF,2010e5,wv,000,0034,0001634,080,54,037,08000US540379216099999972204,"Census Tract 9722.04 (part), Remainder of Middleway district, Middleway district, Jefferson County, West Virginia",0,0,0,0,0,0,0,0,0,0,0,0,0,0,0,0,0,0,0,0
ACSSF,2010e5,wv,000,0034,0001635,080,54,037,08000US540379216099999972300,"Census Tract 9723 (part), Remainder of Middleway district, Middleway district, Jefferson County, West Virginia",1306,1008,526,150,43,333,482,298,107,23,0,0,23,84,191,60,0,0,60,131
ACSSF,2010e5,wv,000,0034,0001636,080,54,037,08000US540379216099999972401,"Census Tract 9724.01 (part), Remainder of Middleway district, Middleway district, Jefferson County, West Virginia",15,15,0,0,0,0,15,0,0,0,0,0,0,0,0,0,0,0,0,0
ACSSF,2010e5,wv,000,0034,0001637,080,54,037,08000US540379216099999972402,"Census Tract 9724.02 (part), Remainder of Middleway district, Middleway district, Jefferson County, West Virginia",568,395,51,0,15,36,344,173,45,45,0,0,45,0,128,83,34,28,21,45
ACSSF,2010e5,wv,000,0034,0001638,080,54,037,08000US540379216099999972501,"Census Tract 9725.01 (part), Remainder of Middleway district, Middleway district, Jefferson County, West Virginia",0,0,0,0,0,0,0,0,0,0,0,0,0,0,0,0,0,0,0,0
ACSSF,2010e5,wv,000,0034,0001639,080,54,037,08000US540379216099999972505,"Census Tract 9725.05 (part), Remainder of Middleway district, Middleway district, Jefferson County, West Virginia",0,0,0,0,0,0,0,0,0,0,0,0,0,0,0,0,0,0,0,0
ACSSF,2010e5,wv,000,0034,0001640,080,54,037,08000US540379216099999972800,"Census Tract 9728 (part), Remainder of Middleway district, Middleway district, Jefferson County, West Virginia",726,615,153,0,29,124,462,111,38,0,0,0,0,38,73,28,0,28,0,45
ACSSF,2010e5,wv,000,0034,0001641,080,54,037,08000US540379276073444972204,"Census Tract 9722.04 (part), Shenandoah Junction CDP (part), Shepherdstown district, Jefferson County, West Virginia",0,0,0,0,0,0,0,0,0,0,0,0,0,0,0,0,0,0,0,0
ACSSF,2010e5,wv,000,0034,0001642,080,54,037,08000US540379276073468972201,"Census Tract 9722.01 (part), Shepherdstown town, Shepherdstown district, Jefferson County, West Virginia",37,22,2,0,0,2,20,15,8,3,0,0,3,5,7,0,0,0,0,7
ACSSF,2010e5,wv,000,0034,0001643,080,54,037,08000US540379276073468972203,"Census Tract 9722.03 (part), Shepherdstown town, Shepherdstown district, Jefferson County, West Virginia",15,3,0,0,0,0,3,12,0,0,0,0,0,0,12,4,4,0,0,8
ACSSF,2010e5,wv,000,0034,0001644,080,54,037,08000US540379276073468972204,"Census Tract 9722.04 (part), Shepherdstown town, Shepherdstown district, Jefferson County, West Virginia",105,84,41,3,6,32,43,21,6,0,0,0,0,6,15,7,0,0,7,8
ACSSF,2010e5,wv,000,0034,0001645,080,54,037,08000US540379276099999972201,"Census Tract 9722.01 (part), Remainder of Shepherdstown district, Shepherdstown district, Jefferson County, West Virginia",854,813,263,89,101,73,550,41,41,24,24,0,0,17,0,0,0,0,0,0
ACSSF,2010e5,wv,000,0034,0001646,080,54,037,08000US540379276099999972203,"Census Tract 9722.03 (part), Remainder of Shepherdstown district, Shepherdstown district, Jefferson County, West Virginia",581,538,230,36,31,163,308,43,31,0,0,0,0,31,12,0,0,0,0,12
ACSSF,2010e5,wv,000,0034,0001647,080,54,037,08000US540379276099999972204,"Census Tract 9722.04 (part), Remainder of Shepherdstown district, Shepherdstown district, Jefferson County, West Virginia",269,233,102,0,71,31,131,36,23,0,0,0,0,23,13,13,0,0,13,0
ACSSF,2010e5,wv,000,0034,0001648,080,54,037,08000US540379276099999972602,"Census Tract 9726.02 (part), Remainder of Shepherdstown district, Shepherdstown district, Jefferson County, West Virginia",351,340,135,59,6,70,205,11,0,0,0,0,0,0,11,11,0,11,0,0
ACSSF,2010e5,wv,000,0034,0001649,080,54,039,08000US540399076805836011402,"Census Tract 114.02 (part), Belle town, District 1, Kanawha County, West Virginia",26,13,2,0,2,0,11,13,0,0,0,0,0,0,13,13,0,0,13,0
ACSSF,2010e5,wv,000,0034,0001650,080,54,039,08000US540399076805836011500,"Census Tract 115 (part), Belle town, District 1, Kanawha County, West Virginia",300,187,45,5,16,24,142,113,21,19,3,0,16,2,92,39,0,6,33,53
ACSSF,2010e5,wv,000,0034,0001651,080,54,039,08000US540399076805836012200,"Census Tract 122 (part), Belle town, District 1, Kanawha County, West Virginia",0,0,0,0,0,0,0,0,0,0,0,0,0,0,0,0,0,0,0,0
ACSSF,2010e5,wv,000,0034,0001652,080,54,039,08000US540399076813924011800,"Census Tract 118 (part), Cedar Grove town, District 1, Kanawha County, West Virginia",253,155,38,7,12,19,117,98,23,15,0,0,15,8,75,41,7,20,14,34
ACSSF,2010e5,wv,000,0034,0001653,080,54,039,08000US540399076814600000900,"Census Tract 9 (part), Charleston city (part), District 1, Kanawha County, West Virginia",123,73,4,0,0,4,69,50,9,0,0,0,0,9,41,41,34,0,7,0
ACSSF,2010e5,wv,000,0034,0001654,080,54,039,08000US540399076814600001100,"Census Tract 11 (part), Charleston city (part), District 1, Kanawha County, West Virginia",1250,989,390,43,0,347,599,261,28,8,0,0,8,20,233,124,101,0,23,109
ACSSF,2010e5,wv,000,0034,0001655,080,54,039,08000US540399076814600001200,"Census Tract 12, Charleston city (part), District 1, Kanawha County, West Virginia",247,95,39,26,0,13,56,152,79,0,0,0,0,79,73,67,18,0,49,6
ACSSF,2010e5,wv,000,0034,0001656,080,54,039,08000US540399076814600001300,"Census Tract 13 (part), Charleston city (part), District 1, Kanawha County, West Virginia",411,236,57,34,10,13,179,175,54,40,40,0,0,14,121,30,0,0,30,91
ACSSF,2010e5,wv,000,0034,0001657,080,54,039,08000US540399076814600001500,"Census Tract 15 (part), Charleston city (part), District 1, Kanawha County, West Virginia",859,765,359,124,74,161,406,94,0,0,0,0,0,0,94,21,0,0,21,73
ACSSF,2010e5,wv,000,0034,0001658,080,54,039,08000US540399076814600001700,"Census Tract 17 (part), Charleston city (part), District 1, Kanawha County, West Virginia",458,308,67,36,14,17,241,150,10,10,0,0,10,0,140,67,0,67,0,73
ACSSF,2010e5,wv,000,0034,0001659,080,54,039,08000US540399076814600001800,"Census Tract 18 (part), Charleston city (part), District 1, Kanawha County, West Virginia",285,221,72,8,30,34,149,64,9,0,0,0,0,9,55,18,0,0,18,37
ACSSF,2010e5,wv,000,0034,0001660,080,54,039,08000US540399076814600002000,"Census Tract 20 (part), Charleston city (part), District 1, Kanawha County, West Virginia",0,0,0,0,0,0,0,0,0,0,0,0,0,0,0,0,0,0,0,0
ACSSF,2010e5,wv,000,0034,0001661,080,54,039,08000US540399076814600011301,"Census Tract 113.01 (part), Charleston city (part), District 1, Kanawha County, West Virginia",0,0,0,0,0,0,0,0,0,0,0,0,0,0,0,0,0,0,0,0
ACSSF,2010e5,wv,000,0034,0001662,080,54,039,08000US540399076814600011401,"Census Tract 114.01 (part), Charleston city (part), District 1, Kanawha County, West Virginia",0,0,0,0,0,0,0,0,0,0,0,0,0,0,0,0,0,0,0,0
ACSSF,2010e5,wv,000,0034,0001663,080,54,039,08000US540399076814600011500,"Census Tract 115 (part), Charleston city (part), District 1, Kanawha County, West Virginia",0,0,0,0,0,0,0,0,0,0,0,0,0,0,0,0,0,0,0,0
ACSSF,2010e5,wv,000,0034,0001664,080,54,039,08000US540399076814812012200,"Census Tract 122 (part), Chelyan CDP, District 1, Kanawha County, West Virginia",112,77,0,0,0,0,77,35,0,0,0,0,0,0,35,18,0,0,18,17
ACSSF,2010e5,wv,000,0034,0001665,080,54,039,08000US540399076815028011500,"Census Tract 115 (part), Chesapeake town, District 1, Kanawha County, West Virginia",0,0,0,0,0,0,0,0,0,0,0,0,0,0,0,0,0,0,0,0
ACSSF,2010e5,wv,000,0034,0001666,080,54,039,08000US540399076815028011800,"Census Tract 118 (part), Chesapeake town, District 1, Kanawha County, West Virginia",0,0,0,0,0,0,0,0,0,0,0,0,0,0,0,0,0,0,0,0
ACSSF,2010e5,wv,000,0034,0001667,080,54,039,08000US540399076815028012200,"Census Tract 122 (part), Chesapeake town, District 1, Kanawha County, West Virginia",448,305,124,56,11,57,181,143,43,18,9,0,9,25,100,45,0,4,41,55
ACSSF,2010e5,wv,000,0034,0001668,080,54,039,08000US540399076816612011401,"Census Tract 114.01 (part), Coal Fork CDP (part), District 1, Kanawha County, West Virginia",235,217,41,8,0,33,176,18,0,0,0,0,0,0,18,10,10,0,0,8
ACSSF,2010e5,wv,000,0034,0001669,080,54,039,08000US540399076816612011402,"Census Tract 114.02 (part), Coal Fork CDP (part), District 1, Kanawha County, West Virginia",108,82,21,0,0,21,61,26,0,0,0,0,0,0,26,15,15,0,0,11
ACSSF,2010e5,wv,000,0034,0001670,080,54,039,08000US540399076823092012100,"Census Tract 121 (part), East Bank town, District 1, Kanawha County, West Virginia",303,176,40,16,0,24,136,127,33,20,15,0,5,13,94,65,9,33,23,29
ACSSF,2010e5,wv,000,0034,0001671,080,54,039,08000US540399076831324011800,"Census Tract 118 (part), Glasgow town, District 1, Kanawha County, West Virginia",180,150,55,13,18,24,95,30,10,0,0,0,0,10,20,13,4,9,0,7
ACSSF,2010e5,wv,000,0034,0001672,080,54,039,08000US540399076834756011800,"Census Tract 118 (part), Handley town, District 1, Kanawha County, West Virginia",0,0,0,0,0,0,0,0,0,0,0,0,0,0,0,0,0,0,0,0
ACSSF,2010e5,wv,000,0034,0001673,080,54,039,08000US540399076834756012100,"Census Tract 121 (part), Handley town, District 1, Kanawha County, West Virginia",47,34,12,2,4,6,22,13,2,0,0,0,0,2,11,3,3,0,0,8
ACSSF,2010e5,wv,000,0034,0001674,080,54,039,08000US540399076851724011500,"Census Tract 115 (part), Marmet city, District 1, Kanawha County, West Virginia",0,0,0,0,0,0,0,0,0,0,0,0,0,0,0,0,0,0,0,0
ACSSF,2010e5,wv,000,0034,0001675,080,54,039,08000US540399076851724012200,"Census Tract 122 (part), Marmet city, District 1, Kanawha County, West Virginia",0,0,0,0,0,0,0,0,0,0,0,0,0,0,0,0,0,0,0,0
ACSSF,2010e5,wv,000,0034,0001676,080,54,039,08000US540399076851724012300,"Census Tract 123 (part), Marmet city, District 1, Kanawha County, West Virginia",454,328,118,16,8,94,210,126,36,4,0,0,4,32,90,54,13,11,30,36
ACSSF,2010e5,wv,000,0034,0001677,080,54,039,08000US540399076855468011800,"Census Tract 118 (part), Montgomery city (part), District 1, Kanawha County, West Virginia",0,0,0,0,0,0,0,0,0,0,0,0,0,0,0,0,0,0,0,0
ACSSF,2010e5,wv,000,0034,0001678,080,54,039,08000US540399076855468012100,"Census Tract 121 (part), Montgomery city (part), District 1, Kanawha County, West Virginia",179,105,56,0,0,56,49,74,9,4,2,0,2,5,65,50,29,7,14,15
ACSSF,2010e5,wv,000,0034,0001679,080,54,039,08000US540399076865356012100,"Census Tract 121 (part), Pratt town, District 1, Kanawha County, West Virginia",145,101,42,9,5,28,59,44,10,5,0,0,5,5,34,8,0,0,8,26
ACSSF,2010e5,wv,000,0034,0001680,080,54,039,08000US540399076866892011500,"Census Tract 115 (part), Rand CDP, District 1, Kanawha County, West Virginia",394,218,22,0,12,10,196,176,35,16,16,0,0,19,141,92,10,49,33,49
ACSSF,2010e5,wv,000,0034,0001681,080,54,039,08000US540399076873876011800,"Census Tract 118 (part), Shrewsbury CDP, District 1, Kanawha County, West Virginia",229,200,76,0,55,21,124,29,0,0,0,0,0,0,29,0,0,0,0,29
ACSSF,2010e5,wv,000,0034,0001682,080,54,039,08000US540399076874740011800,"Census Tract 118 (part), Smithers city (part), District 1, Kanawha County, West Virginia",0,0,0,0,0,0,0,0,0,0,0,0,0,0,0,0,0,0,0,0
ACSSF,2010e5,wv,000,0034,0001683,080,54,039,08000US540399076899999001100,"Census Tract 11 (part), District Remainder of 1, District 1, Kanawha County, West Virginia",19,19,8,0,0,8,11,0,0,0,0,0,0,0,0,0,0,0,0,0
ACSSF,2010e5,wv,000,0034,0001684,080,54,039,08000US540399076899999001700,"Census Tract 17 (part), District Remainder of 1, District 1, Kanawha County, West Virginia",0,0,0,0,0,0,0,0,0,0,0,0,0,0,0,0,0,0,0,0
ACSSF,2010e5,wv,000,0034,0001685,080,54,039,08000US540399076899999001800,"Census Tract 18 (part), District Remainder of 1, District 1, Kanawha County, West Virginia",0,0,0,0,0,0,0,0,0,0,0,0,0,0,0,0,0,0,0,0
ACSSF,2010e5,wv,000,0034,0001686,080,54,039,08000US540399076899999011301,"Census Tract 113.01 (part), District Remainder of 1, District 1, Kanawha County, West Virginia",162,155,35,0,12,23,120,7,0,0,0,0,0,0,7,7,0,0,7,0
ACSSF,2010e5,wv,000,0034,0001687,080,54,039,08000US540399076899999011401,"Census Tract 114.01 (part), District Remainder of 1, District 1, Kanawha County, West Virginia",211,207,47,0,9,38,160,4,0,0,0,0,0,0,4,4,4,0,0,0
ACSSF,2010e5,wv,000,0034,0001688,080,54,039,08000US540399076899999011402,"Census Tract 114.02 (part), District Remainder of 1, District 1, Kanawha County, West Virginia",1012,806,206,25,40,141,600,206,62,0,0,0,0,62,144,84,5,0,79,60
ACSSF,2010e5,wv,000,0034,0001689,080,54,039,08000US540399076899999011500,"Census Tract 115 (part), District Remainder of 1, District 1, Kanawha County, West Virginia",511,303,54,12,0,42,249,208,81,20,0,0,20,61,127,108,0,0,108,19
ACSSF,2010e5,wv,000,0034,0001690,080,54,039,08000US540399076899999011800,"Census Tract 118 (part), District Remainder of 1, District 1, Kanawha County, West Virginia",817,624,200,0,15,185,424,193,15,0,0,0,0,15,178,80,28,38,14,98
ACSSF,2010e5,wv,000,0034,0001691,080,54,039,08000US540399076899999012100,"Census Tract 121 (part), District Remainder of 1, District 1, Kanawha County, West Virginia",637,461,174,11,40,123,287,176,76,43,0,0,43,33,100,23,0,0,23,77
ACSSF,2010e5,wv,000,0034,0001692,080,54,039,08000US540399076899999012200,"Census Tract 122 (part), District Remainder of 1, District 1, Kanawha County, West Virginia",493,388,120,38,46,36,268,105,17,0,0,0,0,17,88,36,0,18,18,52
ACSSF,2010e5,wv,000,0034,0001693,080,54,039,08000US540399076899999012300,"Census Tract 123 (part), District Remainder of 1, District 1, Kanawha County, West Virginia",99,61,28,0,0,28,33,38,0,0,0,0,0,0,38,30,0,0,30,8
ACSSF,2010e5,wv,000,0034,0001694,080,54,039,08000US540399080401396012300,"Census Tract 123 (part), Alum Creek CDP (part), District 2, Kanawha County, West Virginia",71,59,7,0,0,7,52,12,12,12,0,12,0,0,0,0,0,0,0,0
ACSSF,2010e5,wv,000,0034,0001695,080,54,039,08000US540399080414600000100,"Census Tract 1 (part), Charleston city (part), District 2, Kanawha County, West Virginia",268,99,41,0,0,41,58,169,102,84,32,13,39,18,67,14,0,9,5,53
ACSSF,2010e5,wv,000,0034,0001696,080,54,039,08000US540399080414600000200,"Census Tract 2 (part), Charleston city (part), District 2, Kanawha County, West Virginia",477,244,38,25,13,0,206,233,73,64,7,0,57,9,160,120,12,58,50,40
ACSSF,2010e5,wv,000,0034,0001697,080,54,039,08000US540399080414600000900,"Census Tract 9 (part), Charleston city (part), District 2, Kanawha County, West Virginia",0,0,0,0,0,0,0,0,0,0,0,0,0,0,0,0,0,0,0,0
ACSSF,2010e5,wv,000,0034,0001698,080,54,039,08000US540399080414600001300,"Census Tract 13 (part), Charleston city (part), District 2, Kanawha County, West Virginia",0,0,0,0,0,0,0,0,0,0,0,0,0,0,0,0,0,0,0,0
ACSSF,2010e5,wv,000,0034,0001699,080,54,039,08000US540399080414600001500,"Census Tract 15 (part), Charleston city (part), District 2, Kanawha County, West Virginia",285,217,60,0,0,60,157,68,20,20,0,0,20,0,48,20,0,0,20,28
ACSSF,2010e5,wv,000,0034,0001700,080,54,039,08000US540399080414600001800,"Census Tract 18 (part), Charleston city (part), District 2, Kanawha County, West Virginia",404,335,113,0,0,113,222,69,0,0,0,0,0,0,69,45,0,0,45,24
ACSSF,2010e5,wv,000,0034,0001701,080,54,039,08000US540399080414600001901,"Census Tract 19.01 (part), Charleston city (part), District 2, Kanawha County, West Virginia",1004,742,304,38,79,187,438,262,50,0,0,0,0,50,212,78,0,0,78,134
ACSSF,2010e5,wv,000,0034,0001702,080,54,039,08000US540399080414600001902,"Census Tract 19.02 (part), Charleston city (part), District 2, Kanawha County, West Virginia",1028,964,373,105,101,167,591,64,8,0,0,0,0,8,56,39,39,0,0,17
ACSSF,2010e5,wv,000,0034,0001703,080,54,039,08000US540399080414600002000,"Census Tract 20 (part), Charleston city (part), District 2, Kanawha County, West Virginia",724,571,236,66,24,146,335,153,59,59,23,0,36,0,94,57,11,0,46,37
ACSSF,2010e5,wv,000,0034,0001704,080,54,039,08000US540399080414600002100,"Census Tract 21 (part), Charleston city (part), District 2, Kanawha County, West Virginia",970,765,374,99,45,230,391,205,10,10,0,0,10,0,195,133,98,24,11,62
ACSSF,2010e5,wv,000,0034,0001705,080,54,039,08000US540399080414600012300,"Census Tract 123 (part), Charleston city (part), District 2, Kanawha County, West Virginia",61,52,29,0,0,29,23,9,0,0,0,0,0,0,9,9,0,0,9,0
ACSSF,2010e5,wv,000,0034,0001706,080,54,039,08000US540399080414600012800,"Census Tract 128 (part), Charleston city (part), District 2, Kanawha County, West Virginia",76,62,21,11,10,0,41,14,0,0,0,0,0,0,14,14,0,0,14,0
ACSSF,2010e5,wv,000,0034,0001707,080,54,039,08000US540399080414600013000,"Census Tract 130 (part), Charleston city (part), District 2, Kanawha County, West Virginia",14,14,0,0,0,0,14,0,0,0,0,0,0,0,0,0,0,0,0,0
ACSSF,2010e5,wv,000,0034,0001708,080,54,039,08000US540399080422564000100,"Census Tract 1 (part), Dunbar city (part), District 2, Kanawha County, West Virginia",0,0,0,0,0,0,0,0,0,0,0,0,0,0,0,0,0,0,0,0
ACSSF,2010e5,wv,000,0034,0001709,080,54,039,08000US540399080422564010100,"Census Tract 101 (part), Dunbar city (part), District 2, Kanawha County, West Virginia",795,642,230,68,32,130,412,153,18,18,9,0,9,0,135,55,26,29,0,80
ACSSF,2010e5,wv,000,0034,0001710,080,54,039,08000US540399080422564010200,"Census Tract 102 (part), Dunbar city (part), District 2, Kanawha County, West Virginia",675,366,107,26,29,52,259,309,82,0,0,0,0,82,227,142,47,12,83,85
ACSSF,2010e5,wv,000,0034,0001711,080,54,039,08000US540399080422564010300,"Census Tract 103 (part), Dunbar city (part), District 2, Kanawha County, West Virginia",661,419,81,0,0,81,338,242,0,0,0,0,0,0,242,112,0,0,112,130
ACSSF,2010e5,wv,000,0034,0001712,080,54,039,08000US540399080422564010400,"Census Tract 104 (part), Dunbar city (part), District 2, Kanawha County, West Virginia",8,8,0,0,0,0,8,0,0,0,0,0,0,0,0,0,0,0,0,0
ACSSF,2010e5,wv,000,0034,0001713,080,54,039,08000US540399080441010013100,"Census Tract 131 (part), Jefferson CDP (part), District 2, Kanawha County, West Virginia",0,0,0,0,0,0,0,0,0,0,0,0,0,0,0,0,0,0,0,0
ACSSF,2010e5,wv,000,0034,0001714,080,54,039,08000US540399080441010013200,"Census Tract 132 (part), Jefferson CDP (part), District 2, Kanawha County, West Virginia",55,30,3,0,3,0,27,25,0,0,0,0,0,0,25,18,0,0,18,7
ACSSF,2010e5,wv,000,0034,0001715,080,54,039,08000US540399080441010013400,"Census Tract 134 (part), Jefferson CDP (part), District 2, Kanawha County, West Virginia",49,21,9,9,0,0,12,28,0,0,0,0,0,0,28,23,3,15,5,5
ACSSF,2010e5,wv,000,0034,0001716,080,54,039,08000US540399080471212013200,"Census Tract 132 (part), St. Albans city (part), District 2, Kanawha County, West Virginia",0,0,0,0,0,0,0,0,0,0,0,0,0,0,0,0,0,0,0,0
ACSSF,2010e5,wv,000,0034,0001717,080,54,039,08000US540399080471212013400,"Census Tract 134 (part), St. Albans city (part), District 2, Kanawha County, West Virginia",20,20,0,0,0,0,20,0,0,0,0,0,0,0,0,0,0,0,0,0
ACSSF,2010e5,wv,000,0034,0001718,080,54,039,08000US540399080475292000100,"Census Tract 1 (part), South Charleston city, District 2, Kanawha County, West Virginia",0,0,0,0,0,0,0,0,0,0,0,0,0,0,0,0,0,0,0,0
ACSSF,2010e5,wv,000,0034,0001719,080,54,039,08000US540399080475292002100,"Census Tract 21 (part), South Charleston city, District 2, Kanawha County, West Virginia",320,293,85,13,21,51,208,27,0,0,0,0,0,0,27,12,12,0,0,15
ACSSF,2010e5,wv,000,0034,0001720,080,54,039,08000US540399080475292010100,"Census Tract 101 (part), South Charleston city, District 2, Kanawha County, West Virginia",0,0,0,0,0,0,0,0,0,0,0,0,0,0,0,0,0,0,0,0
ACSSF,2010e5,wv,000,0034,0001721,080,54,039,08000US540399080475292010200,"Census Tract 102 (part), South Charleston city, District 2, Kanawha County, West Virginia",0,0,0,0,0,0,0,0,0,0,0,0,0,0,0,0,0,0,0,0
ACSSF,2010e5,wv,000,0034,0001722,080,54,039,08000US540399080475292012300,"Census Tract 123 (part), South Charleston city, District 2, Kanawha County, West Virginia",11,11,0,0,0,0,11,0,0,0,0,0,0,0,0,0,0,0,0,0
ACSSF,2010e5,wv,000,0034,0001723,080,54,039,08000US540399080475292012800,"Census Tract 128 (part), South Charleston city, District 2, Kanawha County, West Virginia",1064,895,340,120,46,174,555,169,39,19,7,0,12,20,130,76,18,15,43,54
ACSSF,2010e5,wv,000,0034,0001724,080,54,039,08000US540399080475292012900,"Census Tract 129, South Charleston city, District 2, Kanawha County, West Virginia",373,270,84,48,0,36,186,103,8,0,0,0,0,8,95,42,0,9,33,53
ACSSF,2010e5,wv,000,0034,0001725,080,54,039,08000US540399080475292013000,"Census Tract 130 (part), South Charleston city, District 2, Kanawha County, West Virginia",983,580,161,6,48,107,419,403,81,9,0,0,9,72,322,114,33,6,75,208
ACSSF,2010e5,wv,000,0034,0001726,080,54,039,08000US540399080475292013100,"Census Tract 131 (part), South Charleston city, District 2, Kanawha County, West Virginia",927,514,112,35,10,67,402,413,59,36,0,0,36,23,354,258,92,33,133,96
ACSSF,2010e5,wv,000,0034,0001727,080,54,039,08000US540399080475292013200,"Census Tract 132 (part), South Charleston city, District 2, Kanawha County, West Virginia",0,0,0,0,0,0,0,0,0,0,0,0,0,0,0,0,0,0,0,0
ACSSF,2010e5,wv,000,0034,0001728,080,54,039,08000US540399080499999001800,"Census Tract 18 (part), District Remainder of 2, District 2, Kanawha County, West Virginia",10,10,10,10,0,0,0,0,0,0,0,0,0,0,0,0,0,0,0,0
ACSSF,2010e5,wv,000,0034,0001729,080,54,039,08000US540399080499999001901,"Census Tract 19.01 (part), District Remainder of 2, District 2, Kanawha County, West Virginia",114,101,89,0,13,76,12,13,0,0,0,0,0,0,13,0,0,0,0,13
ACSSF,2010e5,wv,000,0034,0001730,080,54,039,08000US540399080499999001902,"Census Tract 19.02 (part), District Remainder of 2, District 2, Kanawha County, West Virginia",159,150,45,0,11,34,105,9,0,0,0,0,0,0,9,9,0,0,9,0
ACSSF,2010e5,wv,000,0034,0001731,080,54,039,08000US540399080499999002100,"Census Tract 21 (part), District Remainder of 2, District 2, Kanawha County, West Virginia",0,0,0,0,0,0,0,0,0,0,0,0,0,0,0,0,0,0,0,0
ACSSF,2010e5,wv,000,0034,0001732,080,54,039,08000US540399080499999010100,"Census Tract 101 (part), District Remainder of 2, District 2, Kanawha County, West Virginia",42,32,0,0,0,0,32,10,10,0,0,0,0,10,0,0,0,0,0,0
ACSSF,2010e5,wv,000,0034,0001733,080,54,039,08000US540399080499999010200,"Census Tract 102 (part), District Remainder of 2, District 2, Kanawha County, West Virginia",0,0,0,0,0,0,0,0,0,0,0,0,0,0,0,0,0,0,0,0
ACSSF,2010e5,wv,000,0034,0001734,080,54,039,08000US540399080499999010400,"Census Tract 104 (part), District Remainder of 2, District 2, Kanawha County, West Virginia",0,0,0,0,0,0,0,0,0,0,0,0,0,0,0,0,0,0,0,0
ACSSF,2010e5,wv,000,0034,0001735,080,54,039,08000US540399080499999012300,"Census Tract 123 (part), District Remainder of 2, District 2, Kanawha County, West Virginia",810,723,298,72,84,142,425,87,32,0,0,0,0,32,55,30,23,0,7,25
ACSSF,2010e5,wv,000,0034,0001736,080,54,039,08000US540399080499999012800,"Census Tract 128 (part), District Remainder of 2, District 2, Kanawha County, West Virginia",0,0,0,0,0,0,0,0,0,0,0,0,0,0,0,0,0,0,0,0
ACSSF,2010e5,wv,000,0034,0001737,080,54,039,08000US540399080499999013000,"Census Tract 130 (part), District Remainder of 2, District 2, Kanawha County, West Virginia",342,277,90,65,9,16,187,65,0,0,0,0,0,0,65,42,0,0,42,23
ACSSF,2010e5,wv,000,0034,0001738,080,54,039,08000US540399080499999013100,"Census Tract 131 (part), District Remainder of 2, District 2, Kanawha County, West Virginia",168,107,39,0,18,21,68,61,0,0,0,0,0,0,61,13,0,0,13,48
ACSSF,2010e5,wv,000,0034,0001739,080,54,039,08000US540399080499999013200,"Census Tract 132 (part), District Remainder of 2, District 2, Kanawha County, West Virginia",532,424,188,17,13,158,236,108,80,51,0,27,24,29,28,0,0,0,0,28
ACSSF,2010e5,wv,000,0034,0001740,080,54,039,08000US540399080499999013300,"Census Tract 133 (part), District Remainder of 2, District 2, Kanawha County, West Virginia",33,0,0,0,0,0,0,33,0,0,0,0,0,0,33,33,0,0,33,0
ACSSF,2010e5,wv,000,0034,0001741,080,54,039,08000US540399084019108010500,"Census Tract 105 (part), Cross Lanes CDP, District 3, Kanawha County, West Virginia",988,737,223,53,34,136,514,251,67,59,48,0,11,8,184,131,59,11,61,53
ACSSF,2010e5,wv,000,0034,0001742,080,54,039,08000US540399084019108010701,"Census Tract 107.01 (part), Cross Lanes CDP, District 3, Kanawha County, West Virginia",972,808,343,108,64,171,465,164,34,0,0,0,0,34,130,53,23,0,30,77
ACSSF,2010e5,wv,000,0034,0001743,080,54,039,08000US540399084019108010702,"Census Tract 107.02 (part), Cross Lanes CDP, District 3, Kanawha County, West Virginia",536,479,109,17,0,92,370,57,10,0,0,0,0,10,47,18,0,0,18,29
ACSSF,2010e5,wv,000,0034,0001744,080,54,039,08000US540399084022564000200,"Census Tract 2 (part), Dunbar city (part), District 3, Kanawha County, West Virginia",0,0,0,0,0,0,0,0,0,0,0,0,0,0,0,0,0,0,0,0
ACSSF,2010e5,wv,000,0034,0001745,080,54,039,08000US540399084022564010100,"Census Tract 101 (part), Dunbar city (part), District 3, Kanawha County, West Virginia",0,0,0,0,0,0,0,0,0,0,0,0,0,0,0,0,0,0,0,0
ACSSF,2010e5,wv,000,0034,0001746,080,54,039,08000US540399084022564010300,"Census Tract 103 (part), Dunbar city (part), District 3, Kanawha County, West Virginia",0,0,0,0,0,0,0,0,0,0,0,0,0,0,0,0,0,0,0,0
ACSSF,2010e5,wv,000,0034,0001747,080,54,039,08000US540399084022564010400,"Census Tract 104 (part), Dunbar city (part), District 3, Kanawha County, West Virginia",0,0,0,0,0,0,0,0,0,0,0,0,0,0,0,0,0,0,0,0
ACSSF,2010e5,wv,000,0034,0001748,080,54,039,08000US540399084022564010500,"Census Tract 105 (part), Dunbar city (part), District 3, Kanawha County, West Virginia",0,0,0,0,0,0,0,0,0,0,0,0,0,0,0,0,0,0,0,0
ACSSF,2010e5,wv,000,0034,0001749,080,54,039,08000US540399084041010013400,"Census Tract 134 (part), Jefferson CDP (part), District 3, Kanawha County, West Virginia",0,0,0,0,0,0,0,0,0,0,0,0,0,0,0,0,0,0,0,0
ACSSF,2010e5,wv,000,0034,0001750,080,54,039,08000US540399084059068010600,"Census Tract 106 (part), Nitro city (part), District 3, Kanawha County, West Virginia",1339,973,403,121,177,105,570,366,172,114,48,0,66,58,194,115,13,11,91,79
ACSSF,2010e5,wv,000,0034,0001751,080,54,039,08000US540399084059068010701,"Census Tract 107.01 (part), Nitro city (part), District 3, Kanawha County, West Virginia",190,132,39,0,20,19,93,58,11,11,0,0,11,0,47,26,0,0,26,21
ACSSF,2010e5,wv,000,0034,0001752,080,54,039,08000US540399084059068013800,"Census Tract 138 (part), Nitro city (part), District 3, Kanawha County, West Virginia",0,0,0,0,0,0,0,0,0,0,0,0,0,0,0,0,0,0,0,0
ACSSF,2010e5,wv,000,0034,0001753,080,54,039,08000US540399084071212013200,"Census Tract 132 (part), St. Albans city (part), District 3, Kanawha County, West Virginia",18,18,10,0,0,10,8,0,0,0,0,0,0,0,0,0,0,0,0,0
ACSSF,2010e5,wv,000,0034,0001754,080,54,039,08000US540399084071212013300,"Census Tract 133 (part), St. Albans city (part), District 3, Kanawha County, West Virginia",751,582,175,44,22,109,407,169,39,30,0,0,30,9,130,36,11,0,25,94
ACSSF,2010e5,wv,000,0034,0001755,080,54,039,08000US540399084071212013400,"Census Tract 134 (part), St. Albans city (part), District 3, Kanawha County, West Virginia",424,313,119,14,9,96,194,111,29,0,0,0,0,29,82,44,0,9,35,38
ACSSF,2010e5,wv,000,0034,0001756,080,54,039,08000US540399084071212013500,"Census Tract 135 (part), St. Albans city (part), District 3, Kanawha County, West Virginia",662,507,127,21,33,73,380,155,46,18,0,0,18,28,109,67,11,12,44,42
ACSSF,2010e5,wv,000,0034,0001757,080,54,039,08000US540399084071212013600,"Census Tract 136 (part), St. Albans city (part), District 3, Kanawha County, West Virginia",788,515,177,45,15,117,338,273,111,96,9,0,87,15,162,110,22,0,88,52
ACSSF,2010e5,wv,000,0034,0001758,080,54,039,08000US540399084071212013702,"Census Tract 137.02 (part), St. Albans city (part), District 3, Kanawha County, West Virginia",274,245,67,0,14,53,178,29,29,29,0,0,29,0,0,0,0,0,0,0
ACSSF,2010e5,wv,000,0034,0001759,080,54,039,08000US540399084074356010801,"Census Tract 108.01 (part), Sissonville CDP (part), District 3, Kanawha County, West Virginia",27,27,0,0,0,0,27,0,0,0,0,0,0,0,0,0,0,0,0,0
ACSSF,2010e5,wv,000,0034,0001760,080,54,039,08000US540399084074356010802,"Census Tract 108.02 (part), Sissonville CDP (part), District 3, Kanawha County, West Virginia",164,164,100,0,13,87,64,0,0,0,0,0,0,0,0,0,0,0,0,0
ACSSF,2010e5,wv,000,0034,0001761,080,54,039,08000US540399084082180013200,"Census Tract 132 (part), Upper Falls CDP, District 3, Kanawha County, West Virginia",135,92,38,0,0,38,54,43,9,0,0,0,0,9,34,0,0,0,0,34
ACSSF,2010e5,wv,000,0034,0001762,080,54,039,08000US540399084082180013600,"Census Tract 136 (part), Upper Falls CDP, District 3, Kanawha County, West Virginia",150,115,25,12,0,13,90,35,0,0,0,0,0,0,35,35,0,35,0,0
ACSSF,2010e5,wv,000,0034,0001763,080,54,039,08000US540399084082180013701,"Census Tract 137.01 (part), Upper Falls CDP, District 3, Kanawha County, West Virginia",741,636,250,42,48,160,386,105,14,0,0,0,0,14,91,73,20,0,53,18
ACSSF,2010e5,wv,000,0034,0001764,080,54,039,08000US540399084082180013702,"Census Tract 137.02 (part), Upper Falls CDP, District 3, Kanawha County, West Virginia",41,41,0,0,0,0,41,0,0,0,0,0,0,0,0,0,0,0,0,0
ACSSF,2010e5,wv,000,0034,0001765,080,54,039,08000US540399084099999000200,"Census Tract 2 (part), District Remainder of 3, District 3, Kanawha County, West Virginia",149,149,32,17,0,15,117,0,0,0,0,0,0,0,0,0,0,0,0,0
ACSSF,2010e5,wv,000,0034,0001766,080,54,039,08000US540399084099999010100,"Census Tract 101 (part), District Remainder of 3, District 3, Kanawha County, West Virginia",176,142,79,0,52,27,63,34,25,13,0,0,13,12,9,9,9,0,0,0
ACSSF,2010e5,wv,000,0034,0001767,080,54,039,08000US540399084099999010300,"Census Tract 103 (part), District Remainder of 3, District 3, Kanawha County, West Virginia",29,14,0,0,0,0,14,15,10,0,0,0,0,10,5,0,0,0,0,5
ACSSF,2010e5,wv,000,0034,0001768,080,54,039,08000US540399084099999010400,"Census Tract 104 (part), District Remainder of 3, District 3, Kanawha County, West Virginia",245,204,56,20,0,36,148,41,0,0,0,0,0,0,41,19,0,0,19,22
ACSSF,2010e5,wv,000,0034,0001769,080,54,039,08000US540399084099999010500,"Census Tract 105 (part), District Remainder of 3, District 3, Kanawha County, West Virginia",434,274,83,9,44,30,191,160,72,54,0,0,54,18,88,68,12,32,24,20
ACSSF,2010e5,wv,000,0034,0001770,080,54,039,08000US540399084099999010600,"Census Tract 106 (part), District Remainder of 3, District 3, Kanawha County, West Virginia",189,133,58,0,0,58,75,56,20,0,0,0,0,20,36,24,0,0,24,12
ACSSF,2010e5,wv,000,0034,0001771,080,54,039,08000US540399084099999010701,"Census Tract 107.01 (part), District Remainder of 3, District 3, Kanawha County, West Virginia",59,59,8,0,0,8,51,0,0,0,0,0,0,0,0,0,0,0,0,0
ACSSF,2010e5,wv,000,0034,0001772,080,54,039,08000US540399084099999010702,"Census Tract 107.02 (part), District Remainder of 3, District 3, Kanawha County, West Virginia",689,605,305,39,76,190,300,84,41,0,0,0,0,41,43,23,0,0,23,20
ACSSF,2010e5,wv,000,0034,0001773,080,54,039,08000US540399084099999010801,"Census Tract 108.01 (part), District Remainder of 3, District 3, Kanawha County, West Virginia",717,573,211,40,43,128,362,144,31,14,0,0,14,17,113,70,16,0,54,43
ACSSF,2010e5,wv,000,0034,0001774,080,54,039,08000US540399084099999010802,"Census Tract 108.02 (part), District Remainder of 3, District 3, Kanawha County, West Virginia",127,61,30,0,21,9,31,66,37,25,13,0,12,12,29,21,0,0,21,8
ACSSF,2010e5,wv,000,0034,0001775,080,54,039,08000US540399084099999013100,"Census Tract 131 (part), District Remainder of 3, District 3, Kanawha County, West Virginia",20,20,0,0,0,0,20,0,0,0,0,0,0,0,0,0,0,0,0,0
ACSSF,2010e5,wv,000,0034,0001776,080,54,039,08000US540399084099999013200,"Census Tract 132 (part), District Remainder of 3, District 3, Kanawha County, West Virginia",194,136,47,0,17,30,89,58,35,26,26,0,0,9,23,8,8,0,0,15
ACSSF,2010e5,wv,000,0034,0001777,080,54,039,08000US540399084099999013300,"Census Tract 133 (part), District Remainder of 3, District 3, Kanawha County, West Virginia",0,0,0,0,0,0,0,0,0,0,0,0,0,0,0,0,0,0,0,0
ACSSF,2010e5,wv,000,0034,0001778,080,54,039,08000US540399084099999013400,"Census Tract 134 (part), District Remainder of 3, District 3, Kanawha County, West Virginia",0,0,0,0,0,0,0,0,0,0,0,0,0,0,0,0,0,0,0,0
ACSSF,2010e5,wv,000,0034,0001779,080,54,039,08000US540399084099999013500,"Census Tract 135 (part), District Remainder of 3, District 3, Kanawha County, West Virginia",0,0,0,0,0,0,0,0,0,0,0,0,0,0,0,0,0,0,0,0
ACSSF,2010e5,wv,000,0034,0001780,080,54,039,08000US540399084099999013600,"Census Tract 136 (part), District Remainder of 3, District 3, Kanawha County, West Virginia",332,200,16,16,0,0,184,132,17,17,0,0,17,0,115,22,0,0,22,93
ACSSF,2010e5,wv,000,0034,0001781,080,54,039,08000US540399084099999013701,"Census Tract 137.01 (part), District Remainder of 3, District 3, Kanawha County, West Virginia",0,0,0,0,0,0,0,0,0,0,0,0,0,0,0,0,0,0,0,0
ACSSF,2010e5,wv,000,0034,0001782,080,54,039,08000US540399084099999013702,"Census Tract 137.02 (part), District Remainder of 3, District 3, Kanawha County, West Virginia",1153,919,270,74,61,135,649,234,27,0,0,0,0,27,207,140,32,47,61,67
ACSSF,2010e5,wv,000,0034,0001783,080,54,039,08000US540399084099999013800,"Census Tract 138 (part), District Remainder of 3, District 3, Kanawha County, West Virginia",820,541,214,50,23,141,327,279,30,11,0,0,11,19,249,135,25,54,56,114
ACSSF,2010e5,wv,000,0034,0001784,080,54,039,08000US540399087607204011000,"Census Tract 110 (part), Big Chimney CDP, District 4, Kanawha County, West Virginia",179,179,14,0,0,14,165,0,0,0,0,0,0,0,0,0,0,0,0,0
ACSSF,2010e5,wv,000,0034,0001785,080,54,039,08000US540399087614600000100,"Census Tract 1 (part), Charleston city (part), District 4, Kanawha County, West Virginia",42,22,0,0,0,0,22,20,0,0,0,0,0,0,20,20,20,0,0,0
ACSSF,2010e5,wv,000,0034,0001786,080,54,039,08000US540399087614600000200,"Census Tract 2 (part), Charleston city (part), District 4, Kanawha County, West Virginia",95,18,0,0,0,0,18,77,6,0,0,0,0,6,71,61,46,0,15,10
ACSSF,2010e5,wv,000,0034,0001787,080,54,039,08000US540399087614600000300,"Census Tract 3 (part), Charleston city (part), District 4, Kanawha County, West Virginia",798,599,180,63,8,109,419,199,66,40,0,18,22,26,133,120,24,0,96,13
ACSSF,2010e5,wv,000,0034,0001788,080,54,039,08000US540399087614600000500,"Census Tract 5, Charleston city (part), District 4, Kanawha County, West Virginia",527,409,114,10,58,46,295,118,54,54,0,45,9,0,64,21,0,0,21,43
ACSSF,2010e5,wv,000,0034,0001789,080,54,039,08000US540399087614600000600,"Census Tract 6, Charleston city (part), District 4, Kanawha County, West Virginia",1013,651,210,59,16,135,441,362,31,0,0,0,0,31,331,233,55,20,158,98
ACSSF,2010e5,wv,000,0034,0001790,080,54,039,08000US540399087614600000700,"Census Tract 7, Charleston city (part), District 4, Kanawha County, West Virginia",393,164,44,0,2,42,120,229,45,0,0,0,0,45,184,86,12,42,32,98
ACSSF,2010e5,wv,000,0034,0001791,080,54,039,08000US540399087614600000800,"Census Tract 8, Charleston city (part), District 4, Kanawha County, West Virginia",475,190,69,8,37,24,121,285,51,46,0,0,46,5,234,139,76,13,50,95
ACSSF,2010e5,wv,000,0034,0001792,080,54,039,08000US540399087614600000900,"Census Tract 9 (part), Charleston city (part), District 4, Kanawha County, West Virginia",0,0,0,0,0,0,0,0,0,0,0,0,0,0,0,0,0,0,0,0
ACSSF,2010e5,wv,000,0034,0001793,080,54,039,08000US540399087614600001100,"Census Tract 11 (part), Charleston city (part), District 4, Kanawha County, West Virginia",0,0,0,0,0,0,0,0,0,0,0,0,0,0,0,0,0,0,0,0
ACSSF,2010e5,wv,000,0034,0001794,080,54,039,08000US540399087614600011000,"Census Tract 110 (part), Charleston city (part), District 4, Kanawha County, West Virginia",40,12,0,0,0,0,12,28,0,0,0,0,0,0,28,0,0,0,0,28
ACSSF,2010e5,wv,000,0034,0001795,080,54,039,08000US540399087614600011301,"Census Tract 113.01 (part), Charleston city (part), District 4, Kanawha County, West Virginia",0,0,0,0,0,0,0,0,0,0,0,0,0,0,0,0,0,0,0,0
ACSSF,2010e5,wv,000,0034,0001796,080,54,039,08000US540399087614600011401,"Census Tract 114.01 (part), Charleston city (part), District 4, Kanawha County, West Virginia",0,0,0,0,0,0,0,0,0,0,0,0,0,0,0,0,0,0,0,0
ACSSF,2010e5,wv,000,0034,0001797,080,54,039,08000US540399087616012011200,"Census Tract 112 (part), Clendenin town, District 4, Kanawha County, West Virginia",340,246,89,29,11,49,157,94,7,0,0,0,0,7,87,48,7,14,27,39
ACSSF,2010e5,wv,000,0034,0001798,080,54,039,08000US540399087616612011401,"Census Tract 114.01 (part), Coal Fork CDP (part), District 4, Kanawha County, West Virginia",0,0,0,0,0,0,0,0,0,0,0,0,0,0,0,0,0,0,0,0
ACSSF,2010e5,wv,000,0034,0001799,080,54,039,08000US540399087624748011100,"Census Tract 111 (part), Elkview CDP, District 4, Kanawha County, West Virginia",127,77,20,0,20,0,57,50,0,0,0,0,0,0,50,0,0,0,0,50
ACSSF,2010e5,wv,000,0034,0001800,080,54,039,08000US540399087624748011302,"Census Tract 113.02 (part), Elkview CDP, District 4, Kanawha County, West Virginia",281,269,80,22,0,58,189,12,12,0,0,0,0,12,0,0,0,0,0,0
ACSSF,2010e5,wv,000,0034,0001801,080,54,039,08000US540399087663772011302,"Census Tract 113.02 (part), Pinch CDP, District 4, Kanawha County, West Virginia",884,769,240,77,74,89,529,115,10,10,10,0,0,0,105,38,0,0,38,67
ACSSF,2010e5,wv,000,0034,0001802,080,54,039,08000US540399087674356010801,"Census Tract 108.01 (part), Sissonville CDP (part), District 4, Kanawha County, West Virginia",997,818,291,84,49,158,527,179,25,25,0,8,17,0,154,82,10,0,72,72
ACSSF,2010e5,wv,000,0034,0001803,080,54,039,08000US540399087674356010802,"Census Tract 108.02 (part), Sissonville CDP (part), District 4, Kanawha County, West Virginia",271,183,10,0,0,10,173,88,12,0,0,0,0,12,76,34,0,34,0,42
ACSSF,2010e5,wv,000,0034,0001804,080,54,039,08000US540399087699999000200,"Census Tract 2 (part), District Remainder of 4, District 4, Kanawha County, West Virginia",58,38,0,0,0,0,38,20,0,0,0,0,0,0,20,20,0,0,20,0
ACSSF,2010e5,wv,000,0034,0001805,080,54,039,08000US540399087699999000300,"Census Tract 3 (part), District Remainder of 4, District 4, Kanawha County, West Virginia",38,32,0,0,0,0,32,6,6,0,0,0,0,6,0,0,0,0,0,0
ACSSF,2010e5,wv,000,0034,0001806,080,54,039,08000US540399087699999001100,"Census Tract 11 (part), District Remainder of 4, District 4, Kanawha County, West Virginia",20,20,0,0,0,0,20,0,0,0,0,0,0,0,0,0,0,0,0,0
ACSSF,2010e5,wv,000,0034,0001807,080,54,039,08000US540399087699999010702,"Census Tract 107.02 (part), District Remainder of 4, District 4, Kanawha County, West Virginia",110,110,0,0,0,0,110,0,0,0,0,0,0,0,0,0,0,0,0,0
ACSSF,2010e5,wv,000,0034,0001808,080,54,039,08000US540399087699999010801,"Census Tract 108.01 (part), District Remainder of 4, District 4, Kanawha County, West Virginia",400,298,21,0,9,12,277,102,40,11,0,0,11,29,62,58,0,0,58,4
ACSSF,2010e5,wv,000,0034,0001809,080,54,039,08000US540399087699999010802,"Census Tract 108.02 (part), District Remainder of 4, District 4, Kanawha County, West Virginia",599,534,158,26,13,119,376,65,5,0,0,0,0,5,60,13,13,0,0,47
ACSSF,2010e5,wv,000,0034,0001810,080,54,039,08000US540399087699999010900,"Census Tract 109, District Remainder of 4, District 4, Kanawha County, West Virginia",693,584,158,0,11,147,426,109,36,27,10,0,17,9,73,0,0,0,0,73
ACSSF,2010e5,wv,000,0034,0001811,080,54,039,08000US540399087699999011000,"Census Tract 110 (part), District Remainder of 4, District 4, Kanawha County, West Virginia",1118,982,428,73,146,209,554,136,18,18,18,0,0,0,118,71,42,0,29,47
ACSSF,2010e5,wv,000,0034,0001812,080,54,039,08000US540399087699999011100,"Census Tract 111 (part), District Remainder of 4, District 4, Kanawha County, West Virginia",1314,1034,292,123,0,169,742,280,116,87,0,0,87,29,164,125,78,21,26,39
ACSSF,2010e5,wv,000,0034,0001813,080,54,039,08000US540399087699999011200,"Census Tract 112 (part), District Remainder of 4, District 4, Kanawha County, West Virginia",925,804,253,48,72,133,551,121,18,0,0,0,0,18,103,37,12,0,25,66
ACSSF,2010e5,wv,000,0034,0001814,080,54,039,08000US540399087699999011301,"Census Tract 113.01 (part), District Remainder of 4, District 4, Kanawha County, West Virginia",666,516,197,24,59,114,319,150,51,35,0,0,35,16,99,64,6,0,58,35
ACSSF,2010e5,wv,000,0034,0001815,080,54,039,08000US540399087699999011302,"Census Tract 113.02 (part), District Remainder of 4, District 4, Kanawha County, West Virginia",409,308,87,18,0,69,221,101,14,14,14,0,0,0,87,13,0,0,13,74
ACSSF,2010e5,wv,000,0034,0001816,080,54,039,08000US540399087699999011401,"Census Tract 114.01 (part), District Remainder of 4, District 4, Kanawha County, West Virginia",179,162,55,23,0,32,107,17,0,0,0,0,0,0,17,0,0,0,0,17
ACSSF,2010e5,wv,000,0034,0001817,080,54,039,08000US540399087699999011800,"Census Tract 118 (part), District Remainder of 4, District 4, Kanawha County, West Virginia",0,0,0,0,0,0,0,0,0,0,0,0,0,0,0,0,0,0,0,0
ACSSF,2010e5,wv,000,0034,0001818,080,54,041,08000US540419067685972967400,"Census Tract 9674 (part), Weston city (part), Courthouse-Collins Settlement district, Lewis County, West Virginia",384,278,97,15,16,66,181,106,42,42,13,10,19,0,64,46,9,0,37,18
ACSSF,2010e5,wv,000,0034,0001819,080,54,041,08000US540419067685972967500,"Census Tract 9675 (part), Weston city (part), Courthouse-Collins Settlement district, Lewis County, West Virginia",246,188,58,32,0,26,130,58,0,0,0,0,0,0,58,51,0,11,40,7
ACSSF,2010e5,wv,000,0034,0001820,080,54,041,08000US540419067699999967200,"Census Tract 9672 (part), Remainder of Courthouse-Collins Settlement district, Courthouse-Collins Settlement district, Lewis County, West Virginia",38,17,0,0,0,0,17,21,0,0,0,0,0,0,21,10,0,0,10,11
ACSSF,2010e5,wv,000,0034,0001821,080,54,041,08000US540419067699999967400,"Census Tract 9674 (part), Remainder of Courthouse-Collins Settlement district, Courthouse-Collins Settlement district, Lewis County, West Virginia",66,66,0,0,0,0,66,0,0,0,0,0,0,0,0,0,0,0,0,0
ACSSF,2010e5,wv,000,0034,0001822,080,54,041,08000US540419067699999967500,"Census Tract 9675 (part), Remainder of Courthouse-Collins Settlement district, Courthouse-Collins Settlement district, Lewis County, West Virginia",0,0,0,0,0,0,0,0,0,0,0,0,0,0,0,0,0,0,0,0
ACSSF,2010e5,wv,000,0034,0001823,080,54,041,08000US540419067699999967600,"Census Tract 9676 (part), Remainder of Courthouse-Collins Settlement district, Courthouse-Collins Settlement district, Lewis County, West Virginia",617,489,169,19,18,132,320,128,43,19,0,0,19,24,85,59,22,0,37,26
ACSSF,2010e5,wv,000,0034,0001824,080,54,041,08000US540419117685972967200,"Census Tract 9672 (part), Weston city (part), Freemans Creek district, Lewis County, West Virginia",52,41,14,0,0,14,27,11,0,0,0,0,0,0,11,11,0,11,0,0
ACSSF,2010e5,wv,000,0034,0001825,080,54,041,08000US540419117685972967500,"Census Tract 9675 (part), Weston city (part), Freemans Creek district, Lewis County, West Virginia",246,198,93,10,6,77,105,48,9,0,0,0,0,9,39,32,13,9,10,7
ACSSF,2010e5,wv,000,0034,0001826,080,54,041,08000US540419117699999967200,"Census Tract 9672 (part), Remainder of Freemans Creek district, Freemans Creek district, Lewis County, West Virginia",881,790,227,0,94,133,563,91,52,26,17,0,9,26,39,39,0,0,39,0
ACSSF,2010e5,wv,000,0034,0001827,080,54,041,08000US540419117699999967500,"Census Tract 9675 (part), Remainder of Freemans Creek district, Freemans Creek district, Lewis County, West Virginia",158,143,15,0,0,15,128,15,0,0,0,0,0,0,15,15,0,0,15,0
ACSSF,2010e5,wv,000,0034,0001828,080,54,041,08000US540419117699999967600,"Census Tract 9676 (part), Remainder of Freemans Creek district, Freemans Creek district, Lewis County, West Virginia",55,55,15,0,0,15,40,0,0,0,0,0,0,0,0,0,0,0,0,0
ACSSF,2010e5,wv,000,0034,0001829,080,54,041,08000US540419148040828967300,"Census Tract 9673 (part), Jane Lew town, Hackers Creek-Skin Creek district, Lewis County, West Virginia",106,81,14,8,0,6,67,25,0,0,0,0,0,0,25,6,0,0,6,19
ACSSF,2010e5,wv,000,0034,0001830,080,54,041,08000US540419148040828967400,"Census Tract 9674 (part), Jane Lew town, Hackers Creek-Skin Creek district, Lewis County, West Virginia",16,16,5,0,0,5,11,0,0,0,0,0,0,0,0,0,0,0,0,0
ACSSF,2010e5,wv,000,0034,0001831,080,54,041,08000US540419148085972967300,"Census Tract 9673 (part), Weston city (part), Hackers Creek-Skin Creek district, Lewis County, West Virginia",20,8,0,0,0,0,8,12,0,0,0,0,0,0,12,12,0,0,12,0
ACSSF,2010e5,wv,000,0034,0001832,080,54,041,08000US540419148085972967400,"Census Tract 9674 (part), Weston city (part), Hackers Creek-Skin Creek district, Lewis County, West Virginia",216,128,26,0,8,18,102,88,0,0,0,0,0,0,88,51,11,0,40,37
ACSSF,2010e5,wv,000,0034,0001833,080,54,041,08000US540419148085972967600,"Census Tract 9676 (part), Weston city (part), Hackers Creek-Skin Creek district, Lewis County, West Virginia",0,0,0,0,0,0,0,0,0,0,0,0,0,0,0,0,0,0,0,0
ACSSF,2010e5,wv,000,0034,0001834,080,54,041,08000US540419148099999967300,"Census Tract 9673 (part), Remainder of Hackers Creek-Skin Creek district, Hackers Creek-Skin Creek district, Lewis County, West Virginia",882,765,249,21,77,151,516,117,37,0,0,0,0,37,80,42,13,29,0,38
ACSSF,2010e5,wv,000,0034,0001835,080,54,041,08000US540419148099999967400,"Census Tract 9674 (part), Remainder of Hackers Creek-Skin Creek district, Hackers Creek-Skin Creek district, Lewis County, West Virginia",131,77,9,0,0,9,68,54,19,19,19,0,0,0,35,35,35,0,0,0
ACSSF,2010e5,wv,000,0034,0001836,080,54,041,08000US540419148099999967600,"Census Tract 9676 (part), Remainder of Hackers Creek-Skin Creek district, Hackers Creek-Skin Creek district, Lewis County, West Virginia",129,106,53,13,18,22,53,23,23,0,0,0,0,23,0,0,0,0,0,0
ACSSF,2010e5,wv,000,0034,0001837,080,54,043,08000US540439038434516955500,"Census Tract 9555 (part), Hamlin town, Carroll district, Lincoln County, West Virginia",312,178,70,25,13,32,108,134,29,19,8,0,11,10,105,62,22,3,37,43
ACSSF,2010e5,wv,000,0034,0001838,080,54,043,08000US540439038499999955500,"Census Tract 9555 (part), Remainder of Carroll district, Carroll district, Lincoln County, West Virginia",780,631,205,24,20,161,426,149,56,34,0,0,34,22,93,93,7,25,61,0
ACSSF,2010e5,wv,000,0034,0001839,080,54,043,08000US540439096099999955400,"Census Tract 9554 (part), Duval district, Duval district, Lincoln County, West Virginia",1192,1013,485,127,55,303,528,179,37,0,0,0,0,37,142,110,16,74,20,32
ACSSF,2010e5,wv,000,0034,0001840,080,54,043,08000US540439157235596955700,"Census Tract 9557 (part), Harts CDP, Harts Creek district, Lincoln County, West Virginia",309,186,59,13,17,29,127,123,16,0,0,0,0,16,107,74,9,0,65,33
ACSSF,2010e5,wv,000,0034,0001841,080,54,043,08000US540439157299999955700,"Census Tract 9557 (part), Remainder of Harts Creek district, Harts Creek district, Lincoln County, West Virginia",638,493,145,6,0,139,348,145,37,16,16,0,0,21,108,49,15,23,11,59
ACSSF,2010e5,wv,000,0034,0001842,080,54,043,08000US540439157299999955800,"Census Tract 9558 (part), Remainder of Harts Creek district, Harts Creek district, Lincoln County, West Virginia",156,99,77,29,11,37,22,57,0,0,0,0,0,0,57,0,0,0,0,57
ACSSF,2010e5,wv,000,0034,0001843,080,54,043,08000US540439170499999955800,"Census Tract 9558 (part), Jefferson district, Jefferson district, Lincoln County, West Virginia",350,286,163,56,20,87,123,64,20,0,0,0,0,20,44,28,0,0,28,16
ACSSF,2010e5,wv,000,0034,0001844,080,54,043,08000US540439181299999955600,"Census Tract 9556 (part), Laurel Hill district, Laurel Hill district, Lincoln County, West Virginia",403,285,132,70,0,62,153,118,64,54,0,38,16,10,54,26,0,0,26,28
ACSSF,2010e5,wv,000,0034,0001845,080,54,043,08000US540439181299999955700,"Census Tract 9557 (part), Laurel Hill district, Laurel Hill district, Lincoln County, West Virginia",53,36,0,0,0,0,36,17,17,0,0,0,0,17,0,0,0,0,0,0
ACSSF,2010e5,wv,000,0034,0001846,080,54,043,08000US540439181299999955800,"Census Tract 9558 (part), Laurel Hill district, Laurel Hill district, Lincoln County, West Virginia",214,181,109,48,25,36,72,33,15,0,0,0,0,15,18,18,18,0,0,0
ACSSF,2010e5,wv,000,0034,0001847,080,54,043,08000US540439278485804955600,"Census Tract 9556 (part), West Hamlin town, Sheridan district, Lincoln County, West Virginia",207,131,41,9,0,32,90,76,10,5,0,0,5,5,66,29,6,0,23,37
ACSSF,2010e5,wv,000,0034,0001848,080,54,043,08000US540439278499999955600,"Census Tract 9556 (part), Remainder of Sheridan district, Sheridan district, Lincoln County, West Virginia",922,684,218,31,44,143,466,238,92,31,0,0,31,61,146,82,42,0,40,64
ACSSF,2010e5,wv,000,0034,0001849,080,54,043,08000US540439278499999955800,"Census Tract 9558 (part), Remainder of Sheridan district, Sheridan district, Lincoln County, West Virginia",221,102,20,0,8,12,82,119,71,42,25,0,17,29,48,31,30,0,1,17
ACSSF,2010e5,wv,000,0034,0001850,080,54,043,08000US540439324099999955800,"Census Tract 9558 (part), Union district, Union district, Lincoln County, West Virginia",65,52,0,0,0,0,52,13,0,0,0,0,0,0,13,13,0,0,13,0
ACSSF,2010e5,wv,000,0034,0001851,080,54,043,08000US540439351601396955400,"Census Tract 9554 (part), Alum Creek CDP (part), Washington district, Lincoln County, West Virginia",274,204,115,37,0,78,89,70,0,0,0,0,0,0,70,13,0,13,0,57
ACSSF,2010e5,wv,000,0034,0001852,080,54,043,08000US540439351699999955400,"Census Tract 9554 (part), Remainder of Washington district, Washington district, Lincoln County, West Virginia",456,380,183,96,20,67,197,76,0,0,0,0,0,0,76,0,0,0,0,76
ACSSF,2010e5,wv,000,0034,0001853,080,54,045,08000US540459045336484956800,"Census Tract 9568 (part), Henlawson CDP, Central district, Logan County, West Virginia",154,114,0,0,0,0,114,40,19,0,0,0,0,19,21,0,0,0,0,21
ACSSF,2010e5,wv,000,0034,0001854,080,54,045,08000US540459045348148956200,"Census Tract 9562 (part), Logan city, Central district, Logan County, West Virginia",0,0,0,0,0,0,0,0,0,0,0,0,0,0,0,0,0,0,0,0
ACSSF,2010e5,wv,000,0034,0001855,080,54,045,08000US540459045348148956600,"Census Tract 9566 (part), Logan city, Central district, Logan County, West Virginia",75,53,24,0,10,14,29,22,6,6,0,0,6,0,16,2,0,0,2,14
ACSSF,2010e5,wv,000,0034,0001856,080,54,045,08000US540459045348148956900,"Census Tract 9569 (part), Logan city, Central district, Logan County, West Virginia",301,191,78,26,22,30,113,110,18,12,8,0,4,6,92,41,8,10,23,51
ACSSF,2010e5,wv,000,0034,0001857,080,54,045,08000US540459045349732956400,"Census Tract 9564 (part), McConnell CDP, Central district, Logan County, West Virginia",207,159,45,0,45,0,114,48,0,0,0,0,0,0,48,12,0,0,12,36
ACSSF,2010e5,wv,000,0034,0001858,080,54,045,08000US540459045354892956101,"Census Tract 9561.01 (part), Mitchell Heights town, Central district, Logan County, West Virginia",116,102,32,4,13,15,70,14,2,2,0,0,2,0,12,4,0,0,4,8
ACSSF,2010e5,wv,000,0034,0001859,080,54,045,08000US540459045356342956101,"Census Tract 9561.01 (part), Mount Gay-Shamrock CDP (part), Central district, Logan County, West Virginia",0,0,0,0,0,0,0,0,0,0,0,0,0,0,0,0,0,0,0,0
ACSSF,2010e5,wv,000,0034,0001860,080,54,045,08000US540459045356342956200,"Census Tract 9562 (part), Mount Gay-Shamrock CDP (part), Central district, Logan County, West Virginia",366,298,96,15,18,63,202,68,46,12,0,0,12,34,22,0,0,0,0,22
ACSSF,2010e5,wv,000,0034,0001861,080,54,045,08000US540459045356342956600,"Census Tract 9566 (part), Mount Gay-Shamrock CDP (part), Central district, Logan County, West Virginia",0,0,0,0,0,0,0,0,0,0,0,0,0,0,0,0,0,0,0,0
ACSSF,2010e5,wv,000,0034,0001862,080,54,045,08000US540459045356342956700,"Census Tract 9567 (part), Mount Gay-Shamrock CDP (part), Central district, Logan County, West Virginia",93,46,0,0,0,0,46,47,0,0,0,0,0,0,47,15,15,0,0,32
ACSSF,2010e5,wv,000,0034,0001863,080,54,045,08000US540459045357916956400,"Census Tract 9564 (part), Neibert CDP, Central district, Logan County, West Virginia",47,47,12,0,0,12,35,0,0,0,0,0,0,0,0,0,0,0,0,0
ACSSF,2010e5,wv,000,0034,0001864,080,54,045,08000US540459045376996956900,"Census Tract 9569 (part), Stollings CDP, Central district, Logan County, West Virginia",157,123,15,0,15,0,108,34,18,0,0,0,0,18,16,0,0,0,0,16
ACSSF,2010e5,wv,000,0034,0001865,080,54,045,08000US540459045383332956101,"Census Tract 9561.01 (part), Verdunville CDP (part), Central district, Logan County, West Virginia",0,0,0,0,0,0,0,0,0,0,0,0,0,0,0,0,0,0,0,0
ACSSF,2010e5,wv,000,0034,0001866,080,54,045,08000US540459045383332956200,"Census Tract 9562 (part), Verdunville CDP (part), Central district, Logan County, West Virginia",48,48,18,0,0,18,30,0,0,0,0,0,0,0,0,0,0,0,0,0
ACSSF,2010e5,wv,000,0034,0001867,080,54,045,08000US540459045385900956200,"Census Tract 9562 (part), West Logan town, Central district, Logan County, West Virginia",124,89,34,12,5,17,55,35,6,3,0,0,3,3,29,15,0,0,15,14
ACSSF,2010e5,wv,000,0034,0001868,080,54,045,08000US540459045399999956101,"Census Tract 9561.01 (part), Remainder of Central district, Central district, Logan County, West Virginia",438,306,45,0,0,45,261,132,67,67,67,0,0,0,65,65,0,49,16,0
ACSSF,2010e5,wv,000,0034,0001869,080,54,045,08000US540459045399999956200,"Census Tract 9562 (part), Remainder of Central district, Central district, Logan County, West Virginia",78,0,0,0,0,0,0,78,11,0,0,0,0,11,67,39,0,0,39,28
ACSSF,2010e5,wv,000,0034,0001870,080,54,045,08000US540459045399999956400,"Census Tract 9564 (part), Remainder of Central district, Central district, Logan County, West Virginia",72,57,33,0,16,17,24,15,15,15,15,0,0,0,0,0,0,0,0,0
ACSSF,2010e5,wv,000,0034,0001871,080,54,045,08000US540459045399999956600,"Census Tract 9566 (part), Remainder of Central district, Central district, Logan County, West Virginia",175,110,21,0,0,21,89,65,41,20,0,0,20,21,24,0,0,0,0,24
ACSSF,2010e5,wv,000,0034,0001872,080,54,045,08000US540459045399999956700,"Census Tract 9567 (part), Remainder of Central district, Central district, Logan County, West Virginia",259,220,96,15,28,53,124,39,16,0,0,0,0,16,23,0,0,0,0,23
ACSSF,2010e5,wv,000,0034,0001873,080,54,045,08000US540459045399999956800,"Census Tract 9568 (part), Remainder of Central district, Central district, Logan County, West Virginia",429,296,150,0,8,142,146,133,34,31,0,0,31,3,99,41,0,0,41,58
ACSSF,2010e5,wv,000,0034,0001874,080,54,045,08000US540459045399999956900,"Census Tract 9569 (part), Remainder of Central district, Central district, Logan County, West Virginia",214,171,132,77,22,33,39,43,0,0,0,0,0,0,43,21,0,0,21,22
ACSSF,2010e5,wv,000,0034,0001875,080,54,045,08000US540459097900196956400,"Census Tract 9564 (part), Accoville CDP, Eastern district, Logan County, West Virginia",70,59,13,0,0,13,46,11,0,0,0,0,0,0,11,0,0,0,0,11
ACSSF,2010e5,wv,000,0034,0001876,080,54,045,08000US540459097900196956500,"Census Tract 9565 (part), Accoville CDP, Eastern district, Logan County, West Virginia",104,90,52,17,0,35,38,14,0,0,0,0,0,0,14,0,0,0,0,14
ACSSF,2010e5,wv,000,0034,0001877,080,54,045,08000US540459097901660956400,"Census Tract 9564 (part), Amherstdale CDP, Eastern district, Logan County, West Virginia",101,40,15,0,0,15,25,61,37,0,0,0,0,37,24,24,24,0,0,0
ACSSF,2010e5,wv,000,0034,0001878,080,54,045,08000US540459097901660956500,"Census Tract 9565 (part), Amherstdale CDP, Eastern district, Logan County, West Virginia",0,0,0,0,0,0,0,0,0,0,0,0,0,0,0,0,0,0,0,0
ACSSF,2010e5,wv,000,0034,0001879,080,54,045,08000US540459097907228956102,"Census Tract 9561.02 (part), Big Creek CDP, Eastern district, Logan County, West Virginia",58,25,0,0,0,0,25,33,0,0,0,0,0,0,33,0,0,0,0,33
ACSSF,2010e5,wv,000,0034,0001880,080,54,045,08000US540459097910876956600,"Census Tract 9566 (part), Bruno CDP, Eastern district, Logan County, West Virginia",145,126,19,19,0,0,107,19,0,0,0,0,0,0,19,0,0,0,0,19
ACSSF,2010e5,wv,000,0034,0001881,080,54,045,08000US540459097914524956101,"Census Tract 9561.01 (part), Chapmanville town (part), Eastern district, Logan County, West Virginia",0,0,0,0,0,0,0,0,0,0,0,0,0,0,0,0,0,0,0,0
ACSSF,2010e5,wv,000,0034,0001882,080,54,045,08000US540459097914524956102,"Census Tract 9561.02 (part), Chapmanville town (part), Eastern district, Logan County, West Virginia",411,323,137,27,32,78,186,88,0,0,0,0,0,0,88,43,13,0,30,45
ACSSF,2010e5,wv,000,0034,0001883,080,54,045,08000US540459097944188956400,"Census Tract 9564 (part), Kistler CDP, Eastern district, Logan County, West Virginia",116,45,0,0,0,0,45,71,0,0,0,0,0,0,71,40,0,0,40,31
ACSSF,2010e5,wv,000,0034,0001884,080,54,045,08000US540459097950860956500,"Census Tract 9565 (part), Mallory CDP, Eastern district, Logan County, West Virginia",245,209,45,17,0,28,164,36,20,0,0,0,0,20,16,0,0,0,0,16
ACSSF,2010e5,wv,000,0034,0001885,080,54,045,08000US540459097950860956600,"Census Tract 9566 (part), Mallory CDP, Eastern district, Logan County, West Virginia",237,237,57,0,0,57,180,0,0,0,0,0,0,0,0,0,0,0,0,0
ACSSF,2010e5,wv,000,0034,0001886,080,54,045,08000US540459097950932956400,"Census Tract 9564 (part), Man town (part), Eastern district, Logan County, West Virginia",88,74,30,7,8,15,44,14,5,5,5,0,0,0,9,3,0,0,3,6
ACSSF,2010e5,wv,000,0034,0001887,080,54,045,08000US540459097950932956500,"Census Tract 9565 (part), Man town (part), Eastern district, Logan County, West Virginia",6,6,0,0,0,0,6,0,0,0,0,0,0,0,0,0,0,0,0,0
ACSSF,2010e5,wv,000,0034,0001888,080,54,045,08000US540459097950932956600,"Census Tract 9566 (part), Man town (part), Eastern district, Logan County, West Virginia",199,158,53,13,7,33,105,41,8,0,0,0,0,8,33,0,0,0,0,33
ACSSF,2010e5,wv,000,0034,0001889,080,54,045,08000US540459097969100956400,"Census Tract 9564 (part), Robinette CDP, Eastern district, Logan County, West Virginia",118,90,12,0,0,12,78,28,16,0,0,0,0,16,12,12,0,0,12,0
ACSSF,2010e5,wv,000,0034,0001890,080,54,045,08000US540459097969100956500,"Census Tract 9565 (part), Robinette CDP, Eastern district, Logan County, West Virginia",0,0,0,0,0,0,0,0,0,0,0,0,0,0,0,0,0,0,0,0
ACSSF,2010e5,wv,000,0034,0001891,080,54,045,08000US540459097999999956101,"Census Tract 9561.01 (part), Remainder of Eastern district, Eastern district, Logan County, West Virginia",69,18,0,0,0,0,18,51,0,0,0,0,0,0,51,0,0,0,0,51
ACSSF,2010e5,wv,000,0034,0001892,080,54,045,08000US540459097999999956102,"Census Tract 9561.02 (part), Remainder of Eastern district, Eastern district, Logan County, West Virginia",479,353,62,0,17,45,291,126,0,0,0,0,0,0,126,28,15,0,13,98
ACSSF,2010e5,wv,000,0034,0001893,080,54,045,08000US540459097999999956400,"Census Tract 9564 (part), Remainder of Eastern district, Eastern district, Logan County, West Virginia",177,162,86,50,19,17,76,15,0,0,0,0,0,0,15,0,0,0,0,15
ACSSF,2010e5,wv,000,0034,0001894,080,54,045,08000US540459097999999956500,"Census Tract 9565 (part), Remainder of Eastern district, Eastern district, Logan County, West Virginia",285,212,83,29,0,54,129,73,17,17,0,0,17,0,56,56,41,0,15,0
ACSSF,2010e5,wv,000,0034,0001895,080,54,045,08000US540459097999999956600,"Census Tract 9566 (part), Remainder of Eastern district, Eastern district, Logan County, West Virginia",162,120,57,0,0,57,63,42,0,0,0,0,0,0,42,0,0,0,0,42
ACSSF,2010e5,wv,000,0034,0001896,080,54,045,08000US540459097999999956800,"Census Tract 9568 (part), Remainder of Eastern district, Eastern district, Logan County, West Virginia",840,649,327,77,98,152,322,191,84,44,0,0,44,40,107,0,0,0,0,107
ACSSF,2010e5,wv,000,0034,0001897,080,54,045,08000US540459360814524956101,"Census Tract 9561.01 (part), Chapmanville town (part), Western district, Logan County, West Virginia",0,0,0,0,0,0,0,0,0,0,0,0,0,0,0,0,0,0,0,0
ACSSF,2010e5,wv,000,0034,0001898,080,54,045,08000US540459360814716956600,"Census Tract 9566 (part), Chauncey CDP, Western district, Logan County, West Virginia",177,157,59,20,20,19,98,20,0,0,0,0,0,0,20,0,0,0,0,20
ACSSF,2010e5,wv,000,0034,0001899,080,54,045,08000US540459360814716956700,"Census Tract 9567 (part), Chauncey CDP, Western district, Logan County, West Virginia",0,0,0,0,0,0,0,0,0,0,0,0,0,0,0,0,0,0,0,0
ACSSF,2010e5,wv,000,0034,0001900,080,54,045,08000US540459360837948956200,"Census Tract 9562 (part), Holden CDP, Western district, Logan County, West Virginia",185,121,97,47,21,29,24,64,0,0,0,0,0,0,64,27,0,0,27,37
ACSSF,2010e5,wv,000,0034,0001901,080,54,045,08000US540459360850932956400,"Census Tract 9564 (part), Man town (part), Western district, Logan County, West Virginia",47,28,0,0,0,0,28,19,19,19,0,0,19,0,0,0,0,0,0,0
ACSSF,2010e5,wv,000,0034,0001902,080,54,045,08000US540459360850932956500,"Census Tract 9565 (part), Man town (part), Western district, Logan County, West Virginia",0,0,0,0,0,0,0,0,0,0,0,0,0,0,0,0,0,0,0,0
ACSSF,2010e5,wv,000,0034,0001903,080,54,045,08000US540459360850932956600,"Census Tract 9566 (part), Man town (part), Western district, Logan County, West Virginia",0,0,0,0,0,0,0,0,0,0,0,0,0,0,0,0,0,0,0,0
ACSSF,2010e5,wv,000,0034,0001904,080,54,045,08000US540459360855132956600,"Census Tract 9566 (part), Monaville CDP, Western district, Logan County, West Virginia",0,0,0,0,0,0,0,0,0,0,0,0,0,0,0,0,0,0,0,0
ACSSF,2010e5,wv,000,0034,0001905,080,54,045,08000US540459360855132956700,"Census Tract 9567 (part), Monaville CDP, Western district, Logan County, West Virginia",104,104,39,9,0,30,65,0,0,0,0,0,0,0,0,0,0,0,0,0
ACSSF,2010e5,wv,000,0034,0001906,080,54,045,08000US540459360856342956200,"Census Tract 9562 (part), Mount Gay-Shamrock CDP (part), Western district, Logan County, West Virginia",0,0,0,0,0,0,0,0,0,0,0,0,0,0,0,0,0,0,0,0
ACSSF,2010e5,wv,000,0034,0001907,080,54,045,08000US540459360860628956600,"Census Tract 9566 (part), Omar CDP, Western district, Logan County, West Virginia",177,136,40,0,20,20,96,41,0,0,0,0,0,0,41,0,0,0,0,41
ACSSF,2010e5,wv,000,0034,0001908,080,54,045,08000US540459360860628956700,"Census Tract 9567 (part), Omar CDP, Western district, Logan County, West Virginia",47,27,14,0,0,14,13,20,0,0,0,0,0,0,20,0,0,0,0,20
ACSSF,2010e5,wv,000,0034,0001909,080,54,045,08000US540459360870468956700,"Census Tract 9567 (part), Rossmore CDP, Western district, Logan County, West Virginia",68,9,0,0,0,0,9,59,17,0,0,0,0,17,42,16,0,16,0,26
ACSSF,2010e5,wv,000,0034,0001910,080,54,045,08000US540459360872004956600,"Census Tract 9566 (part), Sarah Ann CDP, Western district, Logan County, West Virginia",32,19,19,0,0,19,0,13,0,0,0,0,0,0,13,0,0,0,0,13
ACSSF,2010e5,wv,000,0034,0001911,080,54,045,08000US540459360872004956700,"Census Tract 9567 (part), Sarah Ann CDP, Western district, Logan County, West Virginia",0,0,0,0,0,0,0,0,0,0,0,0,0,0,0,0,0,0,0,0
ACSSF,2010e5,wv,000,0034,0001912,080,54,045,08000US540459360878796956600,"Census Tract 9566 (part), Switzer CDP, Western district, Logan County, West Virginia",193,118,0,0,0,0,118,75,0,0,0,0,0,0,75,23,23,0,0,52
ACSSF,2010e5,wv,000,0034,0001913,080,54,045,08000US540459360878796956700,"Census Tract 9567 (part), Switzer CDP, Western district, Logan County, West Virginia",83,76,42,13,15,14,34,7,0,0,0,0,0,0,7,0,0,0,0,7
ACSSF,2010e5,wv,000,0034,0001914,080,54,045,08000US540459360883332956101,"Census Tract 9561.01 (part), Verdunville CDP (part), Western district, Logan County, West Virginia",64,64,24,0,0,24,40,0,0,0,0,0,0,0,0,0,0,0,0,0
ACSSF,2010e5,wv,000,0034,0001915,080,54,045,08000US540459360883332956200,"Census Tract 9562 (part), Verdunville CDP (part), Western district, Logan County, West Virginia",15,15,15,0,0,15,0,0,0,0,0,0,0,0,0,0,0,0,0,0
ACSSF,2010e5,wv,000,0034,0001916,080,54,045,08000US540459360899999956101,"Census Tract 9561.01 (part), Remainder of Western district, Western district, Logan County, West Virginia",1142,895,335,6,79,250,560,247,51,22,0,0,22,29,196,63,0,0,63,133
ACSSF,2010e5,wv,000,0034,0001917,080,54,045,08000US540459360899999956200,"Census Tract 9562 (part), Remainder of Western district, Western district, Logan County, West Virginia",118,102,32,0,16,16,70,16,0,0,0,0,0,0,16,16,0,16,0,0
ACSSF,2010e5,wv,000,0034,0001918,080,54,045,08000US540459360899999956400,"Census Tract 9564 (part), Remainder of Western district, Western district, Logan County, West Virginia",48,48,0,0,0,0,48,0,0,0,0,0,0,0,0,0,0,0,0,0
ACSSF,2010e5,wv,000,0034,0001919,080,54,045,08000US540459360899999956500,"Census Tract 9565 (part), Remainder of Western district, Western district, Logan County, West Virginia",0,0,0,0,0,0,0,0,0,0,0,0,0,0,0,0,0,0,0,0
ACSSF,2010e5,wv,000,0034,0001920,080,54,045,08000US540459360899999956600,"Census Tract 9566 (part), Remainder of Western district, Western district, Logan County, West Virginia",172,130,0,0,0,0,130,42,0,0,0,0,0,0,42,22,0,0,22,20
ACSSF,2010e5,wv,000,0034,0001921,080,54,045,08000US540459360899999956700,"Census Tract 9567 (part), Remainder of Western district, Western district, Logan County, West Virginia",579,378,205,0,58,147,173,201,45,32,32,0,0,13,156,64,37,14,13,92
ACSSF,2010e5,wv,000,0034,0001922,080,54,047,08000US540479016804732954504,"Census Tract 9545.04 (part), Bartley CDP, Big Creek district, McDowell County, West Virginia",21,21,0,0,0,0,21,0,0,0,0,0,0,0,0,0,0,0,0,0
ACSSF,2010e5,wv,000,0034,0001923,080,54,047,08000US540479016806748954200,"Census Tract 9542 (part), Berwind CDP, Big Creek district, McDowell County, West Virginia",54,25,0,0,0,0,25,29,12,0,0,0,0,12,17,17,0,0,17,0
ACSSF,2010e5,wv,000,0034,0001924,080,54,047,08000US540479016819492954200,"Census Tract 9542 (part), Cucumber CDP, Big Creek district, McDowell County, West Virginia",35,19,6,6,0,0,13,16,0,0,0,0,0,0,16,16,0,0,16,0
ACSSF,2010e5,wv,000,0034,0001925,080,54,047,08000US540479016867228954000,"Census Tract 9540 (part), Raysal CDP (part), Big Creek district, McDowell County, West Virginia",0,0,0,0,0,0,0,0,0,0,0,0,0,0,0,0,0,0,0,0
ACSSF,2010e5,wv,000,0034,0001926,080,54,047,08000US540479016867228954504,"Census Tract 9545.04 (part), Raysal CDP (part), Big Creek district, McDowell County, West Virginia",0,0,0,0,0,0,0,0,0,0,0,0,0,0,0,0,0,0,0,0
ACSSF,2010e5,wv,000,0034,0001927,080,54,047,08000US540479016884484954200,"Census Tract 9542 (part), War city, Big Creek district, McDowell County, West Virginia",93,49,12,3,0,9,37,44,8,8,0,0,8,0,36,20,0,4,16,16
ACSSF,2010e5,wv,000,0034,0001928,080,54,047,08000US540479016884484954504,"Census Tract 9545.04 (part), War city, Big Creek district, McDowell County, West Virginia",119,97,35,16,3,16,62,22,11,11,0,0,11,0,11,0,0,0,0,11
ACSSF,2010e5,wv,000,0034,0001929,080,54,047,08000US540479016899999953800,"Census Tract 9538 (part), Remainder of Big Creek district, Big Creek district, McDowell County, West Virginia",64,38,13,0,0,13,25,26,0,0,0,0,0,0,26,19,0,0,19,7
ACSSF,2010e5,wv,000,0034,0001930,080,54,047,08000US540479016899999953900,"Census Tract 9539 (part), Remainder of Big Creek district, Big Creek district, McDowell County, West Virginia",64,64,32,12,0,20,32,0,0,0,0,0,0,0,0,0,0,0,0,0
ACSSF,2010e5,wv,000,0034,0001931,080,54,047,08000US540479016899999954000,"Census Tract 9540 (part), Remainder of Big Creek district, Big Creek district, McDowell County, West Virginia",0,0,0,0,0,0,0,0,0,0,0,0,0,0,0,0,0,0,0,0
ACSSF,2010e5,wv,000,0034,0001932,080,54,047,08000US540479016899999954200,"Census Tract 9542 (part), Remainder of Big Creek district, Big Creek district, McDowell County, West Virginia",242,188,44,6,9,29,144,54,15,0,0,0,0,15,39,28,0,17,11,11
ACSSF,2010e5,wv,000,0034,0001933,080,54,047,08000US540479016899999954501,"Census Tract 9545.01 (part), Remainder of Big Creek district, Big Creek district, McDowell County, West Virginia",0,0,0,0,0,0,0,0,0,0,0,0,0,0,0,0,0,0,0,0
ACSSF,2010e5,wv,000,0034,0001934,080,54,047,08000US540479016899999954504,"Census Tract 9545.04 (part), Remainder of Big Creek district, Big Creek district, McDowell County, West Virginia",734,527,73,0,27,46,454,207,57,20,0,20,0,37,150,107,16,25,66,43
ACSSF,2010e5,wv,000,0034,0001935,080,54,047,08000US540479024007516953800,"Census Tract 9538 (part), Big Sandy CDP, Browns Creek district, McDowell County, West Virginia",63,63,33,19,0,14,30,0,0,0,0,0,0,0,0,0,0,0,0,0
ACSSF,2010e5,wv,000,0034,0001936,080,54,047,08000US540479024020500953800,"Census Tract 9538 (part), Davy town, Browns Creek district, McDowell County, West Virginia",94,84,7,7,0,0,77,10,0,0,0,0,0,0,10,0,0,0,0,10
ACSSF,2010e5,wv,000,0034,0001937,080,54,047,08000US540479024043780954503,"Census Tract 9545.03 (part), Kimball town, Browns Creek district, McDowell County, West Virginia",72,50,9,0,0,9,41,22,2,2,2,0,0,0,20,4,0,4,0,16
ACSSF,2010e5,wv,000,0034,0001938,080,54,047,08000US540479024069844953800,"Census Tract 9538 (part), Roderfield CDP (part), Browns Creek district, McDowell County, West Virginia",0,0,0,0,0,0,0,0,0,0,0,0,0,0,0,0,0,0,0,0
ACSSF,2010e5,wv,000,0034,0001939,080,54,047,08000US540479024083764954503,"Census Tract 9545.03 (part), Vivian CDP, Browns Creek district, McDowell County, West Virginia",17,17,0,0,0,0,17,0,0,0,0,0,0,0,0,0,0,0,0,0
ACSSF,2010e5,wv,000,0034,0001940,080,54,047,08000US540479024085228953800,"Census Tract 9538 (part), Welch city (part), Browns Creek district, McDowell County, West Virginia",131,96,8,0,0,8,88,35,11,0,0,0,0,11,24,11,0,0,11,13
ACSSF,2010e5,wv,000,0034,0001941,080,54,047,08000US540479024085228954503,"Census Tract 9545.03 (part), Welch city (part), Browns Creek district, McDowell County, West Virginia",318,219,87,0,25,62,132,99,22,7,0,0,7,15,77,17,0,0,17,60
ACSSF,2010e5,wv,000,0034,0001942,080,54,047,08000US540479024085228954504,"Census Tract 9545.04 (part), Welch city (part), Browns Creek district, McDowell County, West Virginia",0,0,0,0,0,0,0,0,0,0,0,0,0,0,0,0,0,0,0,0
ACSSF,2010e5,wv,000,0034,0001943,080,54,047,08000US540479024099999953800,"Census Tract 9538 (part), Remainder of Browns Creek district, Browns Creek district, McDowell County, West Virginia",291,216,115,0,0,115,101,75,23,15,0,0,15,8,52,52,0,0,52,0
ACSSF,2010e5,wv,000,0034,0001944,080,54,047,08000US540479024099999954503,"Census Tract 9545.03 (part), Remainder of Browns Creek district, Browns Creek district, McDowell County, West Virginia",213,192,74,0,0,74,118,21,9,0,0,0,0,9,12,0,0,0,0,12
ACSSF,2010e5,wv,000,0034,0001945,080,54,047,08000US540479024099999954504,"Census Tract 9545.04 (part), Remainder of Browns Creek district, Browns Creek district, McDowell County, West Virginia",41,23,23,0,0,23,0,18,18,0,0,0,0,18,0,0,0,0,0,0
ACSSF,2010e5,wv,000,0034,0001946,080,54,047,08000US540479234501780954501,"Census Tract 9545.01 (part), Anawalt town, North Elkin district, McDowell County, West Virginia",77,60,12,0,0,12,48,17,6,4,0,0,4,2,11,5,0,5,0,6
ACSSF,2010e5,wv,000,0034,0001947,080,54,047,08000US540479234519324953600,"Census Tract 9536 (part), Crumpler CDP, North Elkin district, McDowell County, West Virginia",61,57,25,0,0,25,32,4,4,4,0,0,4,0,0,0,0,0,0,0
ACSSF,2010e5,wv,000,0034,0001948,080,54,047,08000US540479234530196954200,"Census Tract 9542 (part), Gary city, North Elkin district, McDowell County, West Virginia",0,0,0,0,0,0,0,0,0,0,0,0,0,0,0,0,0,0,0,0
ACSSF,2010e5,wv,000,0034,0001949,080,54,047,08000US540479234530196954501,"Census Tract 9545.01 (part), Gary city, North Elkin district, McDowell County, West Virginia",125,76,26,16,0,10,50,49,0,0,0,0,0,0,49,28,0,8,20,21
ACSSF,2010e5,wv,000,0034,0001950,080,54,047,08000US540479234530196954503,"Census Tract 9545.03 (part), Gary city, North Elkin district, McDowell County, West Virginia",101,65,4,4,0,0,61,36,0,0,0,0,0,0,36,7,0,7,0,29
ACSSF,2010e5,wv,000,0034,0001951,080,54,047,08000US540479234530196954504,"Census Tract 9545.04 (part), Gary city, North Elkin district, McDowell County, West Virginia",7,7,0,0,0,0,7,0,0,0,0,0,0,0,0,0,0,0,0,0
ACSSF,2010e5,wv,000,0034,0001952,080,54,047,08000US540479234543516954501,"Census Tract 9545.01 (part), Keystone city, North Elkin district, McDowell County, West Virginia",10,7,4,0,4,0,3,3,3,0,0,0,0,3,0,0,0,0,0,0
ACSSF,2010e5,wv,000,0034,0001953,080,54,047,08000US540479234543516954503,"Census Tract 9545.03 (part), Keystone city, North Elkin district, McDowell County, West Virginia",51,31,12,4,5,3,19,20,3,0,0,0,0,3,17,0,0,0,0,17
ACSSF,2010e5,wv,000,0034,0001954,080,54,047,08000US540479234552588953600,"Census Tract 9536 (part), Maybeury CDP, North Elkin district, McDowell County, West Virginia",55,55,29,0,14,15,26,0,0,0,0,0,0,0,0,0,0,0,0,0
ACSSF,2010e5,wv,000,0034,0001955,080,54,047,08000US540479234552588954501,"Census Tract 9545.01 (part), Maybeury CDP, North Elkin district, McDowell County, West Virginia",11,0,0,0,0,0,0,11,0,0,0,0,0,0,11,0,0,0,0,11
ACSSF,2010e5,wv,000,0034,0001956,080,54,047,08000US540479234559428953600,"Census Tract 9536 (part), Northfork town, North Elkin district, McDowell County, West Virginia",99,46,10,4,0,6,36,53,5,5,0,0,5,0,48,24,0,8,16,24
ACSSF,2010e5,wv,000,0034,0001957,080,54,047,08000US540479234559428954503,"Census Tract 9545.03 (part), Northfork town, North Elkin district, McDowell County, West Virginia",26,0,0,0,0,0,0,26,0,0,0,0,0,0,26,20,8,0,12,6
ACSSF,2010e5,wv,000,0034,0001958,080,54,047,08000US540479234561684954501,"Census Tract 9545.01 (part), Pageton CDP, North Elkin district, McDowell County, West Virginia",40,40,0,0,0,0,40,0,0,0,0,0,0,0,0,0,0,0,0,0
ACSSF,2010e5,wv,000,0034,0001959,080,54,047,08000US540479234585228954503,"Census Tract 9545.03 (part), Welch city (part), North Elkin district, McDowell County, West Virginia",0,0,0,0,0,0,0,0,0,0,0,0,0,0,0,0,0,0,0,0
ACSSF,2010e5,wv,000,0034,0001960,080,54,047,08000US540479234585228954504,"Census Tract 9545.04 (part), Welch city (part), North Elkin district, McDowell County, West Virginia",33,14,14,0,14,0,0,19,0,0,0,0,0,0,19,0,0,0,0,19
ACSSF,2010e5,wv,000,0034,0001961,080,54,047,08000US540479234599999953600,"Census Tract 9536 (part), Remainder of North Elkin district, North Elkin district, McDowell County, West Virginia",238,175,81,0,14,67,94,63,0,0,0,0,0,0,63,25,0,12,13,38
ACSSF,2010e5,wv,000,0034,0001962,080,54,047,08000US540479234599999954200,"Census Tract 9542 (part), Remainder of North Elkin district, North Elkin district, McDowell County, West Virginia",0,0,0,0,0,0,0,0,0,0,0,0,0,0,0,0,0,0,0,0
ACSSF,2010e5,wv,000,0034,0001963,080,54,047,08000US540479234599999954501,"Census Tract 9545.01 (part), Remainder of North Elkin district, North Elkin district, McDowell County, West Virginia",267,187,83,0,0,83,104,80,24,0,0,0,0,24,56,27,0,0,27,29
ACSSF,2010e5,wv,000,0034,0001964,080,54,047,08000US540479234599999954503,"Census Tract 9545.03 (part), Remainder of North Elkin district, North Elkin district, McDowell County, West Virginia",124,104,26,0,0,26,78,20,0,0,0,0,0,0,20,0,0,0,0,20
ACSSF,2010e5,wv,000,0034,0001965,080,54,047,08000US540479234599999954504,"Census Tract 9545.04 (part), Remainder of North Elkin district, North Elkin district, McDowell County, West Virginia",6,6,0,0,0,0,6,0,0,0,0,0,0,0,0,0,0,0,0,0
ACSSF,2010e5,wv,000,0034,0001966,080,54,047,08000US540479271209700954000,"Census Tract 9540 (part), Bradshaw town, Sandy River district, McDowell County, West Virginia",22,8,2,2,0,0,6,14,5,0,0,0,0,5,9,6,6,0,0,3
ACSSF,2010e5,wv,000,0034,0001967,080,54,047,08000US540479271209700954504,"Census Tract 9545.04 (part), Bradshaw town, Sandy River district, McDowell County, West Virginia",48,42,13,0,3,10,29,6,3,0,0,0,0,3,3,3,0,0,3,0
ACSSF,2010e5,wv,000,0034,0001968,080,54,047,08000US540479271239652953800,"Census Tract 9538 (part), Iaeger town, Sandy River district, McDowell County, West Virginia",15,12,3,0,0,3,9,3,0,0,0,0,0,0,3,3,0,0,3,0
ACSSF,2010e5,wv,000,0034,0001969,080,54,047,08000US540479271239652953900,"Census Tract 9539 (part), Iaeger town, Sandy River district, McDowell County, West Virginia",7,7,4,0,0,4,3,0,0,0,0,0,0,0,0,0,0,0,0,0
ACSSF,2010e5,wv,000,0034,0001970,080,54,047,08000US540479271239652954504,"Census Tract 9545.04 (part), Iaeger town, Sandy River district, McDowell County, West Virginia",55,55,15,2,2,11,40,0,0,0,0,0,0,0,0,0,0,0,0,0
ACSSF,2010e5,wv,000,0034,0001971,080,54,047,08000US540479271267228954000,"Census Tract 9540 (part), Raysal CDP (part), Sandy River district, McDowell County, West Virginia",18,18,0,0,0,0,18,0,0,0,0,0,0,0,0,0,0,0,0,0
ACSSF,2010e5,wv,000,0034,0001972,080,54,047,08000US540479271267228954504,"Census Tract 9545.04 (part), Raysal CDP (part), Sandy River district, McDowell County, West Virginia",51,51,0,0,0,0,51,0,0,0,0,0,0,0,0,0,0,0,0,0
ACSSF,2010e5,wv,000,0034,0001973,080,54,047,08000US540479271269844953800,"Census Tract 9538 (part), Roderfield CDP (part), Sandy River district, McDowell County, West Virginia",16,16,0,0,0,0,16,0,0,0,0,0,0,0,0,0,0,0,0,0
ACSSF,2010e5,wv,000,0034,0001974,080,54,047,08000US540479271299999953800,"Census Tract 9538 (part), Remainder of Sandy River district, Sandy River district, McDowell County, West Virginia",127,82,25,0,0,25,57,45,33,17,0,0,17,16,12,12,0,0,12,0
ACSSF,2010e5,wv,000,0034,0001975,080,54,047,08000US540479271299999953900,"Census Tract 9539 (part), Remainder of Sandy River district, Sandy River district, McDowell County, West Virginia",447,386,79,38,31,10,307,61,33,0,0,0,0,33,28,0,0,0,0,28
ACSSF,2010e5,wv,000,0034,0001976,080,54,047,08000US540479271299999954000,"Census Tract 9540 (part), Remainder of Sandy River district, Sandy River district, McDowell County, West Virginia",509,416,118,19,43,56,298,93,24,8,0,0,8,16,69,26,0,0,26,43
ACSSF,2010e5,wv,000,0034,0001977,080,54,047,08000US540479271299999954504,"Census Tract 9545.04 (part), Remainder of Sandy River district, Sandy River district, McDowell County, West Virginia",178,131,45,13,32,0,86,47,3,0,0,0,0,3,44,44,0,0,44,0
ACSSF,2010e5,wv,000,0034,0001978,080,54,049,08000US540499215404612020500,"Census Tract 205 (part), Barrackville town, Middletown district, Marion County, West Virginia",0,0,0,0,0,0,0,0,0,0,0,0,0,0,0,0,0,0,0,0
ACSSF,2010e5,wv,000,0034,0001979,080,54,049,08000US540499215404612020600,"Census Tract 206 (part), Barrackville town, Middletown district, Marion County, West Virginia",18,11,5,5,0,0,6,7,7,0,0,0,0,7,0,0,0,0,0,0
ACSSF,2010e5,wv,000,0034,0001980,080,54,049,08000US540499215404612021400,"Census Tract 214 (part), Barrackville town, Middletown district, Marion County, West Virginia",386,304,100,12,20,68,204,82,29,3,0,0,3,26,53,23,11,11,1,30
ACSSF,2010e5,wv,000,0034,0001981,080,54,049,08000US540499215426452020100,"Census Tract 201, Fairmont city (part), Middletown district, Marion County, West Virginia",178,73,16,7,0,9,57,105,19,19,0,0,19,0,86,52,52,0,0,34
ACSSF,2010e5,wv,000,0034,0001982,080,54,049,08000US540499215426452020200,"Census Tract 202 (part), Fairmont city (part), Middletown district, Marion County, West Virginia",378,188,53,0,19,34,135,190,14,8,8,0,0,6,176,120,62,51,7,56
ACSSF,2010e5,wv,000,0034,0001983,080,54,049,08000US540499215426452020300,"Census Tract 203 (part), Fairmont city (part), Middletown district, Marion County, West Virginia",881,735,204,64,19,121,531,146,95,63,0,0,63,32,51,20,0,0,20,31
ACSSF,2010e5,wv,000,0034,0001984,080,54,049,08000US540499215426452020400,"Census Tract 204 (part), Fairmont city (part), Middletown district, Marion County, West Virginia",154,110,24,0,0,24,86,44,18,18,0,0,18,0,26,0,0,0,0,26
ACSSF,2010e5,wv,000,0034,0001985,080,54,049,08000US540499215426452020500,"Census Tract 205 (part), Fairmont city (part), Middletown district, Marion County, West Virginia",511,272,143,51,35,57,129,239,0,0,0,0,0,0,239,122,73,26,23,117
ACSSF,2010e5,wv,000,0034,0001986,080,54,049,08000US540499215426452020600,"Census Tract 206 (part), Fairmont city (part), Middletown district, Marion County, West Virginia",397,246,79,16,0,63,167,151,48,10,10,0,0,38,103,66,0,0,66,37
ACSSF,2010e5,wv,000,0034,0001987,080,54,049,08000US540499215426452020700,"Census Tract 207 (part), Fairmont city (part), Middletown district, Marion County, West Virginia",9,9,0,0,0,0,9,0,0,0,0,0,0,0,0,0,0,0,0,0
ACSSF,2010e5,wv,000,0034,0001988,080,54,049,08000US540499215426452020800,"Census Tract 208 (part), Fairmont city (part), Middletown district, Marion County, West Virginia",470,346,95,9,12,74,251,124,9,9,0,0,9,0,115,36,0,0,36,79
ACSSF,2010e5,wv,000,0034,0001989,080,54,049,08000US540499215426452021200,"Census Tract 212 (part), Fairmont city (part), Middletown district, Marion County, West Virginia",0,0,0,0,0,0,0,0,0,0,0,0,0,0,0,0,0,0,0,0
ACSSF,2010e5,wv,000,0034,0001990,080,54,049,08000US540499215464228020200,"Census Tract 202 (part), Pleasant Valley city (part), Middletown district, Marion County, West Virginia",0,0,0,0,0,0,0,0,0,0,0,0,0,0,0,0,0,0,0,0
ACSSF,2010e5,wv,000,0034,0001991,080,54,049,08000US540499215499999020200,"Census Tract 202 (part), Remainder of Middletown district, Middletown district, Marion County, West Virginia",46,5,0,0,0,0,5,41,0,0,0,0,0,0,41,41,0,0,41,0
ACSSF,2010e5,wv,000,0034,0001992,080,54,049,08000US540499215499999020300,"Census Tract 203 (part), Remainder of Middletown district, Middletown district, Marion County, West Virginia",140,93,63,0,23,40,30,47,0,0,0,0,0,0,47,0,0,0,0,47
ACSSF,2010e5,wv,000,0034,0001993,080,54,049,08000US540499215499999020400,"Census Tract 204 (part), Remainder of Middletown district, Middletown district, Marion County, West Virginia",194,170,76,0,7,69,94,24,0,0,0,0,0,0,24,0,0,0,0,24
ACSSF,2010e5,wv,000,0034,0001994,080,54,049,08000US540499215499999020500,"Census Tract 205 (part), Remainder of Middletown district, Middletown district, Marion County, West Virginia",51,19,0,0,0,0,19,32,0,0,0,0,0,0,32,32,0,0,32,0
ACSSF,2010e5,wv,000,0034,0001995,080,54,049,08000US540499215499999020600,"Census Tract 206 (part), Remainder of Middletown district, Middletown district, Marion County, West Virginia",75,75,44,0,0,44,31,0,0,0,0,0,0,0,0,0,0,0,0,0
ACSSF,2010e5,wv,000,0034,0001996,080,54,049,08000US540499215499999020800,"Census Tract 208 (part), Remainder of Middletown district, Middletown district, Marion County, West Virginia",0,0,0,0,0,0,0,0,0,0,0,0,0,0,0,0,0,0,0,0
ACSSF,2010e5,wv,000,0034,0001997,080,54,049,08000US540499215499999021200,"Census Tract 212 (part), Remainder of Middletown district, Middletown district, Marion County, West Virginia",0,0,0,0,0,0,0,0,0,0,0,0,0,0,0,0,0,0,0,0
ACSSF,2010e5,wv,000,0034,0001998,080,54,049,08000US540499215499999021300,"Census Tract 213 (part), Remainder of Middletown district, Middletown district, Marion County, West Virginia",36,36,36,0,0,36,0,0,0,0,0,0,0,0,0,0,0,0,0,0
ACSSF,2010e5,wv,000,0034,0001999,080,54,049,08000US540499215499999021400,"Census Tract 214 (part), Remainder of Middletown district, Middletown district, Marion County, West Virginia",102,89,19,0,0,19,70,13,0,0,0,0,0,0,13,0,0,0,0,13
ACSSF,2010e5,wv,000,0034,0002000,080,54,049,08000US540499215499999021500,"Census Tract 215 (part), Remainder of Middletown district, Middletown district, Marion County, West Virginia",37,37,0,0,0,0,37,0,0,0,0,0,0,0,0,0,0,0,0,0
ACSSF,2010e5,wv,000,0034,0002001,080,54,049,08000US540499241826452020700,"Census Tract 207 (part), Fairmont city (part), Palatine district, Marion County, West Virginia",453,316,121,53,45,23,195,137,14,0,0,0,0,14,123,108,0,0,108,15
ACSSF,2010e5,wv,000,0034,0002002,080,54,049,08000US540499241826452020800,"Census Tract 208 (part), Fairmont city (part), Palatine district, Marion County, West Virginia",173,115,36,9,11,16,79,58,36,36,0,0,36,0,22,11,0,0,11,11
ACSSF,2010e5,wv,000,0034,0002003,080,54,049,08000US540499241826452020900,"Census Tract 209 (part), Fairmont city (part), Palatine district, Marion County, West Virginia",27,27,15,0,0,15,12,0,0,0,0,0,0,0,0,0,0,0,0,0
ACSSF,2010e5,wv,000,0034,0002004,080,54,049,08000US540499241826452021100,"Census Tract 211 (part), Fairmont city (part), Palatine district, Marion County, West Virginia",586,395,99,11,21,67,296,191,79,70,0,0,70,9,112,36,0,8,28,76
ACSSF,2010e5,wv,000,0034,0002005,080,54,049,08000US540499241826452021200,"Census Tract 212 (part), Fairmont city (part), Palatine district, Marion County, West Virginia",93,74,15,0,0,15,59,19,0,0,0,0,0,0,19,7,0,7,0,12
ACSSF,2010e5,wv,000,0034,0002006,080,54,049,08000US540499241864228020800,"Census Tract 208 (part), Pleasant Valley city (part), Palatine district, Marion County, West Virginia",50,25,0,0,0,0,25,25,16,16,0,0,16,0,9,0,0,0,0,9
ACSSF,2010e5,wv,000,0034,0002007,080,54,049,08000US540499241864228020900,"Census Tract 209 (part), Pleasant Valley city (part), Palatine district, Marion County, West Virginia",796,623,298,59,98,141,325,173,55,17,8,0,9,38,118,84,14,0,70,34
ACSSF,2010e5,wv,000,0034,0002008,080,54,049,08000US540499241886620021200,"Census Tract 212 (part), White Hall town, Palatine district, Marion County, West Virginia",151,128,46,26,6,14,82,23,3,0,0,0,0,3,20,6,3,0,3,14
ACSSF,2010e5,wv,000,0034,0002009,080,54,049,08000US540499241888708021200,"Census Tract 212 (part), Worthington town (part), Palatine district, Marion County, West Virginia",0,0,0,0,0,0,0,0,0,0,0,0,0,0,0,0,0,0,0,0
ACSSF,2010e5,wv,000,0034,0002010,080,54,049,08000US540499241899999020700,"Census Tract 207 (part), Remainder of Palatine district, Palatine district, Marion County, West Virginia",447,312,52,10,14,28,260,135,22,10,0,0,10,12,113,27,8,0,19,86
ACSSF,2010e5,wv,000,0034,0002011,080,54,049,08000US540499241899999020800,"Census Tract 208 (part), Remainder of Palatine district, Palatine district, Marion County, West Virginia",44,20,20,10,0,10,0,24,0,0,0,0,0,0,24,24,0,0,24,0
ACSSF,2010e5,wv,000,0034,0002012,080,54,049,08000US540499241899999020900,"Census Tract 209 (part), Remainder of Palatine district, Palatine district, Marion County, West Virginia",194,128,34,15,10,9,94,66,28,0,0,0,0,28,38,29,29,0,0,9
ACSSF,2010e5,wv,000,0034,0002013,080,54,049,08000US540499241899999021000,"Census Tract 210, Remainder of Palatine district, Palatine district, Marion County, West Virginia",1486,1244,479,94,77,308,765,242,56,0,0,0,0,56,186,71,15,0,56,115
ACSSF,2010e5,wv,000,0034,0002014,080,54,049,08000US540499241899999021100,"Census Tract 211 (part), Remainder of Palatine district, Palatine district, Marion County, West Virginia",130,118,41,10,22,9,77,12,0,0,0,0,0,0,12,0,0,0,0,12
ACSSF,2010e5,wv,000,0034,0002015,080,54,049,08000US540499241899999021200,"Census Tract 212 (part), Remainder of Palatine district, Palatine district, Marion County, West Virginia",1362,1025,455,140,15,300,570,337,127,78,0,0,78,49,210,138,0,22,116,72
ACSSF,2010e5,wv,000,0034,0002016,080,54,049,08000US540499241899999021300,"Census Tract 213 (part), Remainder of Palatine district, Palatine district, Marion County, West Virginia",0,0,0,0,0,0,0,0,0,0,0,0,0,0,0,0,0,0,0,0
ACSSF,2010e5,wv,000,0034,0002017,080,54,049,08000US540499359413468021300,"Census Tract 213 (part), Carolina CDP, West Augusta district, Marion County, West Virginia",110,93,70,9,17,44,23,17,17,0,0,0,0,17,0,0,0,0,0,0
ACSSF,2010e5,wv,000,0034,0002018,080,54,049,08000US540499359426524021600,"Census Tract 216 (part), Fairview town, West Augusta district, Marion County, West Virginia",110,85,41,5,6,30,44,25,9,5,5,0,0,4,16,10,2,0,8,6
ACSSF,2010e5,wv,000,0034,0002019,080,54,049,08000US540499359426932021300,"Census Tract 213 (part), Farmington town, West Augusta district, Marion County, West Virginia",15,13,0,0,0,0,13,2,2,0,0,0,0,2,0,0,0,0,0,0
ACSSF,2010e5,wv,000,0034,0002020,080,54,049,08000US540499359426932021600,"Census Tract 216 (part), Farmington town, West Augusta district, Marion County, West Virginia",77,51,18,8,2,8,33,26,0,0,0,0,0,0,26,10,0,0,10,16
ACSSF,2010e5,wv,000,0034,0002021,080,54,049,08000US540499359432908021500,"Census Tract 215 (part), Grant Town town, West Augusta district, Marion County, West Virginia",135,88,38,14,3,21,50,47,19,0,0,0,0,19,28,12,0,0,12,16
ACSSF,2010e5,wv,000,0034,0002022,080,54,049,08000US540499359439676021300,"Census Tract 213 (part), Idamay CDP, West Augusta district, Marion County, West Virginia",165,151,35,35,0,0,116,14,0,0,0,0,0,0,14,0,0,0,0,14
ACSSF,2010e5,wv,000,0034,0002023,080,54,049,08000US540499359451100021600,"Census Tract 216 (part), Mannington city, West Augusta district, Marion County, West Virginia",168,103,48,8,15,25,55,65,58,29,0,29,0,29,7,0,0,0,0,7
ACSSF,2010e5,wv,000,0034,0002024,080,54,049,08000US540499359451100021700,"Census Tract 217 (part), Mannington city, West Augusta district, Marion County, West Virginia",456,352,166,21,33,112,186,104,2,0,0,0,0,2,102,64,21,12,31,38
ACSSF,2010e5,wv,000,0034,0002025,080,54,049,08000US540499359451100021800,"Census Tract 218 (part), Mannington city, West Augusta district, Marion County, West Virginia",0,0,0,0,0,0,0,0,0,0,0,0,0,0,0,0,0,0,0,0
ACSSF,2010e5,wv,000,0034,0002026,080,54,049,08000US540499359455276021200,"Census Tract 212 (part), Monongah town, West Augusta district, Marion County, West Virginia",169,133,67,14,2,51,66,36,8,0,0,0,0,8,28,17,0,3,14,11
ACSSF,2010e5,wv,000,0034,0002027,080,54,049,08000US540499359455276021300,"Census Tract 213 (part), Monongah town, West Augusta district, Marion County, West Virginia",204,112,51,2,2,47,61,92,12,0,0,0,0,12,80,65,26,10,29,15
ACSSF,2010e5,wv,000,0034,0002028,080,54,049,08000US540499359466460021600,"Census Tract 216 (part), Rachel CDP, West Augusta district, Marion County, West Virginia",47,32,23,0,0,23,9,15,15,15,0,0,15,0,0,0,0,0,0,0
ACSSF,2010e5,wv,000,0034,0002029,080,54,049,08000US540499359468908021500,"Census Tract 215 (part), Rivesville town, West Augusta district, Marion County, West Virginia",328,224,82,14,20,48,142,104,27,10,0,0,10,17,77,43,5,5,33,34
ACSSF,2010e5,wv,000,0034,0002030,080,54,049,08000US540499359488708021300,"Census Tract 213 (part), Worthington town (part), West Augusta district, Marion County, West Virginia",61,46,12,8,4,0,34,15,4,0,0,0,0,4,11,6,0,0,6,5
ACSSF,2010e5,wv,000,0034,0002031,080,54,049,08000US540499359488708021800,"Census Tract 218 (part), Worthington town (part), West Augusta district, Marion County, West Virginia",0,0,0,0,0,0,0,0,0,0,0,0,0,0,0,0,0,0,0,0
ACSSF,2010e5,wv,000,0034,0002032,080,54,049,08000US540499359499999020400,"Census Tract 204 (part), Remainder of West Augusta district, West Augusta district, Marion County, West Virginia",26,18,18,7,0,11,0,8,0,0,0,0,0,0,8,0,0,0,0,8
ACSSF,2010e5,wv,000,0034,0002033,080,54,049,08000US540499359499999020600,"Census Tract 206 (part), Remainder of West Augusta district, West Augusta district, Marion County, West Virginia",32,0,0,0,0,0,0,32,0,0,0,0,0,0,32,32,0,0,32,0
ACSSF,2010e5,wv,000,0034,0002034,080,54,049,08000US540499359499999021200,"Census Tract 212 (part), Remainder of West Augusta district, West Augusta district, Marion County, West Virginia",0,0,0,0,0,0,0,0,0,0,0,0,0,0,0,0,0,0,0,0
ACSSF,2010e5,wv,000,0034,0002035,080,54,049,08000US540499359499999021300,"Census Tract 213 (part), Remainder of West Augusta district, West Augusta district, Marion County, West Virginia",476,404,90,7,0,83,314,72,11,0,0,0,0,11,61,61,0,0,61,0
ACSSF,2010e5,wv,000,0034,0002036,080,54,049,08000US540499359499999021400,"Census Tract 214 (part), Remainder of West Augusta district, West Augusta district, Marion County, West Virginia",40,40,0,0,0,0,40,0,0,0,0,0,0,0,0,0,0,0,0,0
ACSSF,2010e5,wv,000,0034,0002037,080,54,049,08000US540499359499999021500,"Census Tract 215 (part), Remainder of West Augusta district, West Augusta district, Marion County, West Virginia",503,404,200,42,37,121,204,99,42,30,0,0,30,12,57,7,0,0,7,50
ACSSF,2010e5,wv,000,0034,0002038,080,54,049,08000US540499359499999021600,"Census Tract 216 (part), Remainder of West Augusta district, West Augusta district, Marion County, West Virginia",996,869,299,76,18,205,570,127,63,13,13,0,0,50,64,43,0,0,43,21
ACSSF,2010e5,wv,000,0034,0002039,080,54,049,08000US540499359499999021700,"Census Tract 217 (part), Remainder of West Augusta district, West Augusta district, Marion County, West Virginia",128,128,16,9,7,0,112,0,0,0,0,0,0,0,0,0,0,0,0,0
ACSSF,2010e5,wv,000,0034,0002040,080,54,049,08000US540499359499999021800,"Census Tract 218 (part), Remainder of West Augusta district, West Augusta district, Marion County, West Virginia",726,635,169,39,37,93,466,91,26,14,0,0,14,12,65,30,0,0,30,35
ACSSF,2010e5,wv,000,0034,0002041,080,54,051,08000US540519078006340020500,"Census Tract 205, Benwood city, District 1, Marshall County, West Virginia",266,153,51,5,13,33,102,113,41,24,0,0,24,17,72,50,8,13,29,22
ACSSF,2010e5,wv,000,0034,0002042,080,54,051,08000US540519078006340020601,"Census Tract 206.01 (part), Benwood city, District 1, Marshall County, West Virginia",20,20,14,0,14,0,6,0,0,0,0,0,0,0,0,0,0,0,0,0
ACSSF,2010e5,wv,000,0034,0002043,080,54,051,08000US540519078006340021300,"Census Tract 213 (part), Benwood city, District 1, Marshall County, West Virginia",77,57,12,0,1,11,45,20,3,3,0,0,3,0,17,7,0,0,7,10
ACSSF,2010e5,wv,000,0034,0002044,080,54,051,08000US540519078050260020601,"Census Tract 206.01 (part), McMechen city, District 1, Marshall County, West Virginia",429,329,86,41,19,26,243,100,26,26,6,0,20,0,74,57,28,0,29,17
ACSSF,2010e5,wv,000,0034,0002045,080,54,051,08000US540519078050260021100,"Census Tract 211 (part), McMechen city, District 1, Marshall County, West Virginia",0,0,0,0,0,0,0,0,0,0,0,0,0,0,0,0,0,0,0,0
ACSSF,2010e5,wv,000,0034,0002046,080,54,051,08000US540519078086452020800,"Census Tract 208 (part), Wheeling city (part), District 1, Marshall County, West Virginia",91,91,66,0,0,66,25,0,0,0,0,0,0,0,0,0,0,0,0,0
ACSSF,2010e5,wv,000,0034,0002047,080,54,051,08000US540519078086452021300,"Census Tract 213 (part), Wheeling city (part), District 1, Marshall County, West Virginia",0,0,0,0,0,0,0,0,0,0,0,0,0,0,0,0,0,0,0,0
ACSSF,2010e5,wv,000,0034,0002048,080,54,051,08000US540519078099999020601,"Census Tract 206.01 (part), District Remainder of 1, District 1, Marshall County, West Virginia",72,60,22,0,8,14,38,12,12,12,0,0,12,0,0,0,0,0,0,0
ACSSF,2010e5,wv,000,0034,0002049,080,54,051,08000US540519078099999020800,"Census Tract 208 (part), District Remainder of 1, District 1, Marshall County, West Virginia",416,314,100,32,0,68,214,102,29,12,12,0,0,17,73,18,18,0,0,55
ACSSF,2010e5,wv,000,0034,0002050,080,54,051,08000US540519078099999020900,"Census Tract 209 (part), District Remainder of 1, District 1, Marshall County, West Virginia",0,0,0,0,0,0,0,0,0,0,0,0,0,0,0,0,0,0,0,0
ACSSF,2010e5,wv,000,0034,0002051,080,54,051,08000US540519078099999021000,"Census Tract 210 (part), District Remainder of 1, District 1, Marshall County, West Virginia",209,166,103,0,9,94,63,43,0,0,0,0,0,0,43,43,0,0,43,0
ACSSF,2010e5,wv,000,0034,0002052,080,54,051,08000US540519078099999021100,"Census Tract 211 (part), District Remainder of 1, District 1, Marshall County, West Virginia",246,170,85,0,33,52,85,76,27,0,0,0,0,27,49,0,0,0,0,49
ACSSF,2010e5,wv,000,0034,0002053,080,54,051,08000US540519078099999021300,"Census Tract 213 (part), District Remainder of 1, District 1, Marshall County, West Virginia",1214,1048,382,63,53,266,666,166,48,23,0,0,23,25,118,35,0,19,16,83
ACSSF,2010e5,wv,000,0034,0002054,080,54,051,08000US540519081656020020200,"Census Tract 202, Moundsville city, District 2, Marshall County, West Virginia",532,444,82,15,38,29,362,88,4,4,0,0,4,0,84,58,0,13,45,26
ACSSF,2010e5,wv,000,0034,0002055,080,54,051,08000US540519081656020020900,"Census Tract 209 (part), Moundsville city, District 2, Marshall County, West Virginia",0,0,0,0,0,0,0,0,0,0,0,0,0,0,0,0,0,0,0,0
ACSSF,2010e5,wv,000,0034,0002056,080,54,051,08000US540519081656020021000,"Census Tract 210 (part), Moundsville city, District 2, Marshall County, West Virginia",981,706,186,0,40,146,520,275,25,0,0,0,0,25,250,128,79,0,49,122
ACSSF,2010e5,wv,000,0034,0002057,080,54,051,08000US540519081656020021100,"Census Tract 211 (part), Moundsville city, District 2, Marshall County, West Virginia",944,570,205,26,31,148,365,374,152,99,38,0,61,53,222,101,17,14,70,121
ACSSF,2010e5,wv,000,0034,0002058,080,54,051,08000US540519081699999020900,"Census Tract 209 (part), District Remainder of 2, District 2, Marshall County, West Virginia",239,239,27,0,11,16,212,0,0,0,0,0,0,0,0,0,0,0,0,0
ACSSF,2010e5,wv,000,0034,0002059,080,54,051,08000US540519085212484020800,"Census Tract 208 (part), Cameron city, District 3, Marshall County, West Virginia",256,197,101,27,27,47,96,59,30,23,23,0,0,7,29,13,5,0,8,16
ACSSF,2010e5,wv,000,0034,0002060,080,54,051,08000US540519085231492020702,"Census Tract 207.02 (part), Glen Dale city, District 3, Marshall County, West Virginia",439,349,125,45,13,67,224,90,43,29,3,0,26,14,47,15,0,0,15,32
ACSSF,2010e5,wv,000,0034,0002061,080,54,051,08000US540519085231492021100,"Census Tract 211 (part), Glen Dale city, District 3, Marshall County, West Virginia",48,42,9,0,0,9,33,6,6,0,0,0,0,6,0,0,0,0,0,0
ACSSF,2010e5,wv,000,0034,0002062,080,54,051,08000US540519085299999020702,"Census Tract 207.02 (part), District Remainder of 3, District 3, Marshall County, West Virginia",6,6,0,0,0,0,6,0,0,0,0,0,0,0,0,0,0,0,0,0
ACSSF,2010e5,wv,000,0034,0002063,080,54,051,08000US540519085299999020800,"Census Tract 208 (part), District Remainder of 3, District 3, Marshall County, West Virginia",498,335,152,28,14,110,183,163,97,0,0,0,0,97,66,18,18,0,0,48
ACSSF,2010e5,wv,000,0034,0002064,080,54,051,08000US540519085299999020900,"Census Tract 209 (part), District Remainder of 3, District 3, Marshall County, West Virginia",1282,1025,383,23,160,200,642,257,52,52,52,0,0,0,205,143,41,12,90,62
ACSSF,2010e5,wv,000,0034,0002065,080,54,051,08000US540519085299999021000,"Census Tract 210 (part), District Remainder of 3, District 3, Marshall County, West Virginia",696,574,207,100,0,107,367,122,19,0,0,0,0,19,103,73,9,0,64,30
ACSSF,2010e5,wv,000,0034,0002066,080,54,051,08000US540519085299999021100,"Census Tract 211 (part), District Remainder of 3, District 3, Marshall County, West Virginia",409,404,76,36,13,27,328,5,0,0,0,0,0,0,5,5,0,0,5,0
ACSSF,2010e5,wv,000,0034,0002067,080,54,051,08000US540519085299999021300,"Census Tract 213 (part), District Remainder of 3, District 3, Marshall County, West Virginia",15,15,0,0,0,0,15,0,0,0,0,0,0,0,0,0,0,0,0,0
ACSSF,2010e5,wv,000,0034,0002068,080,54,053,08000US540539004899999955101,"Census Tract 9551.01 (part), Arbuckle district, Arbuckle district, Mason County, West Virginia",84,49,49,0,36,13,0,35,0,0,0,0,0,0,35,0,0,0,0,35
ACSSF,2010e5,wv,000,0034,0002069,080,54,053,08000US540539004899999955102,"Census Tract 9551.02 (part), Arbuckle district, Arbuckle district, Mason County, West Virginia",226,207,11,11,0,0,196,19,19,17,0,0,17,2,0,0,0,0,0,0
ACSSF,2010e5,wv,000,0034,0002070,080,54,053,08000US540539061202188955101,"Census Tract 9551.01 (part), Apple Grove CDP (part), Clendenin district, Mason County, West Virginia",17,17,0,0,0,0,17,0,0,0,0,0,0,0,0,0,0,0,0,0
ACSSF,2010e5,wv,000,0034,0002071,080,54,053,08000US540539061202188955102,"Census Tract 9551.02 (part), Apple Grove CDP (part), Clendenin district, Mason County, West Virginia",5,5,0,0,0,0,5,0,0,0,0,0,0,0,0,0,0,0,0,0
ACSSF,2010e5,wv,000,0034,0002072,080,54,053,08000US540539061229716955101,"Census Tract 9551.01 (part), Gallipolis Ferry CDP, Clendenin district, Mason County, West Virginia",307,242,39,6,0,33,203,65,7,0,0,0,0,7,58,46,0,34,12,12
ACSSF,2010e5,wv,000,0034,0002073,080,54,053,08000US540539061236436955101,"Census Tract 9551.01 (part), Henderson town, Clendenin district, Mason County, West Virginia",51,26,9,4,0,5,17,25,5,3,0,3,0,2,20,19,6,4,9,1
ACSSF,2010e5,wv,000,0034,0002074,080,54,053,08000US540539061299999955101,"Census Tract 9551.01 (part), Remainder of Clendenin district, Clendenin district, Mason County, West Virginia",352,267,111,21,21,69,156,85,33,0,0,0,0,33,52,0,0,0,0,52
ACSSF,2010e5,wv,000,0034,0002075,080,54,053,08000US540539061299999955102,"Census Tract 9551.02 (part), Remainder of Clendenin district, Clendenin district, Mason County, West Virginia",359,290,95,0,44,51,195,69,28,28,0,0,28,0,41,0,0,0,0,41
ACSSF,2010e5,wv,000,0034,0002076,080,54,053,08000US540539064846300954900,"Census Tract 9549 (part), Leon town, Cologne district, Mason County, West Virginia",46,39,12,0,4,8,27,7,5,5,0,0,5,0,2,0,0,0,0,2
ACSSF,2010e5,wv,000,0034,0002077,080,54,053,08000US540539064899999954802,"Census Tract 9548.02 (part), Remainder of Cologne district, Cologne district, Mason County, West Virginia",11,0,0,0,0,0,0,11,11,0,0,0,0,11,0,0,0,0,0,0
ACSSF,2010e5,wv,000,0034,0002078,080,54,053,08000US540539064899999954900,"Census Tract 9549 (part), Remainder of Cologne district, Cologne district, Mason County, West Virginia",227,211,62,0,14,48,149,16,16,0,0,0,0,16,0,0,0,0,0,0
ACSSF,2010e5,wv,000,0034,0002079,080,54,053,08000US540539066099999954802,"Census Tract 9548.02 (part), Cooper district, Cooper district, Mason County, West Virginia",263,198,83,27,0,56,115,65,15,15,0,0,15,0,50,0,0,0,0,50
ACSSF,2010e5,wv,000,0034,0002080,080,54,053,08000US540539066099999954900,"Census Tract 9549 (part), Cooper district, Cooper district, Mason County, West Virginia",278,267,42,0,27,15,225,11,0,0,0,0,0,0,11,11,0,0,11,0
ACSSF,2010e5,wv,000,0034,0002081,080,54,053,08000US540539126035500954801,"Census Tract 9548.01 (part), Hartford City town (part), Graham district, Mason County, West Virginia",9,0,0,0,0,0,0,9,0,0,0,0,0,0,9,0,0,0,0,9
ACSSF,2010e5,wv,000,0034,0002082,080,54,053,08000US540539126035500954802,"Census Tract 9548.02 (part), Hartford City town (part), Graham district, Mason County, West Virginia",126,97,56,25,0,31,41,29,12,0,0,0,0,12,17,17,0,0,17,0
ACSSF,2010e5,wv,000,0034,0002083,080,54,053,08000US540539126058564954802,"Census Tract 9548.02 (part), New Haven town, Graham district, Mason County, West Virginia",516,352,153,55,24,74,199,164,23,18,12,6,0,5,141,88,12,0,76,53
ACSSF,2010e5,wv,000,0034,0002084,080,54,053,08000US540539126099999954801,"Census Tract 9548.01 (part), Remainder of Graham district, Graham district, Mason County, West Virginia",0,0,0,0,0,0,0,0,0,0,0,0,0,0,0,0,0,0,0,0
ACSSF,2010e5,wv,000,0034,0002085,080,54,053,08000US540539126099999954802,"Census Tract 9548.02 (part), Remainder of Graham district, Graham district, Mason County, West Virginia",330,290,102,0,50,52,188,40,35,12,12,0,0,23,5,5,0,0,5,0
ACSSF,2010e5,wv,000,0034,0002086,080,54,053,08000US540539151202188955102,"Census Tract 9551.02 (part), Apple Grove CDP (part), Hannan district, Mason County, West Virginia",23,0,0,0,0,0,0,23,23,0,0,0,0,23,0,0,0,0,0,0
ACSSF,2010e5,wv,000,0034,0002087,080,54,053,08000US540539151299999955102,"Census Tract 9551.02 (part), Remainder of Hannan district, Hannan district, Mason County, West Virginia",825,670,243,35,69,139,427,155,23,23,0,0,23,0,132,83,41,0,42,49
ACSSF,2010e5,wv,000,0034,0002088,080,54,053,08000US540539186064708954900,"Census Tract 9549 (part), Point Pleasant city (part), Lewis district, Mason County, West Virginia",64,7,7,0,0,7,0,57,19,19,0,0,19,0,38,38,38,0,0,0
ACSSF,2010e5,wv,000,0034,0002089,080,54,053,08000US540539186064708955000,"Census Tract 9550 (part), Point Pleasant city (part), Lewis district, Mason County, West Virginia",1016,744,302,8,107,187,442,272,76,63,9,0,54,13,196,87,19,0,68,109
ACSSF,2010e5,wv,000,0034,0002090,080,54,053,08000US540539186099999954802,"Census Tract 9548.02 (part), Remainder of Lewis district, Lewis district, Mason County, West Virginia",0,0,0,0,0,0,0,0,0,0,0,0,0,0,0,0,0,0,0,0
ACSSF,2010e5,wv,000,0034,0002091,080,54,053,08000US540539186099999954900,"Census Tract 9549 (part), Remainder of Lewis district, Lewis district, Mason County, West Virginia",437,390,114,72,0,42,276,47,0,0,0,0,0,0,47,0,0,0,0,47
ACSSF,2010e5,wv,000,0034,0002092,080,54,053,08000US540539186099999955000,"Census Tract 9550 (part), Remainder of Lewis district, Lewis district, Mason County, West Virginia",47,23,14,0,0,14,9,24,0,0,0,0,0,0,24,24,0,0,24,0
ACSSF,2010e5,wv,000,0034,0002093,080,54,053,08000US540539265264708955000,"Census Tract 9550 (part), Point Pleasant city (part), Robinson district, Mason County, West Virginia",60,46,11,0,11,0,35,14,0,0,0,0,0,0,14,0,0,0,0,14
ACSSF,2010e5,wv,000,0034,0002094,080,54,053,08000US540539265299999954801,"Census Tract 9548.01 (part), Remainder of Robinson district, Robinson district, Mason County, West Virginia",21,21,0,0,0,0,21,0,0,0,0,0,0,0,0,0,0,0,0,0
ACSSF,2010e5,wv,000,0034,0002095,080,54,053,08000US540539265299999954802,"Census Tract 9548.02 (part), Remainder of Robinson district, Robinson district, Mason County, West Virginia",0,0,0,0,0,0,0,0,0,0,0,0,0,0,0,0,0,0,0,0
ACSSF,2010e5,wv,000,0034,0002096,080,54,053,08000US540539265299999954900,"Census Tract 9549 (part), Remainder of Robinson district, Robinson district, Mason County, West Virginia",517,327,127,0,37,90,200,190,0,0,0,0,0,0,190,190,162,10,18,0
ACSSF,2010e5,wv,000,0034,0002097,080,54,053,08000US540539265299999955000,"Census Tract 9550 (part), Remainder of Robinson district, Robinson district, Mason County, West Virginia",126,78,13,0,0,13,65,48,0,0,0,0,0,0,48,48,0,0,48,0
ACSSF,2010e5,wv,000,0034,0002098,080,54,053,08000US540539326499999954900,"Census Tract 9549 (part), Union district, Union district, Mason County, West Virginia",452,370,127,0,19,108,243,82,34,0,0,0,0,34,48,23,0,0,23,25
ACSSF,2010e5,wv,000,0034,0002099,080,54,053,08000US540539343235500954801,"Census Tract 9548.01 (part), Hartford City town (part), Waggener district, Mason County, West Virginia",71,49,13,0,13,0,36,22,10,4,0,0,4,6,12,4,0,0,4,8
ACSSF,2010e5,wv,000,0034,0002100,080,54,053,08000US540539343235500954802,"Census Tract 9548.02 (part), Hartford City town (part), Waggener district, Mason County, West Virginia",0,0,0,0,0,0,0,0,0,0,0,0,0,0,0,0,0,0,0,0
ACSSF,2010e5,wv,000,0034,0002101,080,54,053,08000US540539343252180954801,"Census Tract 9548.01 (part), Mason town, Waggener district, Mason County, West Virginia",280,188,62,3,5,54,126,92,3,3,3,0,0,0,89,49,19,5,25,40
ACSSF,2010e5,wv,000,0034,0002102,080,54,053,08000US540539343299999954801,"Census Tract 9548.01 (part), Remainder of Waggener district, Waggener district, Mason County, West Virginia",421,260,66,24,0,42,194,161,45,45,0,0,45,0,116,82,0,18,64,34
ACSSF,2010e5,wv,000,0034,0002103,080,54,053,08000US540539343299999954802,"Census Tract 9548.02 (part), Remainder of Waggener district, Waggener district, Mason County, West Virginia",27,27,27,0,0,27,0,0,0,0,0,0,0,0,0,0,0,0,0,0
ACSSF,2010e5,wv,000,0034,0002104,080,54,055,08000US540559090008524001900,"Census Tract 19 (part), Bluefield city (part), District I, Mercer County, West Virginia",214,51,0,0,0,0,51,163,19,10,0,0,10,9,144,86,16,18,52,58
ACSSF,2010e5,wv,000,0034,0002105,080,54,055,08000US540559090008524002000,"Census Tract 20 (part), Bluefield city (part), District I, Mercer County, West Virginia",467,323,106,34,0,72,217,144,21,0,0,0,0,21,123,81,38,8,35,42
ACSSF,2010e5,wv,000,0034,0002106,080,54,055,08000US540559090008524002100,"Census Tract 21, Bluefield city (part), District I, Mercer County, West Virginia",754,617,210,10,62,138,407,137,14,4,0,0,4,10,123,42,29,0,13,81
ACSSF,2010e5,wv,000,0034,0002107,080,54,055,08000US540559090008524002200,"Census Tract 22 (part), Bluefield city (part), District I, Mercer County, West Virginia",1092,856,236,39,57,140,620,236,0,0,0,0,0,0,236,194,24,28,142,42
ACSSF,2010e5,wv,000,0034,0002108,080,54,055,08000US540559090008524002300,"Census Tract 23 (part), Bluefield city (part), District I, Mercer County, West Virginia",0,0,0,0,0,0,0,0,0,0,0,0,0,0,0,0,0,0,0,0
ACSSF,2010e5,wv,000,0034,0002109,080,54,055,08000US540559090008524002400,"Census Tract 24 (part), Bluefield city (part), District I, Mercer County, West Virginia",11,11,0,0,0,0,11,0,0,0,0,0,0,0,0,0,0,0,0,0
ACSSF,2010e5,wv,000,0034,0002110,080,54,055,08000US540559090008764001700,"Census Tract 17 (part), Bluewell CDP, District I, Mercer County, West Virginia",542,414,166,40,17,109,248,128,43,0,0,0,0,43,85,55,17,0,38,30
ACSSF,2010e5,wv,000,0034,0002111,080,54,055,08000US540559090009796001600,"Census Tract 16 (part), Bramwell town, District I, Mercer County, West Virginia",96,48,13,2,4,7,35,48,6,4,4,0,0,2,42,10,2,0,8,32
ACSSF,2010e5,wv,000,0034,0002112,080,54,055,08000US540559090009796001700,"Census Tract 17 (part), Bramwell town, District I, Mercer County, West Virginia",17,11,0,0,0,0,11,6,0,0,0,0,0,0,6,0,0,0,0,6
ACSSF,2010e5,wv,000,0034,0002113,080,54,055,08000US540559090010948001700,"Census Tract 17 (part), Brush Fork CDP, District I, Mercer County, West Virginia",100,25,0,0,0,0,25,75,9,0,0,0,0,9,66,32,32,0,0,34
ACSSF,2010e5,wv,000,0034,0002114,080,54,055,08000US540559090010948001900,"Census Tract 19 (part), Brush Fork CDP, District I, Mercer County, West Virginia",14,14,14,0,14,0,0,0,0,0,0,0,0,0,0,0,0,0,0,0
ACSSF,2010e5,wv,000,0034,0002115,080,54,055,08000US540559090010948002000,"Census Tract 20 (part), Brush Fork CDP, District I, Mercer County, West Virginia",105,84,25,0,0,25,59,21,0,0,0,0,0,0,21,0,0,0,0,21
ACSSF,2010e5,wv,000,0034,0002116,080,54,055,08000US540559090099999001600,"Census Tract 16 (part), District Remainder of I, District I, Mercer County, West Virginia",219,207,81,20,12,49,126,12,0,0,0,0,0,0,12,0,0,0,0,12
ACSSF,2010e5,wv,000,0034,0002117,080,54,055,08000US540559090099999001700,"Census Tract 17 (part), District Remainder of I, District I, Mercer County, West Virginia",637,475,110,30,0,80,365,162,38,38,38,0,0,0,124,51,0,17,34,73
ACSSF,2010e5,wv,000,0034,0002118,080,54,055,08000US540559090099999001800,"Census Tract 18 (part), District Remainder of I, District I, Mercer County, West Virginia",136,108,33,0,24,9,75,28,6,0,0,0,0,6,22,22,0,0,22,0
ACSSF,2010e5,wv,000,0034,0002119,080,54,055,08000US540559090099999001900,"Census Tract 19 (part), District Remainder of I, District I, Mercer County, West Virginia",38,38,0,0,0,0,38,0,0,0,0,0,0,0,0,0,0,0,0,0
ACSSF,2010e5,wv,000,0034,0002120,080,54,055,08000US540559090099999002000,"Census Tract 20 (part), District Remainder of I, District I, Mercer County, West Virginia",39,31,0,0,0,0,31,8,8,0,0,0,0,8,0,0,0,0,0,0
ACSSF,2010e5,wv,000,0034,0002121,080,54,055,08000US540559090099999002200,"Census Tract 22 (part), District Remainder of I, District I, Mercer County, West Virginia",113,98,24,24,0,0,74,15,0,0,0,0,0,0,15,15,0,0,15,0
ACSSF,2010e5,wv,000,0034,0002122,080,54,055,08000US540559090099999002300,"Census Tract 23 (part), District Remainder of I, District I, Mercer County, West Virginia",48,48,6,0,0,6,42,0,0,0,0,0,0,0,0,0,0,0,0,0
ACSSF,2010e5,wv,000,0034,0002123,080,54,055,08000US540559090099999002400,"Census Tract 24 (part), District Remainder of I, District I, Mercer County, West Virginia",0,0,0,0,0,0,0,0,0,0,0,0,0,0,0,0,0,0,0,0
ACSSF,2010e5,wv,000,0034,0002124,080,54,055,08000US540559091265692001200,"Census Tract 12 (part), Princeton city (part), District II, Mercer County, West Virginia",24,24,9,9,0,0,15,0,0,0,0,0,0,0,0,0,0,0,0,0
ACSSF,2010e5,wv,000,0034,0002125,080,54,055,08000US540559091265692001300,"Census Tract 13 (part), Princeton city (part), District II, Mercer County, West Virginia",713,424,140,103,0,37,284,289,143,71,0,0,71,72,146,53,13,0,40,93
ACSSF,2010e5,wv,000,0034,0002126,080,54,055,08000US540559091265692001400,"Census Tract 14 (part), Princeton city (part), District II, Mercer County, West Virginia",539,436,130,19,0,111,306,103,62,51,0,0,51,11,41,10,10,0,0,31
ACSSF,2010e5,wv,000,0034,0002127,080,54,055,08000US540559091265692001500,"Census Tract 15 (part), Princeton city (part), District II, Mercer County, West Virginia",264,220,74,23,12,39,146,44,44,44,0,44,0,0,0,0,0,0,0,0
ACSSF,2010e5,wv,000,0034,0002128,080,54,055,08000US540559091265692001800,"Census Tract 18 (part), Princeton city (part), District II, Mercer County, West Virginia",19,0,0,0,0,0,0,19,19,0,0,0,0,19,0,0,0,0,0,0
ACSSF,2010e5,wv,000,0034,0002129,080,54,055,08000US540559091265692002300,"Census Tract 23 (part), Princeton city (part), District II, Mercer County, West Virginia",158,133,16,0,16,0,117,25,0,0,0,0,0,0,25,0,0,0,0,25
ACSSF,2010e5,wv,000,0034,0002130,080,54,055,08000US540559091299999001000,"Census Tract 10 (part), District Remainder of II, District II, Mercer County, West Virginia",57,47,11,0,0,11,36,10,0,0,0,0,0,0,10,0,0,0,0,10
ACSSF,2010e5,wv,000,0034,0002131,080,54,055,08000US540559091299999001200,"Census Tract 12 (part), District Remainder of II, District II, Mercer County, West Virginia",879,608,267,78,43,146,341,271,86,14,14,0,0,72,185,106,55,0,51,79
ACSSF,2010e5,wv,000,0034,0002132,080,54,055,08000US540559091299999001300,"Census Tract 13 (part), District Remainder of II, District II, Mercer County, West Virginia",249,173,45,14,0,31,128,76,43,34,24,0,10,9,33,19,11,0,8,14
ACSSF,2010e5,wv,000,0034,0002133,080,54,055,08000US540559091299999001400,"Census Tract 14 (part), District Remainder of II, District II, Mercer County, West Virginia",37,37,11,0,11,0,26,0,0,0,0,0,0,0,0,0,0,0,0,0
ACSSF,2010e5,wv,000,0034,0002134,080,54,055,08000US540559091299999001500,"Census Tract 15 (part), District Remainder of II, District II, Mercer County, West Virginia",1163,928,347,122,83,142,581,235,48,26,26,0,0,22,187,148,21,0,127,39
ACSSF,2010e5,wv,000,0034,0002135,080,54,055,08000US540559091299999001700,"Census Tract 17 (part), District Remainder of II, District II, Mercer County, West Virginia",0,0,0,0,0,0,0,0,0,0,0,0,0,0,0,0,0,0,0,0
ACSSF,2010e5,wv,000,0034,0002136,080,54,055,08000US540559091299999001800,"Census Tract 18 (part), District Remainder of II, District II, Mercer County, West Virginia",1240,976,211,45,16,150,765,264,111,47,0,13,34,64,153,65,11,0,54,88
ACSSF,2010e5,wv,000,0034,0002137,080,54,055,08000US540559091299999002300,"Census Tract 23 (part), District Remainder of II, District II, Mercer County, West Virginia",764,501,153,31,0,122,348,263,50,9,9,0,0,41,213,123,61,0,62,90
ACSSF,2010e5,wv,000,0034,0002138,080,54,055,08000US540559092403292001100,"Census Tract 11 (part), Athens town, District III, Mercer County, West Virginia",180,149,29,7,11,11,120,31,0,0,0,0,0,0,31,22,19,0,3,9
ACSSF,2010e5,wv,000,0034,0002139,080,54,055,08000US540559092408524001900,"Census Tract 19 (part), Bluefield city (part), District III, Mercer County, West Virginia",0,0,0,0,0,0,0,0,0,0,0,0,0,0,0,0,0,0,0,0
ACSSF,2010e5,wv,000,0034,0002140,080,54,055,08000US540559092445292001000,"Census Tract 10 (part), Lashmeet CDP, District III, Mercer County, West Virginia",107,107,10,0,0,10,97,0,0,0,0,0,0,0,0,0,0,0,0,0
ACSSF,2010e5,wv,000,0034,0002141,080,54,055,08000US540559092452420000900,"Census Tract 9 (part), Matoaka town, District III, Mercer County, West Virginia",55,24,2,0,0,2,22,31,19,16,6,0,10,3,12,0,0,0,0,12
ACSSF,2010e5,wv,000,0034,0002142,080,54,055,08000US540559092452420001000,"Census Tract 10 (part), Matoaka town, District III, Mercer County, West Virginia",0,0,0,0,0,0,0,0,0,0,0,0,0,0,0,0,0,0,0,0
ACSSF,2010e5,wv,000,0034,0002143,080,54,055,08000US540559092455372001600,"Census Tract 16 (part), Montcalm CDP, District III, Mercer County, West Virginia",31,24,0,0,0,0,24,7,0,0,0,0,0,0,7,0,0,0,0,7
ACSSF,2010e5,wv,000,0034,0002144,080,54,055,08000US540559092455372001800,"Census Tract 18 (part), Montcalm CDP, District III, Mercer County, West Virginia",112,112,33,0,18,15,79,0,0,0,0,0,0,0,0,0,0,0,0,0
ACSSF,2010e5,wv,000,0034,0002145,080,54,055,08000US540559092460196002400,"Census Tract 24 (part), Oakvale town, District III, Mercer County, West Virginia",27,27,3,0,3,0,24,0,0,0,0,0,0,0,0,0,0,0,0,0
ACSSF,2010e5,wv,000,0034,0002146,080,54,055,08000US540559092465692002300,"Census Tract 23 (part), Princeton city (part), District III, Mercer County, West Virginia",4,0,0,0,0,0,0,4,0,0,0,0,0,0,4,4,0,0,4,0
ACSSF,2010e5,wv,000,0034,0002147,080,54,055,08000US540559092499999000900,"Census Tract 9 (part), District Remainder of III, District III, Mercer County, West Virginia",845,728,191,36,23,132,537,117,34,0,0,0,0,34,83,46,23,0,23,37
ACSSF,2010e5,wv,000,0034,0002148,080,54,055,08000US540559092499999001000,"Census Tract 10 (part), District Remainder of III, District III, Mercer County, West Virginia",1077,950,350,60,104,186,600,127,68,41,15,8,18,27,59,15,0,0,15,44
ACSSF,2010e5,wv,000,0034,0002149,080,54,055,08000US540559092499999001100,"Census Tract 11 (part), District Remainder of III, District III, Mercer County, West Virginia",1204,938,263,53,39,171,675,266,48,33,15,0,18,15,218,98,31,25,42,120
ACSSF,2010e5,wv,000,0034,0002150,080,54,055,08000US540559092499999001200,"Census Tract 12 (part), District Remainder of III, District III, Mercer County, West Virginia",36,36,16,16,0,0,20,0,0,0,0,0,0,0,0,0,0,0,0,0
ACSSF,2010e5,wv,000,0034,0002151,080,54,055,08000US540559092499999001500,"Census Tract 15 (part), District Remainder of III, District III, Mercer County, West Virginia",12,12,12,0,0,12,0,0,0,0,0,0,0,0,0,0,0,0,0,0
ACSSF,2010e5,wv,000,0034,0002152,080,54,055,08000US540559092499999001600,"Census Tract 16 (part), District Remainder of III, District III, Mercer County, West Virginia",165,94,41,0,0,41,53,71,24,12,12,0,0,12,47,40,17,9,14,7
ACSSF,2010e5,wv,000,0034,0002153,080,54,055,08000US540559092499999001700,"Census Tract 17 (part), District Remainder of III, District III, Mercer County, West Virginia",30,30,15,0,0,15,15,0,0,0,0,0,0,0,0,0,0,0,0,0
ACSSF,2010e5,wv,000,0034,0002154,080,54,055,08000US540559092499999001800,"Census Tract 18 (part), District Remainder of III, District III, Mercer County, West Virginia",0,0,0,0,0,0,0,0,0,0,0,0,0,0,0,0,0,0,0,0
ACSSF,2010e5,wv,000,0034,0002155,080,54,055,08000US540559092499999001900,"Census Tract 19 (part), District Remainder of III, District III, Mercer County, West Virginia",123,123,29,0,8,21,94,0,0,0,0,0,0,0,0,0,0,0,0,0
ACSSF,2010e5,wv,000,0034,0002156,080,54,055,08000US540559092499999002200,"Census Tract 22 (part), District Remainder of III, District III, Mercer County, West Virginia",0,0,0,0,0,0,0,0,0,0,0,0,0,0,0,0,0,0,0,0
ACSSF,2010e5,wv,000,0034,0002157,080,54,055,08000US540559092499999002300,"Census Tract 23 (part), District Remainder of III, District III, Mercer County, West Virginia",378,218,131,0,14,117,87,160,9,9,0,9,0,0,151,76,18,22,36,75
ACSSF,2010e5,wv,000,0034,0002158,080,54,055,08000US540559092499999002400,"Census Tract 24 (part), District Remainder of III, District III, Mercer County, West Virginia",877,740,216,0,76,140,524,137,42,15,0,0,15,27,95,36,0,0,36,59
ACSSF,2010e5,wv,000,0034,0002159,080,54,057,08000US540579078411620010400,"Census Tract 104 (part), Burlington CDP, District 1, Mineral County, West Virginia",0,0,0,0,0,0,0,0,0,0,0,0,0,0,0,0,0,0,0,0
ACSSF,2010e5,wv,000,0034,0002160,080,54,057,08000US540579078424484010700,"Census Tract 107 (part), Elk Garden town, District 1, Mineral County, West Virginia",80,50,18,3,8,7,32,30,11,3,0,0,3,8,19,14,0,0,14,5
ACSSF,2010e5,wv,000,0034,0002161,080,54,057,08000US540579078428444010300,"Census Tract 103 (part), Fort Ashby CDP (part), District 1, Mineral County, West Virginia",380,348,132,25,65,42,216,32,0,0,0,0,0,0,32,32,17,0,15,0
ACSSF,2010e5,wv,000,0034,0002162,080,54,057,08000US540579078463604010700,"Census Tract 107 (part), Piedmont town, District 1, Mineral County, West Virginia",269,137,54,3,4,47,83,132,22,16,0,12,4,6,110,83,11,19,53,27
ACSSF,2010e5,wv,000,0034,0002163,080,54,057,08000US540579078499999010300,"Census Tract 103 (part), District Remainder of 1, District 1, Mineral County, West Virginia",92,92,45,16,0,29,47,0,0,0,0,0,0,0,0,0,0,0,0,0
ACSSF,2010e5,wv,000,0034,0002164,080,54,057,08000US540579078499999010400,"Census Tract 104 (part), District Remainder of 1, District 1, Mineral County, West Virginia",1231,966,304,103,34,167,662,265,86,73,20,41,12,13,179,132,0,0,132,47
ACSSF,2010e5,wv,000,0034,0002165,080,54,057,08000US540579078499999010500,"Census Tract 105 (part), District Remainder of 1, District 1, Mineral County, West Virginia",253,210,64,12,0,52,146,43,10,0,0,0,0,10,33,33,0,15,18,0
ACSSF,2010e5,wv,000,0034,0002166,080,54,057,08000US540579078499999010700,"Census Tract 107 (part), District Remainder of 1, District 1, Mineral County, West Virginia",283,267,30,0,0,30,237,16,16,0,0,0,0,16,0,0,0,0,0,0
ACSSF,2010e5,wv,000,0034,0002167,080,54,057,08000US540579082043492010500,"Census Tract 105 (part), Keyser city, District 2, Mineral County, West Virginia",405,255,132,0,87,45,123,150,10,0,0,0,0,10,140,95,0,23,72,45
ACSSF,2010e5,wv,000,0034,0002168,080,54,057,08000US540579082043492010600,"Census Tract 106 (part), Keyser city, District 2, Mineral County, West Virginia",879,645,185,72,16,97,460,234,71,58,14,0,44,13,163,68,26,0,42,95
ACSSF,2010e5,wv,000,0034,0002169,080,54,057,08000US540579082099999010500,"Census Tract 105 (part), District Remainder of 2, District 2, Mineral County, West Virginia",632,513,88,40,23,25,425,119,32,24,0,0,24,8,87,81,0,0,81,6
ACSSF,2010e5,wv,000,0034,0002170,080,54,057,08000US540579082099999010600,"Census Tract 106 (part), District Remainder of 2, District 2, Mineral County, West Virginia",476,350,135,16,0,119,215,126,0,0,0,0,0,0,126,104,34,0,70,22
ACSSF,2010e5,wv,000,0034,0002171,080,54,057,08000US540579082099999010700,"Census Tract 107 (part), District Remainder of 2, District 2, Mineral County, West Virginia",0,0,0,0,0,0,0,0,0,0,0,0,0,0,0,0,0,0,0,0
ACSSF,2010e5,wv,000,0034,0002172,080,54,057,08000US540579085613525010100,"Census Tract 101 (part), Carpendale town, District 3, Mineral County, West Virginia",293,254,43,4,4,35,211,39,3,3,0,0,3,0,36,2,0,0,2,34
ACSSF,2010e5,wv,000,0034,0002173,080,54,057,08000US540579085628444010300,"Census Tract 103 (part), Fort Ashby CDP (part), District 3, Mineral County, West Virginia",159,144,62,0,13,49,82,15,0,0,0,0,0,0,15,15,0,0,15,0
ACSSF,2010e5,wv,000,0034,0002174,080,54,057,08000US540579085668260010100,"Census Tract 101 (part), Ridgeley town, District 3, Mineral County, West Virginia",191,136,39,4,0,35,97,55,20,5,0,4,1,15,35,31,0,0,31,4
ACSSF,2010e5,wv,000,0034,0002175,080,54,057,08000US540579085687316010100,"Census Tract 101 (part), Wiley Ford CDP, District 3, Mineral County, West Virginia",246,190,93,9,65,19,97,56,19,0,0,0,0,19,37,5,0,0,5,32
ACSSF,2010e5,wv,000,0034,0002176,080,54,057,08000US540579085699999010100,"Census Tract 101 (part), District Remainder of 3, District 3, Mineral County, West Virginia",0,0,0,0,0,0,0,0,0,0,0,0,0,0,0,0,0,0,0,0
ACSSF,2010e5,wv,000,0034,0002177,080,54,057,08000US540579085699999010200,"Census Tract 102, District Remainder of 3, District 3, Mineral County, West Virginia",1047,749,228,79,22,127,521,298,118,86,70,0,16,32,180,138,28,26,84,42
ACSSF,2010e5,wv,000,0034,0002178,080,54,057,08000US540579085699999010300,"Census Tract 103 (part), District Remainder of 3, District 3, Mineral County, West Virginia",786,706,187,10,34,143,519,80,28,28,0,17,11,0,52,28,0,0,28,24
ACSSF,2010e5,wv,000,0034,0002179,080,54,057,08000US540579085699999010400,"Census Tract 104 (part), District Remainder of 3, District 3, Mineral County, West Virginia",8,8,8,0,0,8,0,0,0,0,0,0,0,0,0,0,0,0,0,0
ACSSF,2010e5,wv,000,0034,0002180,080,54,057,08000US540579085699999010500,"Census Tract 105 (part), District Remainder of 3, District 3, Mineral County, West Virginia",0,0,0,0,0,0,0,0,0,0,0,0,0,0,0,0,0,0,0,0
ACSSF,2010e5,wv,000,0034,0002181,080,54,059,08000US540599014167396957500,"Census Tract 9575 (part), Red Jacket CDP (part), Beech Ben Mate district, Mingo County, West Virginia",103,69,31,0,0,31,38,34,0,0,0,0,0,0,34,34,14,0,20,0
ACSSF,2010e5,wv,000,0034,0002182,080,54,059,08000US540599014167396957600,"Census Tract 9576 (part), Red Jacket CDP (part), Beech Ben Mate district, Mingo County, West Virginia",91,61,15,0,0,15,46,30,30,30,30,0,0,0,0,0,0,0,0,0
ACSSF,2010e5,wv,000,0034,0002183,080,54,059,08000US540599014199999957500,"Census Tract 9575 (part), Remainder of Beech Ben Mate district, Beech Ben Mate district, Mingo County, West Virginia",289,182,38,10,14,14,144,107,27,0,0,0,0,27,80,48,16,16,16,32
ACSSF,2010e5,wv,000,0034,0002184,080,54,059,08000US540599014199999957600,"Census Tract 9576 (part), Remainder of Beech Ben Mate district, Beech Ben Mate district, Mingo County, West Virginia",542,445,209,69,28,112,236,97,9,0,0,0,0,9,88,65,0,18,47,23
ACSSF,2010e5,wv,000,0034,0002185,080,54,059,08000US540599177043300957100,"Census Tract 9571 (part), Kermit town, Kermit Harvey district, Mingo County, West Virginia",199,144,37,16,0,21,107,55,5,0,0,0,0,5,50,12,0,4,8,38
ACSSF,2010e5,wv,000,0034,0002186,080,54,059,08000US540599177099999957100,"Census Tract 9571 (part), Remainder of Kermit Harvey district, Kermit Harvey district, Mingo County, West Virginia",740,613,186,11,25,150,427,127,61,34,0,34,0,27,66,0,0,0,0,66
ACSSF,2010e5,wv,000,0034,0002187,080,54,059,08000US540599177099999957200,"Census Tract 9572 (part), Remainder of Kermit Harvey district, Kermit Harvey district, Mingo County, West Virginia",163,126,32,17,0,15,94,37,0,0,0,0,0,0,37,0,0,0,0,37
ACSSF,2010e5,wv,000,0034,0002188,080,54,059,08000US540599184820980957300,"Census Tract 9573 (part), Delbarton town, Lee district, Mingo County, West Virginia",253,207,93,8,26,59,114,46,14,0,0,0,0,14,32,5,0,5,0,27
ACSSF,2010e5,wv,000,0034,0002189,080,54,059,08000US540599184820980957500,"Census Tract 9575 (part), Delbarton town, Lee district, Mingo County, West Virginia",10,3,3,0,0,3,0,7,0,0,0,0,0,0,7,7,0,0,7,0
ACSSF,2010e5,wv,000,0034,0002190,080,54,059,08000US540599184899999957200,"Census Tract 9572 (part), Remainder of Lee district, Lee district, Mingo County, West Virginia",588,417,142,45,33,64,275,171,90,22,22,0,0,68,81,27,0,27,0,54
ACSSF,2010e5,wv,000,0034,0002191,080,54,059,08000US540599184899999957300,"Census Tract 9573 (part), Remainder of Lee district, Lee district, Mingo County, West Virginia",167,167,43,0,0,43,124,0,0,0,0,0,0,0,0,0,0,0,0,0
ACSSF,2010e5,wv,000,0034,0002192,080,54,059,08000US540599184899999957500,"Census Tract 9575 (part), Remainder of Lee district, Lee district, Mingo County, West Virginia",148,123,67,0,14,53,56,25,25,9,9,0,0,16,0,0,0,0,0,0
ACSSF,2010e5,wv,000,0034,0002193,080,54,059,08000US540599206452324957500,"Census Tract 9575 (part), Matewan town, Magnolia district, Mingo County, West Virginia",139,86,34,0,0,34,52,53,14,5,0,0,5,9,39,15,5,0,10,24
ACSSF,2010e5,wv,000,0034,0002194,080,54,059,08000US540599206452324957600,"Census Tract 9576 (part), Matewan town, Magnolia district, Mingo County, West Virginia",11,4,4,0,0,4,0,7,7,0,0,0,0,7,0,0,0,0,0,0
ACSSF,2010e5,wv,000,0034,0002195,080,54,059,08000US540599206467396957500,"Census Tract 9575 (part), Red Jacket CDP (part), Magnolia district, Mingo County, West Virginia",11,11,11,11,0,0,0,0,0,0,0,0,0,0,0,0,0,0,0,0
ACSSF,2010e5,wv,000,0034,0002196,080,54,059,08000US540599206499999957300,"Census Tract 9573 (part), Remainder of Magnolia district, Magnolia district, Mingo County, West Virginia",76,26,10,0,0,10,16,50,38,38,0,0,38,0,12,0,0,0,0,12
ACSSF,2010e5,wv,000,0034,0002197,080,54,059,08000US540599206499999957500,"Census Tract 9575 (part), Remainder of Magnolia district, Magnolia district, Mingo County, West Virginia",288,209,87,44,0,43,122,79,14,0,0,0,0,14,65,65,0,0,65,0
ACSSF,2010e5,wv,000,0034,0002198,080,54,059,08000US540599206499999957600,"Census Tract 9576 (part), Remainder of Magnolia district, Magnolia district, Mingo County, West Virginia",297,166,63,0,15,48,103,131,36,19,0,0,19,17,95,36,0,16,20,59
ACSSF,2010e5,wv,000,0034,0002199,080,54,059,08000US540599301230772957700,"Census Tract 9577 (part), Gilbert town, Stafford district, Mingo County, West Virginia",104,88,28,12,0,16,60,16,5,0,0,0,0,5,11,3,0,0,3,8
ACSSF,2010e5,wv,000,0034,0002200,080,54,059,08000US540599301230777957700,"Census Tract 9577 (part), Gilbert Creek CDP, Stafford district, Mingo County, West Virginia",535,476,123,78,0,45,353,59,26,26,0,0,26,0,33,33,19,0,14,0
ACSSF,2010e5,wv,000,0034,0002201,080,54,059,08000US540599301242292957700,"Census Tract 9577 (part), Justice CDP, Stafford district, Mingo County, West Virginia",151,151,71,0,0,71,80,0,0,0,0,0,0,0,0,0,0,0,0,0
ACSSF,2010e5,wv,000,0034,0002202,080,54,059,08000US540599301299999957700,"Census Tract 9577 (part), Remainder of Stafford district, Stafford district, Mingo County, West Virginia",453,297,68,0,0,68,229,156,20,0,0,0,0,20,136,38,16,0,22,98
ACSSF,2010e5,wv,000,0034,0002203,080,54,059,08000US540599316214692957300,"Census Tract 9573 (part), Chattaroy CDP (part), Tug Hardee district, Mingo County, West Virginia",148,132,28,28,0,0,104,16,0,0,0,0,0,0,16,16,0,0,16,0
ACSSF,2010e5,wv,000,0034,0002204,080,54,059,08000US540599316299999957100,"Census Tract 9571 (part), Remainder of Tug Hardee district, Tug Hardee district, Mingo County, West Virginia",185,152,52,23,11,18,100,33,33,0,0,0,0,33,0,0,0,0,0,0
ACSSF,2010e5,wv,000,0034,0002205,080,54,059,08000US540599316299999957200,"Census Tract 9572 (part), Remainder of Tug Hardee district, Tug Hardee district, Mingo County, West Virginia",278,200,52,0,8,44,148,78,27,0,0,0,0,27,51,19,0,0,19,32
ACSSF,2010e5,wv,000,0034,0002206,080,54,059,08000US540599316299999957300,"Census Tract 9573 (part), Remainder of Tug Hardee district, Tug Hardee district, Mingo County, West Virginia",410,300,152,54,15,83,148,110,61,13,0,0,13,48,49,0,0,0,0,49
ACSSF,2010e5,wv,000,0034,0002207,080,54,059,08000US540599316299999957500,"Census Tract 9575 (part), Remainder of Tug Hardee district, Tug Hardee district, Mingo County, West Virginia",54,54,12,6,0,6,42,0,0,0,0,0,0,0,0,0,0,0,0,0
ACSSF,2010e5,wv,000,0034,0002208,080,54,059,08000US540599369614692957400,"Census Tract 9574 (part), Chattaroy CDP (part), Williamson district, Mingo County, West Virginia",108,75,17,0,0,17,58,33,0,0,0,0,0,0,33,16,0,0,16,17
ACSSF,2010e5,wv,000,0034,0002209,080,54,059,08000US540599369687508957300,"Census Tract 9573 (part), Williamson city, Williamson district, Mingo County, West Virginia",0,0,0,0,0,0,0,0,0,0,0,0,0,0,0,0,0,0,0,0
ACSSF,2010e5,wv,000,0034,0002210,080,54,059,08000US540599369687508957400,"Census Tract 9574 (part), Williamson city, Williamson district, Mingo County, West Virginia",741,462,135,35,34,66,327,279,7,0,0,0,0,7,272,101,57,15,29,171
ACSSF,2010e5,wv,000,0034,0002211,080,54,059,08000US540599369699999957400,"Census Tract 9574 (part), Remainder of Williamson district, Williamson district, Mingo County, West Virginia",81,56,30,0,0,30,26,25,25,0,0,0,0,25,0,0,0,0,0,0
ACSSF,2010e5,wv,000,0034,0002212,080,54,059,08000US540599369699999957500,"Census Tract 9575 (part), Remainder of Williamson district, Williamson district, Mingo County, West Virginia",124,96,44,0,14,30,52,28,0,0,0,0,0,0,28,20,0,0,20,8
ACSSF,2010e5,wv,000,0034,0002213,080,54,061,08000US540619045655756010101,"Census Tract 101.01, Morgantown city (part), Central district, Monongalia County, West Virginia",0,0,0,0,0,0,0,0,0,0,0,0,0,0,0,0,0,0,0,0
ACSSF,2010e5,wv,000,0034,0002214,080,54,061,08000US540619045655756010102,"Census Tract 101.02 (part), Morgantown city (part), Central district, Monongalia County, West Virginia",150,93,38,0,0,38,55,57,0,0,0,0,0,0,57,31,24,0,7,26
ACSSF,2010e5,wv,000,0034,0002215,080,54,061,08000US540619045655756010201,"Census Tract 102.01 (part), Morgantown city (part), Central district, Monongalia County, West Virginia",50,40,20,7,7,6,20,10,10,0,0,0,0,10,0,0,0,0,0,0
ACSSF,2010e5,wv,000,0034,0002216,080,54,061,08000US540619045655756010202,"Census Tract 102.02 (part), Morgantown city (part), Central district, Monongalia County, West Virginia",242,188,110,27,27,56,78,54,9,1,0,1,0,8,45,0,0,0,0,45
ACSSF,2010e5,wv,000,0034,0002217,080,54,061,08000US540619045655756010400,"Census Tract 104 (part), Morgantown city (part), Central district, Monongalia County, West Virginia",343,307,93,18,27,48,214,36,10,10,0,0,10,0,26,17,0,0,17,9
ACSSF,2010e5,wv,000,0034,0002218,080,54,061,08000US540619045655756010700,"Census Tract 107 (part), Morgantown city (part), Central district, Monongalia County, West Virginia",630,381,68,0,35,33,313,249,119,89,23,66,0,30,130,65,18,0,47,65
ACSSF,2010e5,wv,000,0034,0002219,080,54,061,08000US540619045655756010800,"Census Tract 108 (part), Morgantown city (part), Central district, Monongalia County, West Virginia",33,8,8,0,0,8,0,25,7,7,0,0,7,0,18,9,0,9,0,9
ACSSF,2010e5,wv,000,0034,0002220,080,54,061,08000US540619045655756010901,"Census Tract 109.01, Morgantown city (part), Central district, Monongalia County, West Virginia",503,382,83,7,10,66,299,121,15,12,12,0,0,3,106,50,10,0,40,56
ACSSF,2010e5,wv,000,0034,0002221,080,54,061,08000US540619045655756010902,"Census Tract 109.02 (part), Morgantown city (part), Central district, Monongalia County, West Virginia",510,388,163,74,40,49,225,122,12,0,0,0,0,12,110,58,32,0,26,52
ACSSF,2010e5,wv,000,0034,0002222,080,54,061,08000US540619045655756011000,"Census Tract 110 (part), Morgantown city (part), Central district, Monongalia County, West Virginia",381,292,78,45,8,25,214,89,9,0,0,0,0,9,80,62,8,8,46,18
ACSSF,2010e5,wv,000,0034,0002223,080,54,061,08000US540619045655756011100,"Census Tract 111 (part), Morgantown city (part), Central district, Monongalia County, West Virginia",0,0,0,0,0,0,0,0,0,0,0,0,0,0,0,0,0,0,0,0
ACSSF,2010e5,wv,000,0034,0002224,080,54,061,08000US540619045655756011200,"Census Tract 112 (part), Morgantown city (part), Central district, Monongalia County, West Virginia",0,0,0,0,0,0,0,0,0,0,0,0,0,0,0,0,0,0,0,0
ACSSF,2010e5,wv,000,0034,0002225,080,54,061,08000US540619045655756011803,"Census Tract 118.03 (part), Morgantown city (part), Central district, Monongalia County, West Virginia",0,0,0,0,0,0,0,0,0,0,0,0,0,0,0,0,0,0,0,0
ACSSF,2010e5,wv,000,0034,0002226,080,54,061,08000US540619045655756011805,"Census Tract 118.05 (part), Morgantown city (part), Central district, Monongalia County, West Virginia",10,10,0,0,0,0,10,0,0,0,0,0,0,0,0,0,0,0,0,0
ACSSF,2010e5,wv,000,0034,0002227,080,54,061,08000US540619045655756012000,"Census Tract 120 (part), Morgantown city (part), Central district, Monongalia County, West Virginia",533,475,181,26,35,120,294,58,22,0,0,0,0,22,36,18,0,0,18,18
ACSSF,2010e5,wv,000,0034,0002228,080,54,061,08000US540619045676516010400,"Census Tract 104 (part), Star City town (part), Central district, Monongalia County, West Virginia",365,249,81,26,26,29,168,116,52,39,21,0,18,13,64,9,0,0,9,55
ACSSF,2010e5,wv,000,0034,0002229,080,54,061,08000US540619045676516011200,"Census Tract 112 (part), Star City town (part), Central district, Monongalia County, West Virginia",0,0,0,0,0,0,0,0,0,0,0,0,0,0,0,0,0,0,0,0
ACSSF,2010e5,wv,000,0034,0002230,080,54,061,08000US540619045699999010400,"Census Tract 104 (part), Remainder of Central district, Central district, Monongalia County, West Virginia",25,3,0,0,0,0,3,22,0,0,0,0,0,0,22,22,0,22,0,0
ACSSF,2010e5,wv,000,0034,0002231,080,54,061,08000US540619045699999010700,"Census Tract 107 (part), Remainder of Central district, Central district, Monongalia County, West Virginia",0,0,0,0,0,0,0,0,0,0,0,0,0,0,0,0,0,0,0,0
ACSSF,2010e5,wv,000,0034,0002232,080,54,061,08000US540619045699999010902,"Census Tract 109.02 (part), Remainder of Central district, Central district, Monongalia County, West Virginia",0,0,0,0,0,0,0,0,0,0,0,0,0,0,0,0,0,0,0,0
ACSSF,2010e5,wv,000,0034,0002233,080,54,061,08000US540619045699999011000,"Census Tract 110 (part), Remainder of Central district, Central district, Monongalia County, West Virginia",11,0,0,0,0,0,0,11,0,0,0,0,0,0,11,0,0,0,0,11
ACSSF,2010e5,wv,000,0034,0002234,080,54,061,08000US540619045699999011200,"Census Tract 112 (part), Remainder of Central district, Central district, Monongalia County, West Virginia",0,0,0,0,0,0,0,0,0,0,0,0,0,0,0,0,0,0,0,0
ACSSF,2010e5,wv,000,0034,0002235,080,54,061,08000US540619045699999011803,"Census Tract 118.03 (part), Remainder of Central district, Central district, Monongalia County, West Virginia",0,0,0,0,0,0,0,0,0,0,0,0,0,0,0,0,0,0,0,0
ACSSF,2010e5,wv,000,0034,0002236,080,54,061,08000US540619045699999011805,"Census Tract 118.05 (part), Remainder of Central district, Central district, Monongalia County, West Virginia",0,0,0,0,0,0,0,0,0,0,0,0,0,0,0,0,0,0,0,0
ACSSF,2010e5,wv,000,0034,0002237,080,54,061,08000US540619045699999012000,"Census Tract 120 (part), Remainder of Central district, Central district, Monongalia County, West Virginia",0,0,0,0,0,0,0,0,0,0,0,0,0,0,0,0,0,0,0,0
ACSSF,2010e5,wv,000,0034,0002238,080,54,061,08000US540619098310420011803,"Census Tract 118.03 (part), Brookhaven CDP (part), Eastern district, Monongalia County, West Virginia",425,281,137,35,22,80,144,144,51,0,0,0,0,51,93,52,37,0,15,41
ACSSF,2010e5,wv,000,0034,0002239,080,54,061,08000US540619098310420011805,"Census Tract 118.05 (part), Brookhaven CDP (part), Eastern district, Monongalia County, West Virginia",923,658,329,57,86,186,329,265,142,95,58,0,37,47,123,89,44,0,45,34
ACSSF,2010e5,wv,000,0034,0002240,080,54,061,08000US540619098310420011806,"Census Tract 118.06 (part), Brookhaven CDP (part), Eastern district, Monongalia County, West Virginia",0,0,0,0,0,0,0,0,0,0,0,0,0,0,0,0,0,0,0,0
ACSSF,2010e5,wv,000,0034,0002241,080,54,061,08000US540619098314775010800,"Census Tract 108 (part), Cheat Lake CDP, Eastern district, Monongalia County, West Virginia",0,0,0,0,0,0,0,0,0,0,0,0,0,0,0,0,0,0,0,0
ACSSF,2010e5,wv,000,0034,0002242,080,54,061,08000US540619098314775011600,"Census Tract 116 (part), Cheat Lake CDP, Eastern district, Monongalia County, West Virginia",0,0,0,0,0,0,0,0,0,0,0,0,0,0,0,0,0,0,0,0
ACSSF,2010e5,wv,000,0034,0002243,080,54,061,08000US540619098314775011700,"Census Tract 117 (part), Cheat Lake CDP, Eastern district, Monongalia County, West Virginia",731,638,267,49,59,159,371,93,17,7,0,0,7,10,76,56,0,5,51,20
ACSSF,2010e5,wv,000,0034,0002244,080,54,061,08000US540619098314775011805,"Census Tract 118.05 (part), Cheat Lake CDP, Eastern district, Monongalia County, West Virginia",169,154,81,23,16,42,73,15,0,0,0,0,0,0,15,0,0,0,0,15
ACSSF,2010e5,wv,000,0034,0002245,080,54,061,08000US540619098314775011806,"Census Tract 118.06 (part), Cheat Lake CDP, Eastern district, Monongalia County, West Virginia",1142,1000,371,100,86,185,629,142,61,45,38,0,7,16,81,13,0,0,13,68
ACSSF,2010e5,wv,000,0034,0002246,080,54,061,08000US540619098355756010102,"Census Tract 101.02 (part), Morgantown city (part), Eastern district, Monongalia County, West Virginia",28,0,0,0,0,0,0,28,0,0,0,0,0,0,28,28,0,28,0,0
ACSSF,2010e5,wv,000,0034,0002247,080,54,061,08000US540619098355756010201,"Census Tract 102.01 (part), Morgantown city (part), Eastern district, Monongalia County, West Virginia",26,26,0,0,0,0,26,0,0,0,0,0,0,0,0,0,0,0,0,0
ACSSF,2010e5,wv,000,0034,0002248,080,54,061,08000US540619098355756010202,"Census Tract 102.02 (part), Morgantown city (part), Eastern district, Monongalia County, West Virginia",0,0,0,0,0,0,0,0,0,0,0,0,0,0,0,0,0,0,0,0
ACSSF,2010e5,wv,000,0034,0002249,080,54,061,08000US540619098355756010400,"Census Tract 104 (part), Morgantown city (part), Eastern district, Monongalia County, West Virginia",0,0,0,0,0,0,0,0,0,0,0,0,0,0,0,0,0,0,0,0
ACSSF,2010e5,wv,000,0034,0002250,080,54,061,08000US540619098355756010600,"Census Tract 106 (part), Morgantown city (part), Eastern district, Monongalia County, West Virginia",0,0,0,0,0,0,0,0,0,0,0,0,0,0,0,0,0,0,0,0
ACSSF,2010e5,wv,000,0034,0002251,080,54,061,08000US540619098355756010700,"Census Tract 107 (part), Morgantown city (part), Eastern district, Monongalia County, West Virginia",0,0,0,0,0,0,0,0,0,0,0,0,0,0,0,0,0,0,0,0
ACSSF,2010e5,wv,000,0034,0002252,080,54,061,08000US540619098355756010800,"Census Tract 108 (part), Morgantown city (part), Eastern district, Monongalia County, West Virginia",38,0,0,0,0,0,0,38,38,0,0,0,0,38,0,0,0,0,0,0
ACSSF,2010e5,wv,000,0034,0002253,080,54,061,08000US540619098355756010902,"Census Tract 109.02 (part), Morgantown city (part), Eastern district, Monongalia County, West Virginia",0,0,0,0,0,0,0,0,0,0,0,0,0,0,0,0,0,0,0,0
ACSSF,2010e5,wv,000,0034,0002254,080,54,061,08000US540619098355756011000,"Census Tract 110 (part), Morgantown city (part), Eastern district, Monongalia County, West Virginia",161,118,40,0,8,32,78,43,0,0,0,0,0,0,43,9,0,0,9,34
ACSSF,2010e5,wv,000,0034,0002255,080,54,061,08000US540619098355756011600,"Census Tract 116 (part), Morgantown city (part), Eastern district, Monongalia County, West Virginia",0,0,0,0,0,0,0,0,0,0,0,0,0,0,0,0,0,0,0,0
ACSSF,2010e5,wv,000,0034,0002256,080,54,061,08000US540619098355756011805,"Census Tract 118.05 (part), Morgantown city (part), Eastern district, Monongalia County, West Virginia",0,0,0,0,0,0,0,0,0,0,0,0,0,0,0,0,0,0,0,0
ACSSF,2010e5,wv,000,0034,0002257,080,54,061,08000US540619098355756012000,"Census Tract 120 (part), Morgantown city (part), Eastern district, Monongalia County, West Virginia",0,0,0,0,0,0,0,0,0,0,0,0,0,0,0,0,0,0,0,0
ACSSF,2010e5,wv,000,0034,0002258,080,54,061,08000US540619098399999010102,"Census Tract 101.02 (part), Remainder of Eastern district, Eastern district, Monongalia County, West Virginia",0,0,0,0,0,0,0,0,0,0,0,0,0,0,0,0,0,0,0,0
ACSSF,2010e5,wv,000,0034,0002259,080,54,061,08000US540619098399999010201,"Census Tract 102.01 (part), Remainder of Eastern district, Eastern district, Monongalia County, West Virginia",259,207,74,20,18,36,133,52,36,0,0,0,0,36,16,16,0,8,8,0
ACSSF,2010e5,wv,000,0034,0002260,080,54,061,08000US540619098399999010202,"Census Tract 102.02 (part), Remainder of Eastern district, Eastern district, Monongalia County, West Virginia",141,120,21,0,0,21,99,21,0,0,0,0,0,0,21,0,0,0,0,21
ACSSF,2010e5,wv,000,0034,0002261,080,54,061,08000US540619098399999010400,"Census Tract 104 (part), Remainder of Eastern district, Eastern district, Monongalia County, West Virginia",81,55,22,0,0,22,33,26,0,0,0,0,0,0,26,0,0,0,0,26
ACSSF,2010e5,wv,000,0034,0002262,080,54,061,08000US540619098399999010600,"Census Tract 106 (part), Remainder of Eastern district, Eastern district, Monongalia County, West Virginia",949,724,316,189,2,125,408,225,56,0,0,0,0,56,169,125,60,0,65,44
ACSSF,2010e5,wv,000,0034,0002263,080,54,061,08000US540619098399999010700,"Census Tract 107 (part), Remainder of Eastern district, Eastern district, Monongalia County, West Virginia",26,26,0,0,0,0,26,0,0,0,0,0,0,0,0,0,0,0,0,0
ACSSF,2010e5,wv,000,0034,0002264,080,54,061,08000US540619098399999010800,"Census Tract 108 (part), Remainder of Eastern district, Eastern district, Monongalia County, West Virginia",765,614,284,103,69,112,330,151,61,0,0,0,0,61,90,74,9,0,65,16
ACSSF,2010e5,wv,000,0034,0002265,080,54,061,08000US540619098399999010902,"Census Tract 109.02 (part), Remainder of Eastern district, Eastern district, Monongalia County, West Virginia",221,190,73,45,7,21,117,31,25,20,0,0,20,5,6,6,0,0,6,0
ACSSF,2010e5,wv,000,0034,0002266,080,54,061,08000US540619098399999011000,"Census Tract 110 (part), Remainder of Eastern district, Eastern district, Monongalia County, West Virginia",99,16,16,16,0,0,0,83,10,10,10,0,0,0,73,48,9,0,39,25
ACSSF,2010e5,wv,000,0034,0002267,080,54,061,08000US540619098399999011100,"Census Tract 111 (part), Remainder of Eastern district, Eastern district, Monongalia County, West Virginia",0,0,0,0,0,0,0,0,0,0,0,0,0,0,0,0,0,0,0,0
ACSSF,2010e5,wv,000,0034,0002268,080,54,061,08000US540619098399999011600,"Census Tract 116 (part), Remainder of Eastern district, Eastern district, Monongalia County, West Virginia",1019,879,348,86,106,156,531,140,23,0,0,0,0,23,117,35,21,0,14,82
ACSSF,2010e5,wv,000,0034,0002269,080,54,061,08000US540619098399999011700,"Census Tract 117 (part), Remainder of Eastern district, Eastern district, Monongalia County, West Virginia",153,133,54,20,0,34,79,20,20,0,0,0,0,20,0,0,0,0,0,0
ACSSF,2010e5,wv,000,0034,0002270,080,54,061,08000US540619098399999011803,"Census Tract 118.03 (part), Remainder of Eastern district, Eastern district, Monongalia County, West Virginia",223,223,47,0,12,35,176,0,0,0,0,0,0,0,0,0,0,0,0,0
ACSSF,2010e5,wv,000,0034,0002271,080,54,061,08000US540619098399999011805,"Census Tract 118.05 (part), Remainder of Eastern district, Eastern district, Monongalia County, West Virginia",30,30,30,0,17,13,0,0,0,0,0,0,0,0,0,0,0,0,0,0
ACSSF,2010e5,wv,000,0034,0002272,080,54,061,08000US540619098399999011806,"Census Tract 118.06 (part), Remainder of Eastern district, Eastern district, Monongalia County, West Virginia",41,41,12,0,0,12,29,0,0,0,0,0,0,0,0,0,0,0,0,0
ACSSF,2010e5,wv,000,0034,0002273,080,54,061,08000US540619098399999012000,"Census Tract 120 (part), Remainder of Eastern district, Eastern district, Monongalia County, West Virginia",219,164,111,63,29,19,53,55,46,46,0,0,46,0,9,0,0,0,0,9
ACSSF,2010e5,wv,000,0034,0002274,080,54,061,08000US540619361208092011400,"Census Tract 114 (part), Blacksville town, Western district, Monongalia County, West Virginia",33,21,7,0,3,4,14,12,4,0,0,0,0,4,8,2,0,0,2,6
ACSSF,2010e5,wv,000,0034,0002275,080,54,061,08000US540619361210420011803,"Census Tract 118.03 (part), Brookhaven CDP (part), Western district, Monongalia County, West Virginia",10,10,10,0,10,0,0,0,0,0,0,0,0,0,0,0,0,0,0,0
ACSSF,2010e5,wv,000,0034,0002276,080,54,061,08000US540619361213756011500,"Census Tract 115 (part), Cassville CDP, Western district, Monongalia County, West Virginia",248,248,97,28,53,16,151,0,0,0,0,0,0,0,0,0,0,0,0,0
ACSSF,2010e5,wv,000,0034,0002277,080,54,061,08000US540619361232932011200,"Census Tract 112 (part), Granville town, Western district, Monongalia County, West Virginia",146,114,30,4,0,26,84,32,15,5,0,5,0,10,17,5,0,0,5,12
ACSSF,2010e5,wv,000,0034,0002278,080,54,061,08000US540619361255756010400,"Census Tract 104 (part), Morgantown city (part), Western district, Monongalia County, West Virginia",0,0,0,0,0,0,0,0,0,0,0,0,0,0,0,0,0,0,0,0
ACSSF,2010e5,wv,000,0034,0002279,080,54,061,08000US540619361255756011000,"Census Tract 110 (part), Morgantown city (part), Western district, Monongalia County, West Virginia",0,0,0,0,0,0,0,0,0,0,0,0,0,0,0,0,0,0,0,0
ACSSF,2010e5,wv,000,0034,0002280,080,54,061,08000US540619361255756011500,"Census Tract 115 (part), Morgantown city (part), Western district, Monongalia County, West Virginia",0,0,0,0,0,0,0,0,0,0,0,0,0,0,0,0,0,0,0,0
ACSSF,2010e5,wv,000,0034,0002281,080,54,061,08000US540619361255756011804,"Census Tract 118.04 (part), Morgantown city (part), Western district, Monongalia County, West Virginia",15,15,15,15,0,0,0,0,0,0,0,0,0,0,0,0,0,0,0,0
ACSSF,2010e5,wv,000,0034,0002282,080,54,061,08000US540619361262788011400,"Census Tract 114 (part), Pentress CDP, Western district, Monongalia County, West Virginia",45,45,32,19,0,13,13,0,0,0,0,0,0,0,0,0,0,0,0,0
ACSSF,2010e5,wv,000,0034,0002283,080,54,061,08000US540619361262788011500,"Census Tract 115 (part), Pentress CDP, Western district, Monongalia County, West Virginia",13,13,0,0,0,0,13,0,0,0,0,0,0,0,0,0,0,0,0,0
ACSSF,2010e5,wv,000,0034,0002284,080,54,061,08000US540619361276516010400,"Census Tract 104 (part), Star City town (part), Western district, Monongalia County, West Virginia",0,0,0,0,0,0,0,0,0,0,0,0,0,0,0,0,0,0,0,0
ACSSF,2010e5,wv,000,0034,0002285,080,54,061,08000US540619361276516011200,"Census Tract 112 (part), Star City town (part), Western district, Monongalia County, West Virginia",0,0,0,0,0,0,0,0,0,0,0,0,0,0,0,0,0,0,0,0
ACSSF,2010e5,wv,000,0034,0002286,080,54,061,08000US540619361276516011500,"Census Tract 115 (part), Star City town (part), Western district, Monongalia County, West Virginia",0,0,0,0,0,0,0,0,0,0,0,0,0,0,0,0,0,0,0,0
ACSSF,2010e5,wv,000,0034,0002287,080,54,061,08000US540619361285996011100,"Census Tract 111 (part), Westover city, Western district, Monongalia County, West Virginia",515,361,99,4,33,62,262,154,8,8,0,0,8,0,146,112,34,0,78,34
ACSSF,2010e5,wv,000,0034,0002288,080,54,061,08000US540619361285996011200,"Census Tract 112 (part), Westover city, Western district, Monongalia County, West Virginia",466,342,117,41,32,44,225,124,51,11,11,0,0,40,73,34,10,10,14,39
ACSSF,2010e5,wv,000,0034,0002289,080,54,061,08000US540619361299999010400,"Census Tract 104 (part), Remainder of Western district, Western district, Monongalia County, West Virginia",0,0,0,0,0,0,0,0,0,0,0,0,0,0,0,0,0,0,0,0
ACSSF,2010e5,wv,000,0034,0002290,080,54,061,08000US540619361299999011000,"Census Tract 110 (part), Remainder of Western district, Western district, Monongalia County, West Virginia",72,41,17,17,0,0,24,31,0,0,0,0,0,0,31,9,0,0,9,22
ACSSF,2010e5,wv,000,0034,0002291,080,54,061,08000US540619361299999011100,"Census Tract 111 (part), Remainder of Western district, Western district, Monongalia County, West Virginia",100,90,24,8,0,16,66,10,10,0,0,0,0,10,0,0,0,0,0,0
ACSSF,2010e5,wv,000,0034,0002292,080,54,061,08000US540619361299999011200,"Census Tract 112 (part), Remainder of Western district, Western district, Monongalia County, West Virginia",80,40,15,0,0,15,25,40,0,0,0,0,0,0,40,13,0,0,13,27
ACSSF,2010e5,wv,000,0034,0002293,080,54,061,08000US540619361299999011300,"Census Tract 113, Remainder of Western district, Western district, Monongalia County, West Virginia",1104,865,332,117,34,181,533,239,134,61,0,0,61,73,105,59,0,0,59,46
ACSSF,2010e5,wv,000,0034,0002294,080,54,061,08000US540619361299999011400,"Census Tract 114 (part), Remainder of Western district, Western district, Monongalia County, West Virginia",1079,945,296,30,25,241,649,134,36,36,21,0,15,0,98,36,0,0,36,62
ACSSF,2010e5,wv,000,0034,0002295,080,54,061,08000US540619361299999011500,"Census Tract 115 (part), Remainder of Western district, Western district, Monongalia County, West Virginia",1085,887,338,61,59,218,549,198,56,16,0,0,16,40,142,88,39,23,26,54
ACSSF,2010e5,wv,000,0034,0002296,080,54,061,08000US540619361299999011803,"Census Tract 118.03 (part), Remainder of Western district, Western district, Monongalia County, West Virginia",221,211,82,27,0,55,129,10,0,0,0,0,0,0,10,10,0,0,10,0
ACSSF,2010e5,wv,000,0034,0002297,080,54,061,08000US540619361299999011804,"Census Tract 118.04 (part), Remainder of Western district, Western district, Monongalia County, West Virginia",940,830,295,63,50,182,535,110,10,0,0,0,0,10,100,65,12,40,13,35
ACSSF,2010e5,wv,000,0034,0002298,080,54,061,08000US540619361299999011900,"Census Tract 119, Remainder of Western district, Western district, Monongalia County, West Virginia",958,870,421,96,117,208,449,88,15,0,0,0,0,15,73,31,8,0,23,42
ACSSF,2010e5,wv,000,0034,0002299,080,54,063,08000US540639045781940950200,"Census Tract 9502 (part), Union town, Central district, Monroe County, West Virginia",125,78,36,5,0,31,42,47,30,17,0,0,17,13,17,8,0,8,0,9
ACSSF,2010e5,wv,000,0034,0002300,080,54,063,08000US540639045799999950100,"Census Tract 9501 (part), Remainder of Central district, Central district, Monroe County, West Virginia",44,31,0,0,0,0,31,13,13,0,0,0,0,13,0,0,0,0,0,0
ACSSF,2010e5,wv,000,0034,0002301,080,54,063,08000US540639045799999950200,"Census Tract 9502 (part), Remainder of Central district, Central district, Monroe County, West Virginia",1018,875,196,98,10,88,679,143,58,27,0,0,27,31,85,61,61,0,0,24
ACSSF,2010e5,wv,000,0034,0002302,080,54,063,08000US540639045799999950300,"Census Tract 9503 (part), Remainder of Central district, Central district, Monroe County, West Virginia",195,173,66,25,0,41,107,22,0,0,0,0,0,0,22,22,0,0,22,0
ACSSF,2010e5,wv,000,0034,0002303,080,54,063,08000US540639098400772950200,"Census Tract 9502 (part), Alderson town (part), Eastern district, Monroe County, West Virginia",72,32,17,12,5,0,15,40,3,0,0,0,0,3,37,16,0,0,16,21
ACSSF,2010e5,wv,000,0034,0002304,080,54,063,08000US540639098499999950100,"Census Tract 9501 (part), Remainder of Eastern district, Eastern district, Monroe County, West Virginia",959,847,266,48,52,166,581,112,48,27,0,0,27,21,64,0,0,0,0,64
ACSSF,2010e5,wv,000,0034,0002305,080,54,063,08000US540639098499999950200,"Census Tract 9502 (part), Remainder of Eastern district, Eastern district, Monroe County, West Virginia",220,187,54,15,39,0,133,33,13,0,0,0,0,13,20,0,0,0,0,20
ACSSF,2010e5,wv,000,0034,0002306,080,54,063,08000US540639361363052950300,"Census Tract 9503 (part), Peterstown town, Western district, Monroe County, West Virginia",130,87,48,6,7,35,39,43,7,0,0,0,0,7,36,8,0,3,5,28
ACSSF,2010e5,wv,000,0034,0002307,080,54,063,08000US540639361399999950200,"Census Tract 9502 (part), Remainder of Western district, Western district, Monroe County, West Virginia",0,0,0,0,0,0,0,0,0,0,0,0,0,0,0,0,0,0,0,0
ACSSF,2010e5,wv,000,0034,0002308,080,54,063,08000US540639361399999950300,"Census Tract 9503 (part), Remainder of Western district, Western district, Monroe County, West Virginia",1159,987,282,90,50,142,705,172,26,0,0,0,0,26,146,36,0,0,36,110
ACSSF,2010e5,wv,000,0034,0002309,080,54,065,08000US540659078604876970800,"Census Tract 9708 (part), Bath (Berkeley Springs) town (part), District 1, Morgan County, West Virginia",3,3,0,0,0,0,3,0,0,0,0,0,0,0,0,0,0,0,0,0
ACSSF,2010e5,wv,000,0034,0002310,080,54,065,08000US540659078633100970900,"Census Tract 9709 (part), Great Cacapon CDP, District 1, Morgan County, West Virginia",107,92,33,0,13,20,59,15,0,0,0,0,0,0,15,0,0,0,0,15
ACSSF,2010e5,wv,000,0034,0002311,080,54,065,08000US540659078662332970900,"Census Tract 9709 (part), Paw Paw town, District 1, Morgan County, West Virginia",92,51,5,0,0,5,46,41,0,0,0,0,0,0,41,23,6,0,17,18
ACSSF,2010e5,wv,000,0034,0002312,080,54,065,08000US540659078699999970800,"Census Tract 9708 (part), District Remainder of 1, District 1, Morgan County, West Virginia",227,159,38,0,0,38,121,68,29,5,0,0,5,24,39,39,0,0,39,0
ACSSF,2010e5,wv,000,0034,0002313,080,54,065,08000US540659078699999970900,"Census Tract 9709 (part), District Remainder of 1, District 1, Morgan County, West Virginia",409,277,70,0,0,70,207,132,24,0,0,0,0,24,108,47,0,0,47,61
ACSSF,2010e5,wv,000,0034,0002314,080,54,065,08000US540659078699999971000,"Census Tract 9710 (part), District Remainder of 1, District 1, Morgan County, West Virginia",376,297,73,0,24,49,224,79,0,0,0,0,0,0,79,41,0,0,41,38
ACSSF,2010e5,wv,000,0034,0002315,080,54,065,08000US540659082204876970800,"Census Tract 9708 (part), Bath (Berkeley Springs) town (part), District 2, Morgan County, West Virginia",152,112,44,4,18,22,68,40,2,0,0,0,0,2,38,20,0,6,14,18
ACSSF,2010e5,wv,000,0034,0002316,080,54,065,08000US540659082299999970700,"Census Tract 9707 (part), District Remainder of 2, District 2, Morgan County, West Virginia",18,0,0,0,0,0,0,18,0,0,0,0,0,0,18,18,0,0,18,0
ACSSF,2010e5,wv,000,0034,0002317,080,54,065,08000US540659082299999970800,"Census Tract 9708 (part), District Remainder of 2, District 2, Morgan County, West Virginia",468,415,127,16,64,47,288,53,9,9,0,0,9,0,44,36,0,0,36,8
ACSSF,2010e5,wv,000,0034,0002318,080,54,065,08000US540659082299999971000,"Census Tract 9710 (part), District Remainder of 2, District 2, Morgan County, West Virginia",601,473,68,43,0,25,405,128,25,0,0,0,0,25,103,48,0,28,20,55
ACSSF,2010e5,wv,000,0034,0002319,080,54,065,08000US540659085899999970700,"Census Tract 9707 (part), District 3, District 3, Morgan County, West Virginia",1616,1327,507,63,111,333,820,289,181,136,59,10,67,45,108,63,0,0,63,45
ACSSF,2010e5,wv,000,0034,0002320,080,54,065,08000US540659085899999970800,"Census Tract 9708 (part), District 3, District 3, Morgan County, West Virginia",0,0,0,0,0,0,0,0,0,0,0,0,0,0,0,0,0,0,0,0
ACSSF,2010e5,wv,000,0034,0002321,080,54,065,08000US540659085899999971000,"Census Tract 9710 (part), District 3, District 3, Morgan County, West Virginia",13,13,0,0,0,0,13,0,0,0,0,0,0,0,0,0,0,0,0,0
ACSSF,2010e5,wv,000,0034,0002322,080,54,067,08000US540679013218604950400,"Census Tract 9504 (part), Craigsville CDP, Beaver district, Nicholas County, West Virginia",836,703,298,91,105,102,405,133,51,21,0,0,21,30,82,44,19,0,25,38
ACSSF,2010e5,wv,000,0034,0002323,080,54,067,08000US540679013227196950500,"Census Tract 9505 (part), Fenwick CDP, Beaver district, Nicholas County, West Virginia",50,28,14,0,0,14,14,22,0,0,0,0,0,0,22,0,0,0,0,22
ACSSF,2010e5,wv,000,0034,0002324,080,54,067,08000US540679013268116950500,"Census Tract 9505 (part), Richwood city, Beaver district, Nicholas County, West Virginia",331,240,36,19,10,7,204,91,33,23,8,0,15,10,58,22,7,13,2,36
ACSSF,2010e5,wv,000,0034,0002325,080,54,067,08000US540679013268116950600,"Census Tract 9506 (part), Richwood city, Beaver district, Nicholas County, West Virginia",285,186,51,15,24,12,135,99,22,14,0,0,14,8,77,49,11,38,0,28
ACSSF,2010e5,wv,000,0034,0002326,080,54,067,08000US540679013280476950100,"Census Tract 9501 (part), Tioga CDP, Beaver district, Nicholas County, West Virginia",26,8,0,0,0,0,8,18,0,0,0,0,0,0,18,0,0,0,0,18
ACSSF,2010e5,wv,000,0034,0002327,080,54,067,08000US540679013280476950400,"Census Tract 9504 (part), Tioga CDP, Beaver district, Nicholas County, West Virginia",0,0,0,0,0,0,0,0,0,0,0,0,0,0,0,0,0,0,0,0
ACSSF,2010e5,wv,000,0034,0002328,080,54,067,08000US540679013299999950100,"Census Tract 9501 (part), Remainder of Beaver district, Beaver district, Nicholas County, West Virginia",24,24,8,8,0,0,16,0,0,0,0,0,0,0,0,0,0,0,0,0
ACSSF,2010e5,wv,000,0034,0002329,080,54,067,08000US540679013299999950400,"Census Tract 9504 (part), Remainder of Beaver district, Beaver district, Nicholas County, West Virginia",574,502,154,41,0,113,348,72,36,30,30,0,0,6,36,16,0,0,16,20
ACSSF,2010e5,wv,000,0034,0002330,080,54,067,08000US540679013299999950500,"Census Tract 9505 (part), Remainder of Beaver district, Beaver district, Nicholas County, West Virginia",123,106,27,0,0,27,79,17,17,0,0,0,0,17,0,0,0,0,0,0
ACSSF,2010e5,wv,000,0034,0002331,080,54,067,08000US540679013299999950600,"Census Tract 9506 (part), Remainder of Beaver district, Beaver district, Nicholas County, West Virginia",6,6,0,0,0,0,6,0,0,0,0,0,0,0,0,0,0,0,0,0
ACSSF,2010e5,wv,000,0034,0002332,080,54,067,08000US540679134499999950200,"Census Tract 9502 (part), Grant district, Grant district, Nicholas County, West Virginia",393,253,94,0,0,94,159,140,84,65,0,0,65,19,56,0,0,0,0,56
ACSSF,2010e5,wv,000,0034,0002333,080,54,067,08000US540679134499999950300,"Census Tract 9503 (part), Grant district, Grant district, Nicholas County, West Virginia",0,0,0,0,0,0,0,0,0,0,0,0,0,0,0,0,0,0,0,0
ACSSF,2010e5,wv,000,0034,0002334,080,54,067,08000US540679150007756950100,"Census Tract 9501 (part), Birch River CDP, Hamilton district, Nicholas County, West Virginia",72,62,0,0,0,0,62,10,0,0,0,0,0,0,10,0,0,0,0,10
ACSSF,2010e5,wv,000,0034,0002335,080,54,067,08000US540679150099999950100,"Census Tract 9501 (part), Remainder of Hamilton district, Hamilton district, Nicholas County, West Virginia",707,622,196,25,43,128,426,85,76,38,12,0,26,38,9,0,0,0,0,9
ACSSF,2010e5,wv,000,0034,0002336,080,54,067,08000US540679150099999950200,"Census Tract 9502 (part), Remainder of Hamilton district, Hamilton district, Nicholas County, West Virginia",16,16,0,0,0,0,16,0,0,0,0,0,0,0,0,0,0,0,0,0
ACSSF,2010e5,wv,000,0034,0002337,080,54,067,08000US540679150099999950400,"Census Tract 9504 (part), Remainder of Hamilton district, Hamilton district, Nicholas County, West Virginia",40,40,15,15,0,0,25,0,0,0,0,0,0,0,0,0,0,0,0,0
ACSSF,2010e5,wv,000,0034,0002338,080,54,067,08000US540679171606052950300,"Census Tract 9503 (part), Belva CDP, Jefferson district, Nicholas County, West Virginia",8,0,0,0,0,0,0,8,0,0,0,0,0,0,8,8,0,0,8,0
ACSSF,2010e5,wv,000,0034,0002339,080,54,067,08000US540679171621628950300,"Census Tract 9503 (part), Dixie CDP (part), Jefferson district, Nicholas County, West Virginia",68,68,53,0,0,53,15,0,0,0,0,0,0,0,0,0,0,0,0,0
ACSSF,2010e5,wv,000,0034,0002340,080,54,067,08000US540679171699999950200,"Census Tract 9502 (part), Remainder of Jefferson district, Jefferson district, Nicholas County, West Virginia",52,11,0,0,0,0,11,41,41,20,0,0,20,21,0,0,0,0,0,0
ACSSF,2010e5,wv,000,0034,0002341,080,54,067,08000US540679171699999950300,"Census Tract 9503 (part), Remainder of Jefferson district, Jefferson district, Nicholas County, West Virginia",335,285,87,0,22,65,198,50,21,0,0,0,0,21,29,15,0,0,15,14
ACSSF,2010e5,wv,000,0034,0002342,080,54,067,08000US540679175258180950600,"Census Tract 9506 (part), Nettie CDP, Kentucky district, Nicholas County, West Virginia",266,266,54,0,0,54,212,0,0,0,0,0,0,0,0,0,0,0,0,0
ACSSF,2010e5,wv,000,0034,0002343,080,54,067,08000US540679175299999950600,"Census Tract 9506 (part), Remainder of Kentucky district, Kentucky district, Nicholas County, West Virginia",1036,834,365,100,65,200,469,202,97,78,15,0,63,19,105,0,0,0,0,105
ACSSF,2010e5,wv,000,0034,0002344,080,54,067,08000US540679307277980950200,"Census Tract 9502 (part), Summersville town (part), Summersville district, Nicholas County, West Virginia",1093,942,319,29,0,290,623,151,39,0,0,0,0,39,112,16,0,0,16,96
ACSSF,2010e5,wv,000,0034,0002345,080,54,067,08000US540679307299999950100,"Census Tract 9501 (part), Remainder of Summersville district, Summersville district, Nicholas County, West Virginia",60,60,23,0,0,23,37,0,0,0,0,0,0,0,0,0,0,0,0,0
ACSSF,2010e5,wv,000,0034,0002346,080,54,067,08000US540679307299999950200,"Census Tract 9502 (part), Remainder of Summersville district, Summersville district, Nicholas County, West Virginia",370,300,116,0,0,116,184,70,0,0,0,0,0,0,70,52,0,0,52,18
ACSSF,2010e5,wv,000,0034,0002347,080,54,067,08000US540679366077980950700,"Census Tract 9507 (part), Summersville town (part), Wilderness district, Nicholas County, West Virginia",0,0,0,0,0,0,0,0,0,0,0,0,0,0,0,0,0,0,0,0
ACSSF,2010e5,wv,000,0034,0002348,080,54,067,08000US540679366099999950600,"Census Tract 9506 (part), Remainder of Wilderness district, Wilderness district, Nicholas County, West Virginia",33,33,20,0,0,20,13,0,0,0,0,0,0,0,0,0,0,0,0,0
ACSSF,2010e5,wv,000,0034,0002349,080,54,067,08000US540679366099999950700,"Census Tract 9507 (part), Remainder of Wilderness district, Wilderness district, Nicholas County, West Virginia",867,768,223,49,56,118,545,99,18,11,11,0,0,7,81,15,0,0,15,66
ACSSF,2010e5,wv,000,0034,0002350,080,54,069,08000US540699078815916002000,"Census Tract 20 (part), Clearview village, District 1, Ohio County, West Virginia",204,178,47,3,6,38,131,26,0,0,0,0,0,0,26,13,9,4,0,13
ACSSF,2010e5,wv,000,0034,0002351,080,54,069,08000US540699078880932001800,"Census Tract 18 (part), Triadelphia town, District 1, Ohio County, West Virginia",0,0,0,0,0,0,0,0,0,0,0,0,0,0,0,0,0,0,0,0
ACSSF,2010e5,wv,000,0034,0002352,080,54,069,08000US540699078880932002100,"Census Tract 21 (part), Triadelphia town, District 1, Ohio County, West Virginia",65,47,13,4,9,0,34,18,0,0,0,0,0,0,18,18,18,0,0,0
ACSSF,2010e5,wv,000,0034,0002353,080,54,069,08000US540699078880932002200,"Census Tract 22 (part), Triadelphia town, District 1, Ohio County, West Virginia",184,155,36,15,0,21,119,29,29,19,19,0,0,10,0,0,0,0,0,0
ACSSF,2010e5,wv,000,0034,0002354,080,54,069,08000US540699078882732002100,"Census Tract 21 (part), Valley Grove village, District 1, Ohio County, West Virginia",85,64,23,5,0,18,41,21,2,0,0,0,0,2,19,19,3,0,16,0
ACSSF,2010e5,wv,000,0034,0002355,080,54,069,08000US540699078882732002200,"Census Tract 22 (part), Valley Grove village, District 1, Ohio County, West Virginia",30,30,12,0,8,4,18,0,0,0,0,0,0,0,0,0,0,0,0,0
ACSSF,2010e5,wv,000,0034,0002356,080,54,069,08000US540699078885876002000,"Census Tract 20 (part), West Liberty town, District 1, Ohio County, West Virginia",3,3,0,0,0,0,3,0,0,0,0,0,0,0,0,0,0,0,0,0
ACSSF,2010e5,wv,000,0034,0002357,080,54,069,08000US540699078885876002100,"Census Tract 21 (part), West Liberty town, District 1, Ohio County, West Virginia",68,54,8,0,3,5,46,14,4,0,0,0,0,4,10,0,0,0,0,10
ACSSF,2010e5,wv,000,0034,0002358,080,54,069,08000US540699078886452000200,"Census Tract 2 (part), Wheeling city (part), District 1, Ohio County, West Virginia",928,697,199,29,24,146,498,231,32,19,0,0,19,13,199,121,18,0,103,78
ACSSF,2010e5,wv,000,0034,0002359,080,54,069,08000US540699078886452000400,"Census Tract 4 (part), Wheeling city (part), District 1, Ohio County, West Virginia",11,11,11,0,11,0,0,0,0,0,0,0,0,0,0,0,0,0,0,0
ACSSF,2010e5,wv,000,0034,0002360,080,54,069,08000US540699078886452001500,"Census Tract 15 (part), Wheeling city (part), District 1, Ohio County, West Virginia",10,10,0,0,0,0,10,0,0,0,0,0,0,0,0,0,0,0,0,0
ACSSF,2010e5,wv,000,0034,0002361,080,54,069,08000US540699078886452001700,"Census Tract 17 (part), Wheeling city (part), District 1, Ohio County, West Virginia",160,87,40,18,0,22,47,73,0,0,0,0,0,0,73,43,0,33,10,30
ACSSF,2010e5,wv,000,0034,0002362,080,54,069,08000US540699078886452002000,"Census Tract 20 (part), Wheeling city (part), District 1, Ohio County, West Virginia",215,215,104,0,13,91,111,0,0,0,0,0,0,0,0,0,0,0,0,0
ACSSF,2010e5,wv,000,0034,0002363,080,54,069,08000US540699078899999000200,"Census Tract 2 (part), District Remainder of 1, District 1, Ohio County, West Virginia",8,0,0,0,0,0,0,8,0,0,0,0,0,0,8,8,0,0,8,0
ACSSF,2010e5,wv,000,0034,0002364,080,54,069,08000US540699078899999000300,"Census Tract 3 (part), District Remainder of 1, District 1, Ohio County, West Virginia",0,0,0,0,0,0,0,0,0,0,0,0,0,0,0,0,0,0,0,0
ACSSF,2010e5,wv,000,0034,0002365,080,54,069,08000US540699078899999001500,"Census Tract 15 (part), District Remainder of 1, District 1, Ohio County, West Virginia",52,52,38,0,38,0,14,0,0,0,0,0,0,0,0,0,0,0,0,0
ACSSF,2010e5,wv,000,0034,0002366,080,54,069,08000US540699078899999001600,"Census Tract 16 (part), District Remainder of 1, District 1, Ohio County, West Virginia",0,0,0,0,0,0,0,0,0,0,0,0,0,0,0,0,0,0,0,0
ACSSF,2010e5,wv,000,0034,0002367,080,54,069,08000US540699078899999001700,"Census Tract 17 (part), District Remainder of 1, District 1, Ohio County, West Virginia",0,0,0,0,0,0,0,0,0,0,0,0,0,0,0,0,0,0,0,0
ACSSF,2010e5,wv,000,0034,0002368,080,54,069,08000US540699078899999001800,"Census Tract 18 (part), District Remainder of 1, District 1, Ohio County, West Virginia",73,46,0,0,0,0,46,27,13,13,0,0,13,0,14,14,14,0,0,0
ACSSF,2010e5,wv,000,0034,0002369,080,54,069,08000US540699078899999002000,"Census Tract 20 (part), District Remainder of 1, District 1, Ohio County, West Virginia",1138,1015,537,74,104,359,478,123,12,0,0,0,0,12,111,56,10,0,46,55
ACSSF,2010e5,wv,000,0034,0002370,080,54,069,08000US540699078899999002100,"Census Tract 21 (part), District Remainder of 1, District 1, Ohio County, West Virginia",643,625,166,22,67,77,459,18,0,0,0,0,0,0,18,18,18,0,0,0
ACSSF,2010e5,wv,000,0034,0002371,080,54,069,08000US540699078899999002200,"Census Tract 22 (part), District Remainder of 1, District 1, Ohio County, West Virginia",585,523,140,12,40,88,383,62,11,0,0,0,0,11,51,20,0,0,20,31
ACSSF,2010e5,wv,000,0034,0002372,080,54,069,08000US540699082486452000300,"Census Tract 3 (part), Wheeling city (part), District 2, Ohio County, West Virginia",437,277,85,44,0,41,192,160,44,44,15,0,29,0,116,85,51,26,8,31
ACSSF,2010e5,wv,000,0034,0002373,080,54,069,08000US540699082486452000400,"Census Tract 4 (part), Wheeling city (part), District 2, Ohio County, West Virginia",261,193,43,0,0,43,150,68,24,0,0,0,0,24,44,20,0,0,20,24
ACSSF,2010e5,wv,000,0034,0002374,080,54,069,08000US540699082486452000500,"Census Tract 5, Wheeling city (part), District 2, Ohio County, West Virginia",379,286,84,0,15,69,202,93,33,23,11,0,12,10,60,30,11,0,19,30
ACSSF,2010e5,wv,000,0034,0002375,080,54,069,08000US540699082486452000600,"Census Tract 6, Wheeling city (part), District 2, Ohio County, West Virginia",302,87,30,0,6,24,57,215,20,2,0,0,2,18,195,138,64,39,35,57
ACSSF,2010e5,wv,000,0034,0002376,080,54,069,08000US540699082486452000700,"Census Tract 7, Wheeling city (part), District 2, Ohio County, West Virginia",174,83,17,17,0,0,66,91,9,9,0,0,9,0,82,46,0,46,0,36
ACSSF,2010e5,wv,000,0034,0002377,080,54,069,08000US540699082486452001300,"Census Tract 13 (part), Wheeling city (part), District 2, Ohio County, West Virginia",87,25,19,9,0,10,6,62,10,0,0,0,0,10,52,13,6,0,7,39
ACSSF,2010e5,wv,000,0034,0002378,080,54,069,08000US540699082486452001400,"Census Tract 14 (part), Wheeling city (part), District 2, Ohio County, West Virginia",125,60,27,0,0,27,33,65,16,0,0,0,0,16,49,44,0,0,44,5
ACSSF,2010e5,wv,000,0034,0002379,080,54,069,08000US540699082486452001500,"Census Tract 15 (part), Wheeling city (part), District 2, Ohio County, West Virginia",642,465,210,51,25,134,255,177,44,29,15,0,14,15,133,68,19,28,21,65
ACSSF,2010e5,wv,000,0034,0002380,080,54,069,08000US540699082486452001600,"Census Tract 16 (part), Wheeling city (part), District 2, Ohio County, West Virginia",163,131,34,34,0,0,97,32,0,0,0,0,0,0,32,11,0,0,11,21
ACSSF,2010e5,wv,000,0034,0002381,080,54,069,08000US540699082486452002600,"Census Tract 26 (part), Wheeling city (part), District 2, Ohio County, West Virginia",190,45,18,0,18,0,27,145,46,26,26,0,0,20,99,58,31,0,27,41
ACSSF,2010e5,wv,000,0034,0002382,080,54,069,08000US540699082486452002700,"Census Tract 27, Wheeling city (part), District 2, Ohio County, West Virginia",173,131,0,0,0,0,131,42,9,0,0,0,0,9,33,9,0,0,9,24
ACSSF,2010e5,wv,000,0034,0002383,080,54,069,08000US540699082499999001300,"Census Tract 13 (part), District Remainder of 2, District 2, Ohio County, West Virginia",166,145,49,0,20,29,96,21,0,0,0,0,0,0,21,21,0,0,21,0
ACSSF,2010e5,wv,000,0034,0002384,080,54,069,08000US540699082499999001500,"Census Tract 15 (part), District Remainder of 2, District 2, Ohio County, West Virginia",6,6,6,0,0,6,0,0,0,0,0,0,0,0,0,0,0,0,0,0
ACSSF,2010e5,wv,000,0034,0002385,080,54,069,08000US540699082499999002000,"Census Tract 20 (part), District Remainder of 2, District 2, Ohio County, West Virginia",0,0,0,0,0,0,0,0,0,0,0,0,0,0,0,0,0,0,0,0
ACSSF,2010e5,wv,000,0034,0002386,080,54,069,08000US540699086206940001800,"Census Tract 18 (part), Bethlehem village, District 3, Ohio County, West Virginia",26,26,16,0,0,16,10,0,0,0,0,0,0,0,0,0,0,0,0,0
ACSSF,2010e5,wv,000,0034,0002387,080,54,069,08000US540699086206940001901,"Census Tract 19.01, Bethlehem village, District 3, Ohio County, West Virginia",749,675,227,31,27,169,448,74,15,10,10,0,0,5,59,21,0,15,6,38
ACSSF,2010e5,wv,000,0034,0002388,080,54,069,08000US540699086286452001300,"Census Tract 13 (part), Wheeling city (part), District 3, Ohio County, West Virginia",174,115,31,18,0,13,84,59,0,0,0,0,0,0,59,36,0,14,22,23
ACSSF,2010e5,wv,000,0034,0002389,080,54,069,08000US540699086286452001400,"Census Tract 14 (part), Wheeling city (part), District 3, Ohio County, West Virginia",543,423,188,8,38,142,235,120,15,0,0,0,0,15,105,55,0,9,46,50
ACSSF,2010e5,wv,000,0034,0002390,080,54,069,08000US540699086286452001600,"Census Tract 16 (part), Wheeling city (part), District 3, Ohio County, West Virginia",425,374,115,18,0,97,259,51,0,0,0,0,0,0,51,28,0,0,28,23
ACSSF,2010e5,wv,000,0034,0002391,080,54,069,08000US540699086286452001700,"Census Tract 17 (part), Wheeling city (part), District 3, Ohio County, West Virginia",296,260,55,31,11,13,205,36,8,8,0,0,8,0,28,12,0,12,0,16
ACSSF,2010e5,wv,000,0034,0002392,080,54,069,08000US540699086286452001800,"Census Tract 18 (part), Wheeling city (part), District 3, Ohio County, West Virginia",1105,811,241,29,34,178,570,294,41,15,0,0,15,26,253,86,27,0,59,167
ACSSF,2010e5,wv,000,0034,0002393,080,54,069,08000US540699086286452002200,"Census Tract 22 (part), Wheeling city (part), District 3, Ohio County, West Virginia",0,0,0,0,0,0,0,0,0,0,0,0,0,0,0,0,0,0,0,0
ACSSF,2010e5,wv,000,0034,0002394,080,54,069,08000US540699086286452002600,"Census Tract 26 (part), Wheeling city (part), District 3, Ohio County, West Virginia",316,208,66,0,23,43,142,108,13,0,0,0,0,13,95,26,0,26,0,69
ACSSF,2010e5,wv,000,0034,0002395,080,54,069,08000US540699086299999001300,"Census Tract 13 (part), District Remainder of 3, District 3, Ohio County, West Virginia",36,22,9,0,0,9,13,14,0,0,0,0,0,0,14,0,0,0,0,14
ACSSF,2010e5,wv,000,0034,0002396,080,54,069,08000US540699086299999001600,"Census Tract 16 (part), District Remainder of 3, District 3, Ohio County, West Virginia",0,0,0,0,0,0,0,0,0,0,0,0,0,0,0,0,0,0,0,0
ACSSF,2010e5,wv,000,0034,0002397,080,54,069,08000US540699086299999001800,"Census Tract 18 (part), District Remainder of 3, District 3, Ohio County, West Virginia",249,228,101,16,28,57,127,21,0,0,0,0,0,0,21,9,0,0,9,12
ACSSF,2010e5,wv,000,0034,0002398,080,54,069,08000US540699086299999002000,"Census Tract 20 (part), District Remainder of 3, District 3, Ohio County, West Virginia",0,0,0,0,0,0,0,0,0,0,0,0,0,0,0,0,0,0,0,0
ACSSF,2010e5,wv,000,0034,0002399,080,54,071,08000US540719046229044970500,"Census Tract 9705 (part), Franklin town, Central district, Pendleton County, West Virginia",212,133,57,16,9,32,76,79,3,0,0,0,0,3,76,25,9,0,16,51
ACSSF,2010e5,wv,000,0034,0002400,080,54,071,08000US540719046299999970400,"Census Tract 9704 (part), Remainder of Central district, Central district, Pendleton County, West Virginia",0,0,0,0,0,0,0,0,0,0,0,0,0,0,0,0,0,0,0,0
ACSSF,2010e5,wv,000,0034,0002401,080,54,071,08000US540719046299999970500,"Census Tract 9705 (part), Remainder of Central district, Central district, Pendleton County, West Virginia",542,505,152,0,40,112,353,37,14,0,0,0,0,14,23,0,0,0,0,23
ACSSF,2010e5,wv,000,0034,0002402,080,54,071,08000US540719046299999970600,"Census Tract 9706 (part), Remainder of Central district, Central district, Pendleton County, West Virginia",0,0,0,0,0,0,0,0,0,0,0,0,0,0,0,0,0,0,0,0
ACSSF,2010e5,wv,000,0034,0002403,080,54,071,08000US540719098709868970600,"Census Tract 9706 (part), Brandywine CDP, Eastern district, Pendleton County, West Virginia",113,99,42,0,31,11,57,14,0,0,0,0,0,0,14,0,0,0,0,14
ACSSF,2010e5,wv,000,0034,0002404,080,54,071,08000US540719098799999970500,"Census Tract 9705 (part), Remainder of Eastern district, Eastern district, Pendleton County, West Virginia",118,91,16,0,0,16,75,27,27,27,0,0,27,0,0,0,0,0,0,0
ACSSF,2010e5,wv,000,0034,0002405,080,54,071,08000US540719098799999970600,"Census Tract 9706 (part), Remainder of Eastern district, Eastern district, Pendleton County, West Virginia",489,397,112,40,55,17,285,92,21,21,21,0,0,0,71,47,0,34,13,24
ACSSF,2010e5,wv,000,0034,0002406,080,54,071,08000US540719361599999970400,"Census Tract 9704 (part), Western district, Western district, Pendleton County, West Virginia",536,436,91,14,6,71,345,100,25,0,0,0,0,25,75,65,31,0,34,10
ACSSF,2010e5,wv,000,0034,0002407,080,54,071,08000US540719361599999970500,"Census Tract 9705 (part), Western district, Western district, Pendleton County, West Virginia",201,180,58,0,14,44,122,21,9,0,0,0,0,9,12,0,0,0,0,12
ACSSF,2010e5,wv,000,0034,0002408,080,54,073,08000US540739089206004962200,"Census Tract 9622 (part), Belmont city, District A, Pleasants County, West Virginia",213,168,57,3,19,35,111,45,10,0,0,0,0,10,35,15,0,0,15,20
ACSSF,2010e5,wv,000,0034,0002409,080,54,073,08000US540739089299999962200,"Census Tract 9622 (part), District Remainder of A, District A, Pleasants County, West Virginia",214,210,112,22,25,65,98,4,4,4,0,0,4,0,0,0,0,0,0,0
ACSSF,2010e5,wv,000,0034,0002410,080,54,073,08000US540739089499999962100,"Census Tract 9621 (part), District B, District B, Pleasants County, West Virginia",151,121,25,0,0,25,96,30,0,0,0,0,0,0,30,30,0,0,30,0
ACSSF,2010e5,wv,000,0034,0002411,080,54,073,08000US540739089499999962200,"Census Tract 9622 (part), District B, District B, Pleasants County, West Virginia",194,155,15,0,0,15,140,39,26,26,0,0,26,0,13,0,0,0,0,13
ACSSF,2010e5,wv,000,0034,0002412,080,54,073,08000US540739089671356962100,"Census Tract 9621 (part), St. Marys city (part), District C, Pleasants County, West Virginia",0,0,0,0,0,0,0,0,0,0,0,0,0,0,0,0,0,0,0,0
ACSSF,2010e5,wv,000,0034,0002413,080,54,073,08000US540739089671356962200,"Census Tract 9622 (part), St. Marys city (part), District C, Pleasants County, West Virginia",404,290,101,14,8,79,189,114,23,7,0,7,0,16,91,64,19,7,38,27
ACSSF,2010e5,wv,000,0034,0002414,080,54,073,08000US540739089699999962100,"Census Tract 9621 (part), District Remainder of C, District C, Pleasants County, West Virginia",40,40,17,0,0,17,23,0,0,0,0,0,0,0,0,0,0,0,0,0
ACSSF,2010e5,wv,000,0034,0002415,080,54,073,08000US540739089699999962200,"Census Tract 9622 (part), District Remainder of C, District C, Pleasants County, West Virginia",0,0,0,0,0,0,0,0,0,0,0,0,0,0,0,0,0,0,0,0
ACSSF,2010e5,wv,000,0034,0002416,080,54,073,08000US540739089871356962100,"Census Tract 9621 (part), St. Marys city (part), District D, Pleasants County, West Virginia",106,83,17,4,0,13,66,23,0,0,0,0,0,0,23,0,0,0,0,23
ACSSF,2010e5,wv,000,0034,0002417,080,54,073,08000US540739089899999962100,"Census Tract 9621 (part), District Remainder of D, District D, Pleasants County, West Virginia",352,327,144,28,0,116,183,25,18,8,0,0,8,10,7,0,0,0,0,7
ACSSF,2010e5,wv,000,0034,0002418,080,54,073,08000US540739089899999962200,"Census Tract 9622 (part), District Remainder of D, District D, Pleasants County, West Virginia",0,0,0,0,0,0,0,0,0,0,0,0,0,0,0,0,0,0,0,0
ACSSF,2010e5,wv,000,0034,0002419,080,54,075,08000US540759099651676960200,"Census Tract 9602 (part), Marlinton town (part), Edray district, Pocahontas County, West Virginia",278,147,14,4,0,10,133,131,36,36,0,0,36,0,95,78,56,3,19,17
ACSSF,2010e5,wv,000,0034,0002420,080,54,075,08000US540759099651676960300,"Census Tract 9603 (part), Marlinton town (part), Edray district, Pocahontas County, West Virginia",73,18,4,0,0,4,14,55,43,0,0,0,0,43,12,0,0,0,0,12
ACSSF,2010e5,wv,000,0034,0002421,080,54,075,08000US540759099699999960102,"Census Tract 9601.02 (part), Remainder of Edray district, Edray district, Pocahontas County, West Virginia",0,0,0,0,0,0,0,0,0,0,0,0,0,0,0,0,0,0,0,0
ACSSF,2010e5,wv,000,0034,0002422,080,54,075,08000US540759099699999960200,"Census Tract 9602 (part), Remainder of Edray district, Edray district, Pocahontas County, West Virginia",545,453,109,17,0,92,344,92,35,14,0,0,14,21,57,57,0,15,42,0
ACSSF,2010e5,wv,000,0034,0002423,080,54,075,08000US540759099699999960300,"Census Tract 9603 (part), Remainder of Edray district, Edray district, Pocahontas County, West Virginia",168,153,10,0,10,0,143,15,11,0,0,0,0,11,4,0,0,0,0,4
ACSSF,2010e5,wv,000,0034,0002424,080,54,075,08000US540759141604780960101,"Census Tract 9601.01 (part), Bartow CDP, Greenbank district, Pocahontas County, West Virginia",30,30,0,0,0,0,30,0,0,0,0,0,0,0,0,0,0,0,0,0
ACSSF,2010e5,wv,000,0034,0002425,080,54,075,08000US540759141613684960102,"Census Tract 9601.02 (part), Cass CDP, Greenbank district, Pocahontas County, West Virginia",0,0,0,0,0,0,0,0,0,0,0,0,0,0,0,0,0,0,0,0
ACSSF,2010e5,wv,000,0034,0002426,080,54,075,08000US540759141613684960200,"Census Tract 9602 (part), Cass CDP, Greenbank district, Pocahontas County, West Virginia",0,0,0,0,0,0,0,0,0,0,0,0,0,0,0,0,0,0,0,0
ACSSF,2010e5,wv,000,0034,0002427,080,54,075,08000US540759141622852960102,"Census Tract 9601.02 (part), Durbin town, Greenbank district, Pocahontas County, West Virginia",88,63,5,0,0,5,58,25,8,6,0,0,6,2,17,11,11,0,0,6
ACSSF,2010e5,wv,000,0034,0002428,080,54,075,08000US540759141628948960102,"Census Tract 9601.02 (part), Frank CDP, Greenbank district, Pocahontas County, West Virginia",56,56,56,0,0,56,0,0,0,0,0,0,0,0,0,0,0,0,0,0
ACSSF,2010e5,wv,000,0034,0002429,080,54,075,08000US540759141633124960101,"Census Tract 9601.01 (part), Green Bank CDP, Greenbank district, Pocahontas County, West Virginia",32,32,24,24,0,0,8,0,0,0,0,0,0,0,0,0,0,0,0,0
ACSSF,2010e5,wv,000,0034,0002430,080,54,075,08000US540759141633124960102,"Census Tract 9601.02 (part), Green Bank CDP, Greenbank district, Pocahontas County, West Virginia",0,0,0,0,0,0,0,0,0,0,0,0,0,0,0,0,0,0,0,0
ACSSF,2010e5,wv,000,0034,0002431,080,54,075,08000US540759141699999960101,"Census Tract 9601.01 (part), Remainder of Greenbank district, Greenbank district, Pocahontas County, West Virginia",322,313,117,17,19,81,196,9,0,0,0,0,0,0,9,0,0,0,0,9
ACSSF,2010e5,wv,000,0034,0002432,080,54,075,08000US540759141699999960102,"Census Tract 9601.02 (part), Remainder of Greenbank district, Greenbank district, Pocahontas County, West Virginia",195,195,89,0,16,73,106,0,0,0,0,0,0,0,0,0,0,0,0,0
ACSSF,2010e5,wv,000,0034,0002433,080,54,075,08000US540759141699999960200,"Census Tract 9602 (part), Remainder of Greenbank district, Greenbank district, Pocahontas County, West Virginia",80,80,51,0,29,22,29,0,0,0,0,0,0,0,0,0,0,0,0,0
ACSSF,2010e5,wv,000,0034,0002434,080,54,075,08000US540759165639412960200,"Census Tract 9602 (part), Huntersville CDP, Huntersville district, Pocahontas County, West Virginia",43,43,8,0,0,8,35,0,0,0,0,0,0,0,0,0,0,0,0,0
ACSSF,2010e5,wv,000,0034,0002435,080,54,075,08000US540759165651676960200,"Census Tract 9602 (part), Marlinton town (part), Huntersville district, Pocahontas County, West Virginia",14,11,5,0,0,5,6,3,0,0,0,0,0,0,3,0,0,0,0,3
ACSSF,2010e5,wv,000,0034,0002436,080,54,075,08000US540759165699999960101,"Census Tract 9601.01 (part), Remainder of Huntersville district, Huntersville district, Pocahontas County, West Virginia",0,0,0,0,0,0,0,0,0,0,0,0,0,0,0,0,0,0,0,0
ACSSF,2010e5,wv,000,0034,0002437,080,54,075,08000US540759165699999960200,"Census Tract 9602 (part), Remainder of Huntersville district, Huntersville district, Pocahontas County, West Virginia",256,242,106,0,26,80,136,14,0,0,0,0,0,0,14,14,0,0,14,0
ACSSF,2010e5,wv,000,0034,0002438,080,54,075,08000US540759165699999960300,"Census Tract 9603 (part), Remainder of Huntersville district, Huntersville district, Pocahontas County, West Virginia",5,5,0,0,0,0,5,0,0,0,0,0,0,0,0,0,0,0,0,0
ACSSF,2010e5,wv,000,0034,0002439,080,54,075,08000US540759194437372960300,"Census Tract 9603 (part), Hillsboro town, Little Levels district, Pocahontas County, West Virginia",67,56,36,23,4,9,20,11,0,0,0,0,0,0,11,8,0,0,8,3
ACSSF,2010e5,wv,000,0034,0002440,080,54,075,08000US540759194499999960200,"Census Tract 9602 (part), Remainder of Little Levels district, Little Levels district, Pocahontas County, West Virginia",14,14,14,0,0,14,0,0,0,0,0,0,0,0,0,0,0,0,0,0
ACSSF,2010e5,wv,000,0034,0002441,080,54,075,08000US540759194499999960300,"Census Tract 9603 (part), Remainder of Little Levels district, Little Levels district, Pocahontas County, West Virginia",437,363,109,46,17,46,254,74,26,17,17,0,0,9,48,25,0,0,25,23
ACSSF,2010e5,wv,000,0034,0002442,080,54,077,08000US540779109603460964200,"Census Tract 9642 (part), Aurora CDP, Fifth district, Preston County, West Virginia",40,40,30,0,0,30,10,0,0,0,0,0,0,0,0,0,0,0,0,0
ACSSF,2010e5,wv,000,0034,0002443,080,54,077,08000US540779109658300964400,"Census Tract 9644 (part), Newburg town (part), Fifth district, Preston County, West Virginia",113,98,33,0,17,16,65,15,4,4,0,0,4,0,11,11,11,0,0,0
ACSSF,2010e5,wv,000,0034,0002444,080,54,077,08000US540779109670588964500,"Census Tract 9645 (part), Rowlesburg town (part), Fifth district, Preston County, West Virginia",139,117,57,18,5,34,60,22,0,0,0,0,0,0,22,18,0,0,18,4
ACSSF,2010e5,wv,000,0034,0002445,080,54,077,08000US540779109681268964400,"Census Tract 9644 (part), Tunnelton town, Fifth district, Preston County, West Virginia",70,58,32,11,5,16,26,12,0,0,0,0,0,0,12,10,5,0,5,2
ACSSF,2010e5,wv,000,0034,0002446,080,54,077,08000US540779109681268964500,"Census Tract 9645 (part), Tunnelton town, Fifth district, Preston County, West Virginia",25,22,7,0,0,7,15,3,0,0,0,0,0,0,3,0,0,0,0,3
ACSSF,2010e5,wv,000,0034,0002447,080,54,077,08000US540779109699999964200,"Census Tract 9642 (part), Remainder of Fifth district, Fifth district, Preston County, West Virginia",332,257,88,0,36,52,169,75,0,0,0,0,0,0,75,25,0,0,25,50
ACSSF,2010e5,wv,000,0034,0002448,080,54,077,08000US540779109699999964300,"Census Tract 9643 (part), Remainder of Fifth district, Fifth district, Preston County, West Virginia",0,0,0,0,0,0,0,0,0,0,0,0,0,0,0,0,0,0,0,0
ACSSF,2010e5,wv,000,0034,0002449,080,54,077,08000US540779109699999964400,"Census Tract 9644 (part), Remainder of Fifth district, Fifth district, Preston County, West Virginia",321,274,102,16,0,86,172,47,20,0,0,0,0,20,27,0,0,0,0,27
ACSSF,2010e5,wv,000,0034,0002450,080,54,077,08000US540779109699999964500,"Census Tract 9645 (part), Remainder of Fifth district, Fifth district, Preston County, West Virginia",638,589,212,59,24,129,377,49,13,13,13,0,0,0,36,23,10,13,0,13
ACSSF,2010e5,wv,000,0034,0002451,080,54,077,08000US540779110010852963800,"Census Tract 9638 (part), Bruceton Mills town, First district, Preston County, West Virginia",39,18,11,0,8,3,7,21,9,9,0,0,9,0,12,9,5,0,4,3
ACSSF,2010e5,wv,000,0034,0002452,080,54,077,08000US540779110052228963900,"Census Tract 9639 (part), Masontown town, First district, Preston County, West Virginia",234,179,80,6,18,56,99,55,14,7,0,7,0,7,41,32,12,14,6,9
ACSSF,2010e5,wv,000,0034,0002453,080,54,077,08000US540779110067636963900,"Census Tract 9639 (part), Reedsville town, First district, Preston County, West Virginia",22,22,0,0,0,0,22,0,0,0,0,0,0,0,0,0,0,0,0,0
ACSSF,2010e5,wv,000,0034,0002454,080,54,077,08000US540779110067636964300,"Census Tract 9643 (part), Reedsville town, First district, Preston County, West Virginia",123,100,52,31,5,16,48,23,0,0,0,0,0,0,23,13,0,0,13,10
ACSSF,2010e5,wv,000,0034,0002455,080,54,077,08000US540779110099999963800,"Census Tract 9638 (part), Remainder of First district, First district, Preston County, West Virginia",231,219,75,24,0,51,144,12,0,0,0,0,0,0,12,0,0,0,0,12
ACSSF,2010e5,wv,000,0034,0002456,080,54,077,08000US540779110099999963900,"Census Tract 9639 (part), Remainder of First district, First district, Preston County, West Virginia",801,699,229,50,9,170,470,102,29,18,0,0,18,11,73,37,0,14,23,36
ACSSF,2010e5,wv,000,0034,0002457,080,54,077,08000US540779110099999964300,"Census Tract 9643 (part), Remainder of First district, First district, Preston County, West Virginia",460,340,178,47,26,105,162,120,0,0,0,0,0,0,120,60,39,0,21,60
ACSSF,2010e5,wv,000,0034,0002458,080,54,077,08000US540779113400748964100,"Census Tract 9641 (part), Albright town, Fourth district, Preston County, West Virginia",81,76,37,8,2,27,39,5,0,0,0,0,0,0,5,0,0,0,0,5
ACSSF,2010e5,wv,000,0034,0002459,080,54,077,08000US540779113444044964000,"Census Tract 9640 (part), Kingwood city (part), Fourth district, Preston County, West Virginia",293,226,41,0,20,21,185,67,0,0,0,0,0,0,67,14,0,12,2,53
ACSSF,2010e5,wv,000,0034,0002460,080,54,077,08000US540779113444044964300,"Census Tract 9643 (part), Kingwood city (part), Fourth district, Preston County, West Virginia",123,99,24,0,0,24,75,24,0,0,0,0,0,0,24,13,0,0,13,11
ACSSF,2010e5,wv,000,0034,0002461,080,54,077,08000US540779113470588964200,"Census Tract 9642 (part), Rowlesburg town (part), Fourth district, Preston County, West Virginia",46,46,15,0,0,15,31,0,0,0,0,0,0,0,0,0,0,0,0,0
ACSSF,2010e5,wv,000,0034,0002462,080,54,077,08000US540779113479708964100,"Census Tract 9641 (part), Terra Alta town (part), Fourth district, Preston County, West Virginia",137,118,44,17,12,15,74,19,5,5,0,0,5,0,14,12,5,4,3,2
ACSSF,2010e5,wv,000,0034,0002463,080,54,077,08000US540779113479708964200,"Census Tract 9642 (part), Terra Alta town (part), Fourth district, Preston County, West Virginia",206,121,81,6,18,57,40,85,32,22,22,0,0,10,53,28,0,5,23,25
ACSSF,2010e5,wv,000,0034,0002464,080,54,077,08000US540779113499999963900,"Census Tract 9639 (part), Remainder of Fourth district, Fourth district, Preston County, West Virginia",0,0,0,0,0,0,0,0,0,0,0,0,0,0,0,0,0,0,0,0
ACSSF,2010e5,wv,000,0034,0002465,080,54,077,08000US540779113499999964000,"Census Tract 9640 (part), Remainder of Fourth district, Fourth district, Preston County, West Virginia",51,51,10,0,0,10,41,0,0,0,0,0,0,0,0,0,0,0,0,0
ACSSF,2010e5,wv,000,0034,0002466,080,54,077,08000US540779113499999964100,"Census Tract 9641 (part), Remainder of Fourth district, Fourth district, Preston County, West Virginia",290,259,130,59,0,71,129,31,0,0,0,0,0,0,31,0,0,0,0,31
ACSSF,2010e5,wv,000,0034,0002467,080,54,077,08000US540779113499999964200,"Census Tract 9642 (part), Remainder of Fourth district, Fourth district, Preston County, West Virginia",501,364,135,26,25,84,229,137,26,0,0,0,0,26,111,36,0,0,36,75
ACSSF,2010e5,wv,000,0034,0002468,080,54,077,08000US540779113499999964300,"Census Tract 9643 (part), Remainder of Fourth district, Fourth district, Preston County, West Virginia",22,22,0,0,0,0,22,0,0,0,0,0,0,0,0,0,0,0,0,0
ACSSF,2010e5,wv,000,0034,0002469,080,54,077,08000US540779274209844963800,"Census Tract 9638 (part), Brandonville town, Second district, Preston County, West Virginia",24,15,2,2,0,0,13,9,0,0,0,0,0,0,9,2,0,0,2,7
ACSSF,2010e5,wv,000,0034,0002470,080,54,077,08000US540779274279708964100,"Census Tract 9641 (part), Terra Alta town (part), Second district, Preston County, West Virginia",81,60,8,0,0,8,52,21,5,0,0,0,0,5,16,16,10,0,6,0
ACSSF,2010e5,wv,000,0034,0002471,080,54,077,08000US540779274279708964200,"Census Tract 9642 (part), Terra Alta town (part), Second district, Preston County, West Virginia",74,41,27,5,4,18,14,33,11,0,0,0,0,11,22,18,4,0,14,4
ACSSF,2010e5,wv,000,0034,0002472,080,54,077,08000US540779274299999963800,"Census Tract 9638 (part), Remainder of Second district, Second district, Preston County, West Virginia",872,776,223,44,44,135,553,96,37,0,0,0,0,37,59,32,17,15,0,27
ACSSF,2010e5,wv,000,0034,0002473,080,54,077,08000US540779274299999964100,"Census Tract 9641 (part), Remainder of Second district, Second district, Preston County, West Virginia",685,575,133,20,0,113,442,110,22,11,0,0,11,11,88,34,0,0,34,54
ACSSF,2010e5,wv,000,0034,0002474,080,54,077,08000US540779274299999964200,"Census Tract 9642 (part), Remainder of Second district, Second district, Preston County, West Virginia",13,13,7,0,7,0,6,0,0,0,0,0,0,0,0,0,0,0,0,0
ACSSF,2010e5,wv,000,0034,0002475,080,54,077,08000US540779310244044964000,"Census Tract 9640 (part), Kingwood city (part), Third district, Preston County, West Virginia",445,355,151,88,19,44,204,90,27,27,0,0,27,0,63,48,0,0,48,15
ACSSF,2010e5,wv,000,0034,0002476,080,54,077,08000US540779310258300964400,"Census Tract 9644 (part), Newburg town (part), Third district, Preston County, West Virginia",48,37,14,5,3,6,23,11,6,6,6,0,0,0,5,5,0,0,5,0
ACSSF,2010e5,wv,000,0034,0002477,080,54,077,08000US540779310299999963900,"Census Tract 9639 (part), Remainder of Third district, Third district, Preston County, West Virginia",155,102,38,0,0,38,64,53,53,0,0,0,0,53,0,0,0,0,0,0
ACSSF,2010e5,wv,000,0034,0002478,080,54,077,08000US540779310299999964000,"Census Tract 9640 (part), Remainder of Third district, Third district, Preston County, West Virginia",320,291,72,64,8,0,219,29,29,29,0,13,16,0,0,0,0,0,0,0
ACSSF,2010e5,wv,000,0034,0002479,080,54,077,08000US540779310299999964300,"Census Tract 9643 (part), Remainder of Third district, Third district, Preston County, West Virginia",513,332,115,53,0,62,217,181,28,15,0,0,15,13,153,129,39,69,21,24
ACSSF,2010e5,wv,000,0034,0002480,080,54,077,08000US540779310299999964400,"Census Tract 9644 (part), Remainder of Third district, Third district, Preston County, West Virginia",435,348,112,32,21,59,236,87,64,48,48,0,0,16,23,15,0,0,15,8
ACSSF,2010e5,wv,000,0034,0002481,080,54,079,08000US540799029211284020200,"Census Tract 202 (part), Buffalo town, Buffalo-Union district, Putnam County, West Virginia",361,276,108,0,3,105,168,85,43,25,6,6,13,18,42,30,9,6,15,12
ACSSF,2010e5,wv,000,0034,0002482,080,54,079,08000US540799029211284020300,"Census Tract 203 (part), Buffalo town, Buffalo-Union district, Putnam County, West Virginia",0,0,0,0,0,0,0,0,0,0,0,0,0,0,0,0,0,0,0,0
ACSSF,2010e5,wv,000,0034,0002483,080,54,079,08000US540799029219516020300,"Census Tract 203 (part), Culloden CDP (part), Buffalo-Union district, Putnam County, West Virginia",0,0,0,0,0,0,0,0,0,0,0,0,0,0,0,0,0,0,0,0
ACSSF,2010e5,wv,000,0034,0002484,080,54,079,08000US540799029224292020200,"Census Tract 202 (part), Eleanor town, Buffalo-Union district, Putnam County, West Virginia",501,402,154,27,36,91,248,99,6,0,0,0,0,6,93,45,4,0,41,48
ACSSF,2010e5,wv,000,0034,0002485,080,54,079,08000US540799029238260020100,"Census Tract 201 (part), Hometown CDP, Buffalo-Union district, Putnam County, West Virginia",238,172,18,0,0,18,154,66,0,0,0,0,0,0,66,36,36,0,0,30
ACSSF,2010e5,wv,000,0034,0002486,080,54,079,08000US540799029239532020300,"Census Tract 203 (part), Hurricane city (part), Buffalo-Union district, Putnam County, West Virginia",27,27,0,0,0,0,27,0,0,0,0,0,0,0,0,0,0,0,0,0
ACSSF,2010e5,wv,000,0034,0002487,080,54,079,08000US540799029299999020100,"Census Tract 201 (part), Remainder of Buffalo-Union district, Buffalo-Union district, Putnam County, West Virginia",680,505,119,35,11,73,386,175,55,10,0,0,10,45,120,88,0,0,88,32
ACSSF,2010e5,wv,000,0034,0002488,080,54,079,08000US540799029299999020200,"Census Tract 202 (part), Remainder of Buffalo-Union district, Buffalo-Union district, Putnam County, West Virginia",690,584,202,16,17,169,382,106,16,0,0,0,0,16,90,0,0,0,0,90
ACSSF,2010e5,wv,000,0034,0002489,080,54,079,08000US540799029299999020300,"Census Tract 203 (part), Remainder of Buffalo-Union district, Buffalo-Union district, Putnam County, West Virginia",633,433,136,0,30,106,297,200,38,38,0,0,38,0,162,22,0,0,22,140
ACSSF,2010e5,wv,000,0034,0002490,080,54,079,08000US540799072019516020603,"Census Tract 206.03 (part), Culloden CDP (part), Curry district, Putnam County, West Virginia",50,35,13,13,0,0,22,15,0,0,0,0,0,0,15,0,0,0,0,15
ACSSF,2010e5,wv,000,0034,0002491,080,54,079,08000US540799072019516020700,"Census Tract 207 (part), Culloden CDP (part), Curry district, Putnam County, West Virginia",0,0,0,0,0,0,0,0,0,0,0,0,0,0,0,0,0,0,0,0
ACSSF,2010e5,wv,000,0034,0002492,080,54,079,08000US540799072039532020603,"Census Tract 206.03 (part), Hurricane city (part), Curry district, Putnam County, West Virginia",1141,932,372,102,69,201,560,209,28,15,0,0,15,13,181,136,18,68,50,45
ACSSF,2010e5,wv,000,0034,0002493,080,54,079,08000US540799072039532020604,"Census Tract 206.04 (part), Hurricane city (part), Curry district, Putnam County, West Virginia",0,0,0,0,0,0,0,0,0,0,0,0,0,0,0,0,0,0,0,0
ACSSF,2010e5,wv,000,0034,0002494,080,54,079,08000US540799072039532020700,"Census Tract 207 (part), Hurricane city (part), Curry district, Putnam County, West Virginia",111,111,35,0,23,12,76,0,0,0,0,0,0,0,0,0,0,0,0,0
ACSSF,2010e5,wv,000,0034,0002495,080,54,079,08000US540799072099999020603,"Census Tract 206.03 (part), Remainder of Curry district, Curry district, Putnam County, West Virginia",253,229,84,49,0,35,145,24,11,11,0,0,11,0,13,0,0,0,0,13
ACSSF,2010e5,wv,000,0034,0002496,080,54,079,08000US540799072099999020700,"Census Tract 207 (part), Remainder of Curry district, Curry district, Putnam County, West Virginia",1199,1007,414,69,172,173,593,192,8,8,8,0,0,0,184,97,9,32,56,87
ACSSF,2010e5,wv,000,0034,0002497,080,54,079,08000US540799250804204020100,"Census Tract 201 (part), Bancroft town, Pocatalico district, Putnam County, West Virginia",50,39,14,0,0,14,25,11,0,0,0,0,0,0,11,0,0,0,0,11
ACSSF,2010e5,wv,000,0034,0002498,080,54,079,08000US540799250859068020500,"Census Tract 205 (part), Nitro city (part), Pocatalico district, Putnam County, West Virginia",345,186,42,30,0,12,144,159,48,38,0,0,38,10,111,80,63,0,17,31
ACSSF,2010e5,wv,000,0034,0002499,080,54,079,08000US540799250864516020100,"Census Tract 201 (part), Poca town (part), Pocatalico district, Putnam County, West Virginia",0,0,0,0,0,0,0,0,0,0,0,0,0,0,0,0,0,0,0,0
ACSSF,2010e5,wv,000,0034,0002500,080,54,079,08000US540799250864516020500,"Census Tract 205 (part), Poca town (part), Pocatalico district, Putnam County, West Virginia",369,283,84,24,10,50,199,86,18,0,0,0,0,18,68,50,5,12,33,18
ACSSF,2010e5,wv,000,0034,0002501,080,54,079,08000US540799250899999020100,"Census Tract 201 (part), Remainder of Pocatalico district, Pocatalico district, Putnam County, West Virginia",588,454,172,0,64,108,282,134,63,0,0,0,0,63,71,71,0,35,36,0
ACSSF,2010e5,wv,000,0034,0002502,080,54,079,08000US540799250899999020500,"Census Tract 205 (part), Remainder of Pocatalico district, Pocatalico district, Putnam County, West Virginia",1084,859,406,132,39,235,453,225,76,76,0,0,76,0,149,118,0,78,40,31
ACSSF,2010e5,wv,000,0034,0002503,080,54,079,08000US540799273639532020300,"Census Tract 203 (part), Hurricane city (part), Scott district, Putnam County, West Virginia",16,16,0,0,0,0,16,0,0,0,0,0,0,0,0,0,0,0,0,0
ACSSF,2010e5,wv,000,0034,0002504,080,54,079,08000US540799273659068020400,"Census Tract 204 (part), Nitro city (part), Scott district, Putnam County, West Virginia",0,0,0,0,0,0,0,0,0,0,0,0,0,0,0,0,0,0,0,0
ACSSF,2010e5,wv,000,0034,0002505,080,54,079,08000US540799273659068020601,"Census Tract 206.01 (part), Nitro city (part), Scott district, Putnam County, West Virginia",0,0,0,0,0,0,0,0,0,0,0,0,0,0,0,0,0,0,0,0
ACSSF,2010e5,wv,000,0034,0002506,080,54,079,08000US540799273664516020400,"Census Tract 204 (part), Poca town (part), Scott district, Putnam County, West Virginia",0,0,0,0,0,0,0,0,0,0,0,0,0,0,0,0,0,0,0,0
ACSSF,2010e5,wv,000,0034,0002507,080,54,079,08000US540799273679545020300,"Census Tract 203 (part), Teays Valley CDP (part), Scott district, Putnam County, West Virginia",0,0,0,0,0,0,0,0,0,0,0,0,0,0,0,0,0,0,0,0
ACSSF,2010e5,wv,000,0034,0002508,080,54,079,08000US540799273679545020601,"Census Tract 206.01 (part), Teays Valley CDP (part), Scott district, Putnam County, West Virginia",669,602,261,61,93,107,341,67,17,0,0,0,0,17,50,12,0,0,12,38
ACSSF,2010e5,wv,000,0034,0002509,080,54,079,08000US540799273687988020400,"Census Tract 204 (part), Winfield town, Scott district, Putnam County, West Virginia",719,632,327,64,59,204,305,87,15,15,6,0,9,0,72,29,6,0,23,43
ACSSF,2010e5,wv,000,0034,0002510,080,54,079,08000US540799273699999020300,"Census Tract 203 (part), Remainder of Scott district, Scott district, Putnam County, West Virginia",575,487,266,24,17,225,221,88,47,15,0,15,0,32,41,9,0,0,9,32
ACSSF,2010e5,wv,000,0034,0002511,080,54,079,08000US540799273699999020400,"Census Tract 204 (part), Remainder of Scott district, Scott district, Putnam County, West Virginia",1084,981,450,64,0,386,531,103,35,35,0,16,19,0,68,7,0,0,7,61
ACSSF,2010e5,wv,000,0034,0002512,080,54,079,08000US540799273699999020603,"Census Tract 206.03 (part), Remainder of Scott district, Scott district, Putnam County, West Virginia",176,95,67,0,0,67,28,81,16,0,0,0,0,16,65,65,65,0,0,0
ACSSF,2010e5,wv,000,0034,0002513,080,54,079,08000US540799309039532020603,"Census Tract 206.03 (part), Hurricane city (part), Teays district, Putnam County, West Virginia",14,14,14,14,0,0,0,0,0,0,0,0,0,0,0,0,0,0,0,0
ACSSF,2010e5,wv,000,0034,0002514,080,54,079,08000US540799309039532020604,"Census Tract 206.04 (part), Hurricane city (part), Teays district, Putnam County, West Virginia",94,82,24,8,0,16,58,12,12,0,0,0,0,12,0,0,0,0,0,0
ACSSF,2010e5,wv,000,0034,0002515,080,54,079,08000US540799309039532020605,"Census Tract 206.05 (part), Hurricane city (part), Teays district, Putnam County, West Virginia",358,348,207,32,54,121,141,10,0,0,0,0,0,0,10,10,0,0,10,0
ACSSF,2010e5,wv,000,0034,0002516,080,54,079,08000US540799309079545020601,"Census Tract 206.01 (part), Teays Valley CDP (part), Teays district, Putnam County, West Virginia",718,619,304,46,68,190,315,99,28,0,0,0,0,28,71,25,0,0,25,46
ACSSF,2010e5,wv,000,0034,0002517,080,54,079,08000US540799309079545020604,"Census Tract 206.04 (part), Teays Valley CDP (part), Teays district, Putnam County, West Virginia",763,563,249,36,60,153,314,200,55,29,0,0,29,26,145,145,33,67,45,0
ACSSF,2010e5,wv,000,0034,0002518,080,54,079,08000US540799309079545020605,"Census Tract 206.05 (part), Teays Valley CDP (part), Teays district, Putnam County, West Virginia",1767,1624,640,228,115,297,984,143,79,20,0,0,20,59,64,54,0,0,54,10
ACSSF,2010e5,wv,000,0034,0002519,080,54,079,08000US540799309099999020603,"Census Tract 206.03 (part), Remainder of Teays district, Teays district, Putnam County, West Virginia",481,401,146,0,47,99,255,80,17,0,0,0,0,17,63,49,0,0,49,14
ACSSF,2010e5,wv,000,0034,0002520,080,54,079,08000US540799309099999020604,"Census Tract 206.04 (part), Remainder of Teays district, Teays district, Putnam County, West Virginia",52,0,0,0,0,0,0,52,52,15,0,0,15,37,0,0,0,0,0,0
ACSSF,2010e5,wv,000,0034,0002521,080,54,079,08000US540799309099999020605,"Census Tract 206.05 (part), Remainder of Teays district, Teays district, Putnam County, West Virginia",123,123,90,18,13,59,33,0,0,0,0,0,0,0,0,0,0,0,0,0
ACSSF,2010e5,wv,000,0034,0002522,080,54,079,08000US540799309099999020700,"Census Tract 207 (part), Remainder of Teays district, Teays district, Putnam County, West Virginia",0,0,0,0,0,0,0,0,0,0,0,0,0,0,0,0,0,0,0,0
ACSSF,2010e5,wv,000,0034,0002523,080,54,081,08000US540819079205332000600,"Census Tract 6 (part), Beckley city (part), District 1, Raleigh County, West Virginia",0,0,0,0,0,0,0,0,0,0,0,0,0,0,0,0,0,0,0,0
ACSSF,2010e5,wv,000,0034,0002524,080,54,081,08000US540819079205332000700,"Census Tract 7 (part), Beckley city (part), District 1, Raleigh County, West Virginia",0,0,0,0,0,0,0,0,0,0,0,0,0,0,0,0,0,0,0,0
ACSSF,2010e5,wv,000,0034,0002525,080,54,081,08000US540819079205332001300,"Census Tract 13 (part), Beckley city (part), District 1, Raleigh County, West Virginia",0,0,0,0,0,0,0,0,0,0,0,0,0,0,0,0,0,0,0,0
ACSSF,2010e5,wv,000,0034,0002526,080,54,081,08000US540819079208956001100,"Census Tract 11 (part), Bolt CDP, District 1, Raleigh County, West Virginia",156,156,62,20,0,42,94,0,0,0,0,0,0,0,0,0,0,0,0,0
ACSSF,2010e5,wv,000,0034,0002527,080,54,081,08000US540819079216516000900,"Census Tract 9 (part), Coal City CDP, District 1, Raleigh County, West Virginia",463,348,208,38,35,135,140,115,41,0,0,0,0,41,74,12,0,12,0,62
ACSSF,2010e5,wv,000,0034,0002528,080,54,081,08000US540819079218508001001,"Census Tract 10.01 (part), Crab Orchard CDP, District 1, Raleigh County, West Virginia",825,693,240,45,63,132,453,132,72,25,0,25,0,47,60,0,0,0,0,60
ACSSF,2010e5,wv,000,0034,0002529,080,54,081,08000US540819079223644001300,"Census Tract 13 (part), Eccles CDP, District 1, Raleigh County, West Virginia",118,64,64,14,0,50,0,54,23,23,0,0,23,0,31,0,0,0,0,31
ACSSF,2010e5,wv,000,0034,0002530,080,54,081,08000US540819079230724000900,"Census Tract 9 (part), Ghent CDP, District 1, Raleigh County, West Virginia",166,134,21,0,21,0,113,32,0,0,0,0,0,0,32,0,0,0,0,32
ACSSF,2010e5,wv,000,0034,0002531,080,54,081,08000US540819079232068001100,"Census Tract 11 (part), Glen White CDP, District 1, Raleigh County, West Virginia",0,0,0,0,0,0,0,0,0,0,0,0,0,0,0,0,0,0,0,0
ACSSF,2010e5,wv,000,0034,0002532,080,54,081,08000US540819079236292000900,"Census Tract 9 (part), Helen CDP, District 1, Raleigh County, West Virginia",18,18,0,0,0,0,18,0,0,0,0,0,0,0,0,0,0,0,0,0
ACSSF,2010e5,wv,000,0034,0002533,080,54,081,08000US540819079246468001100,"Census Tract 11 (part), Lester town, District 1, Raleigh County, West Virginia",84,51,20,0,0,20,31,33,0,0,0,0,0,0,33,15,3,0,12,18
ACSSF,2010e5,wv,000,0034,0002534,080,54,081,08000US540819079249492000700,"Census Tract 7 (part), Mabscott town (part), District 1, Raleigh County, West Virginia",453,366,148,26,40,82,218,87,28,0,0,0,0,28,59,32,8,6,18,27
ACSSF,2010e5,wv,000,0034,0002535,080,54,081,08000US540819079249564000700,"Census Tract 7 (part), MacArthur CDP (part), District 1, Raleigh County, West Virginia",371,274,58,0,0,58,216,97,30,30,0,0,30,0,67,58,48,10,0,9
ACSSF,2010e5,wv,000,0034,0002536,080,54,081,08000US540819079267996000900,"Census Tract 9 (part), Rhodell town, District 1, Raleigh County, West Virginia",33,21,10,3,0,7,11,12,0,0,0,0,0,0,12,12,0,0,12,0
ACSSF,2010e5,wv,000,0034,0002537,080,54,081,08000US540819079275172001001,"Census Tract 10.01 (part), Sophia town, District 1, Raleigh County, West Virginia",6,6,2,2,0,0,4,0,0,0,0,0,0,0,0,0,0,0,0,0
ACSSF,2010e5,wv,000,0034,0002538,080,54,081,08000US540819079275172001002,"Census Tract 10.02 (part), Sophia town, District 1, Raleigh County, West Virginia",337,273,103,24,20,59,170,64,0,0,0,0,0,0,64,34,4,13,17,30
ACSSF,2010e5,wv,000,0034,0002539,080,54,081,08000US540819079299999000300,"Census Tract 3 (part), District Remainder of 1, District 1, Raleigh County, West Virginia",0,0,0,0,0,0,0,0,0,0,0,0,0,0,0,0,0,0,0,0
ACSSF,2010e5,wv,000,0034,0002540,080,54,081,08000US540819079299999000600,"Census Tract 6 (part), District Remainder of 1, District 1, Raleigh County, West Virginia",27,27,0,0,0,0,27,0,0,0,0,0,0,0,0,0,0,0,0,0
ACSSF,2010e5,wv,000,0034,0002541,080,54,081,08000US540819079299999000700,"Census Tract 7 (part), District Remainder of 1, District 1, Raleigh County, West Virginia",0,0,0,0,0,0,0,0,0,0,0,0,0,0,0,0,0,0,0,0
ACSSF,2010e5,wv,000,0034,0002542,080,54,081,08000US540819079299999000900,"Census Tract 9 (part), District Remainder of 1, District 1, Raleigh County, West Virginia",887,728,226,23,0,203,502,159,26,0,0,0,0,26,133,71,0,52,19,62
ACSSF,2010e5,wv,000,0034,0002543,080,54,081,08000US540819079299999001001,"Census Tract 10.01 (part), District Remainder of 1, District 1, Raleigh County, West Virginia",680,501,164,34,21,109,337,179,25,13,13,0,0,12,154,64,0,8,56,90
ACSSF,2010e5,wv,000,0034,0002544,080,54,081,08000US540819079299999001002,"Census Tract 10.02 (part), District Remainder of 1, District 1, Raleigh County, West Virginia",445,314,103,11,37,55,211,131,19,0,0,0,0,19,112,59,24,27,8,53
ACSSF,2010e5,wv,000,0034,0002545,080,54,081,08000US540819079299999001100,"Census Tract 11 (part), District Remainder of 1, District 1, Raleigh County, West Virginia",1215,1073,383,121,14,248,690,142,38,19,0,0,19,19,104,62,37,0,25,42
ACSSF,2010e5,wv,000,0034,0002546,080,54,081,08000US540819079299999001200,"Census Tract 12 (part), District Remainder of 1, District 1, Raleigh County, West Virginia",0,0,0,0,0,0,0,0,0,0,0,0,0,0,0,0,0,0,0,0
ACSSF,2010e5,wv,000,0034,0002547,080,54,081,08000US540819079299999001300,"Census Tract 13 (part), District Remainder of 1, District 1, Raleigh County, West Virginia",586,506,181,7,52,122,325,80,62,31,14,0,17,31,18,18,0,0,18,0
ACSSF,2010e5,wv,000,0034,0002548,080,54,081,08000US540819082805332000200,"Census Tract 2 (part), Beckley city (part), District 2, Raleigh County, West Virginia",70,27,23,0,0,23,4,43,0,0,0,0,0,0,43,36,0,0,36,7
ACSSF,2010e5,wv,000,0034,0002549,080,54,081,08000US540819082805332000400,"Census Tract 4 (part), Beckley city (part), District 2, Raleigh County, West Virginia",354,268,108,81,0,27,160,86,10,0,0,0,0,10,76,21,0,11,10,55
ACSSF,2010e5,wv,000,0034,0002550,080,54,081,08000US540819082805332000500,"Census Tract 5 (part), Beckley city (part), District 2, Raleigh County, West Virginia",655,588,207,8,57,142,381,67,0,0,0,0,0,0,67,15,0,0,15,52
ACSSF,2010e5,wv,000,0034,0002551,080,54,081,08000US540819082805332000600,"Census Tract 6 (part), Beckley city (part), District 2, Raleigh County, West Virginia",916,612,158,40,0,118,454,304,38,0,0,0,0,38,266,158,35,0,123,108
ACSSF,2010e5,wv,000,0034,0002552,080,54,081,08000US540819082805332001300,"Census Tract 13 (part), Beckley city (part), District 2, Raleigh County, West Virginia",0,0,0,0,0,0,0,0,0,0,0,0,0,0,0,0,0,0,0,0
ACSSF,2010e5,wv,000,0034,0002553,080,54,081,08000US540819082805332001400,"Census Tract 14 (part), Beckley city (part), District 2, Raleigh County, West Virginia",45,0,0,0,0,0,0,45,0,0,0,0,0,0,45,34,0,28,6,11
ACSSF,2010e5,wv,000,0034,0002554,080,54,081,08000US540819082805332001500,"Census Tract 15 (part), Beckley city (part), District 2, Raleigh County, West Virginia",27,27,13,0,0,13,14,0,0,0,0,0,0,0,0,0,0,0,0,0
ACSSF,2010e5,wv,000,0034,0002555,080,54,081,08000US540819082809676001400,"Census Tract 14 (part), Bradley CDP, District 2, Raleigh County, West Virginia",555,468,155,73,42,40,313,87,24,12,12,0,0,12,63,63,21,0,42,0
ACSSF,2010e5,wv,000,0034,0002556,080,54,081,08000US540819082863988001500,"Census Tract 15 (part), Piney View CDP, District 2, Raleigh County, West Virginia",244,187,40,0,0,40,147,57,41,0,0,0,0,41,16,16,0,0,16,0
ACSSF,2010e5,wv,000,0034,0002557,080,54,081,08000US540819082865836001400,"Census Tract 14 (part), Prosperity CDP, District 2, Raleigh County, West Virginia",367,183,83,25,0,58,100,184,19,0,0,0,0,19,165,66,39,0,27,99
ACSSF,2010e5,wv,000,0034,0002558,080,54,081,08000US540819082876444001500,"Census Tract 15 (part), Stanaford CDP (part), District 2, Raleigh County, West Virginia",278,231,149,64,0,85,82,47,40,30,0,0,30,10,7,7,0,0,7,0
ACSSF,2010e5,wv,000,0034,0002559,080,54,081,08000US540819082899999000400,"Census Tract 4 (part), District Remainder of 2, District 2, Raleigh County, West Virginia",60,36,0,0,0,0,36,24,0,0,0,0,0,0,24,0,0,0,0,24
ACSSF,2010e5,wv,000,0034,0002560,080,54,081,08000US540819082899999000500,"Census Tract 5 (part), District Remainder of 2, District 2, Raleigh County, West Virginia",626,389,136,21,0,115,253,237,45,0,0,0,0,45,192,70,0,11,59,122
ACSSF,2010e5,wv,000,0034,0002561,080,54,081,08000US540819082899999000600,"Census Tract 6 (part), District Remainder of 2, District 2, Raleigh County, West Virginia",54,54,15,15,0,0,39,0,0,0,0,0,0,0,0,0,0,0,0,0
ACSSF,2010e5,wv,000,0034,0002562,080,54,081,08000US540819082899999001100,"Census Tract 11 (part), District Remainder of 2, District 2, Raleigh County, West Virginia",137,64,20,0,0,20,44,73,41,22,0,0,22,19,32,21,0,0,21,11
ACSSF,2010e5,wv,000,0034,0002563,080,54,081,08000US540819082899999001200,"Census Tract 12 (part), District Remainder of 2, District 2, Raleigh County, West Virginia",1234,961,397,38,159,200,564,273,45,0,0,0,0,45,228,107,0,40,67,121
ACSSF,2010e5,wv,000,0034,0002564,080,54,081,08000US540819082899999001300,"Census Tract 13 (part), District Remainder of 2, District 2, Raleigh County, West Virginia",728,545,193,117,27,49,352,183,31,0,0,0,0,31,152,83,19,37,27,69
ACSSF,2010e5,wv,000,0034,0002565,080,54,081,08000US540819082899999001400,"Census Tract 14 (part), District Remainder of 2, District 2, Raleigh County, West Virginia",476,370,136,0,0,136,234,106,0,0,0,0,0,0,106,86,60,0,26,20
ACSSF,2010e5,wv,000,0034,0002566,080,54,081,08000US540819082899999001500,"Census Tract 15 (part), District Remainder of 2, District 2, Raleigh County, West Virginia",77,42,7,0,0,7,35,35,23,23,0,0,23,0,12,0,0,0,0,12
ACSSF,2010e5,wv,000,0034,0002567,080,54,081,08000US540819086405260000804,"Census Tract 8.04 (part), Beaver CDP, District 3, Raleigh County, West Virginia",415,287,89,12,32,45,198,128,65,21,21,0,0,44,63,53,11,0,42,10
ACSSF,2010e5,wv,000,0034,0002568,080,54,081,08000US540819086405332000200,"Census Tract 2 (part), Beckley city (part), District 3, Raleigh County, West Virginia",766,314,64,17,30,17,250,452,149,62,19,20,23,87,303,97,36,14,47,206
ACSSF,2010e5,wv,000,0034,0002569,080,54,081,08000US540819086405332000300,"Census Tract 3 (part), Beckley city (part), District 3, Raleigh County, West Virginia",818,576,203,87,39,77,373,242,54,43,0,43,0,11,188,67,10,0,57,121
ACSSF,2010e5,wv,000,0034,0002570,080,54,081,08000US540819086405332000400,"Census Tract 4 (part), Beckley city (part), District 3, Raleigh County, West Virginia",403,296,102,26,45,31,194,107,54,11,11,0,0,43,53,36,8,0,28,17
ACSSF,2010e5,wv,000,0034,0002571,080,54,081,08000US540819086405332000600,"Census Tract 6 (part), Beckley city (part), District 3, Raleigh County, West Virginia",183,130,110,0,43,67,20,53,19,0,0,0,0,19,34,22,0,0,22,12
ACSSF,2010e5,wv,000,0034,0002572,080,54,081,08000US540819086405332000700,"Census Tract 7 (part), Beckley city (part), District 3, Raleigh County, West Virginia",0,0,0,0,0,0,0,0,0,0,0,0,0,0,0,0,0,0,0,0
ACSSF,2010e5,wv,000,0034,0002573,080,54,081,08000US540819086405332001500,"Census Tract 15 (part), Beckley city (part), District 3, Raleigh County, West Virginia",214,205,45,0,0,45,160,9,0,0,0,0,0,0,9,0,0,0,0,9
ACSSF,2010e5,wv,000,0034,0002574,080,54,081,08000US540819086420164000804,"Census Tract 8.04 (part), Daniels CDP, District 3, Raleigh County, West Virginia",442,392,83,7,34,42,309,50,0,0,0,0,0,0,50,38,38,0,0,12
ACSSF,2010e5,wv,000,0034,0002575,080,54,081,08000US540819086449492000700,"Census Tract 7 (part), Mabscott town (part), District 3, Raleigh County, West Virginia",0,0,0,0,0,0,0,0,0,0,0,0,0,0,0,0,0,0,0,0
ACSSF,2010e5,wv,000,0034,0002576,080,54,081,08000US540819086449564000200,"Census Tract 2 (part), MacArthur CDP (part), District 3, Raleigh County, West Virginia",0,0,0,0,0,0,0,0,0,0,0,0,0,0,0,0,0,0,0,0
ACSSF,2010e5,wv,000,0034,0002577,080,54,081,08000US540819086449564000700,"Census Tract 7 (part), MacArthur CDP (part), District 3, Raleigh County, West Virginia",22,0,0,0,0,0,0,22,22,22,0,0,22,0,0,0,0,0,0,0
ACSSF,2010e5,wv,000,0034,0002578,080,54,081,08000US540819086473108000803,"Census Tract 8.03 (part), Shady Spring CDP, District 3, Raleigh County, West Virginia",626,460,175,52,0,123,285,166,64,64,0,0,64,0,102,67,0,0,67,35
ACSSF,2010e5,wv,000,0034,0002579,080,54,081,08000US540819086473108000804,"Census Tract 8.04 (part), Shady Spring CDP, District 3, Raleigh County, West Virginia",263,208,37,37,0,0,171,55,14,0,0,0,0,14,41,29,29,0,0,12
ACSSF,2010e5,wv,000,0034,0002580,080,54,081,08000US540819086476444001500,"Census Tract 15 (part), Stanaford CDP (part), District 3, Raleigh County, West Virginia",182,172,66,0,41,25,106,10,0,0,0,0,0,0,10,0,0,0,0,10
ACSSF,2010e5,wv,000,0034,0002581,080,54,081,08000US540819086499999000200,"Census Tract 2 (part), District Remainder of 3, District 3, Raleigh County, West Virginia",37,14,14,0,0,14,0,23,23,23,0,0,23,0,0,0,0,0,0,0
ACSSF,2010e5,wv,000,0034,0002582,080,54,081,08000US540819086499999000300,"Census Tract 3 (part), District Remainder of 3, District 3, Raleigh County, West Virginia",326,235,101,7,41,53,134,91,0,0,0,0,0,0,91,42,0,0,42,49
ACSSF,2010e5,wv,000,0034,0002583,080,54,081,08000US540819086499999000400,"Census Tract 4 (part), District Remainder of 3, District 3, Raleigh County, West Virginia",0,0,0,0,0,0,0,0,0,0,0,0,0,0,0,0,0,0,0,0
ACSSF,2010e5,wv,000,0034,0002584,080,54,081,08000US540819086499999000700,"Census Tract 7 (part), District Remainder of 3, District 3, Raleigh County, West Virginia",102,102,0,0,0,0,102,0,0,0,0,0,0,0,0,0,0,0,0,0
ACSSF,2010e5,wv,000,0034,0002585,080,54,081,08000US540819086499999000802,"Census Tract 8.02, District Remainder of 3, District 3, Raleigh County, West Virginia",1066,917,221,21,28,172,696,149,42,28,0,0,28,14,107,20,0,15,5,87
ACSSF,2010e5,wv,000,0034,0002586,080,54,081,08000US540819086499999000803,"Census Tract 8.03 (part), District Remainder of 3, District 3, Raleigh County, West Virginia",460,404,211,92,22,97,193,56,14,0,0,0,0,14,42,0,0,0,0,42
ACSSF,2010e5,wv,000,0034,0002587,080,54,081,08000US540819086499999000804,"Census Tract 8.04 (part), District Remainder of 3, District 3, Raleigh County, West Virginia",671,564,268,18,30,220,296,107,51,15,0,0,15,36,56,42,0,10,32,14
ACSSF,2010e5,wv,000,0034,0002588,080,54,081,08000US540819086499999000900,"Census Tract 9 (part), District Remainder of 3, District 3, Raleigh County, West Virginia",105,105,0,0,0,0,105,0,0,0,0,0,0,0,0,0,0,0,0,0
ACSSF,2010e5,wv,000,0034,0002589,080,54,081,08000US540819086499999001001,"Census Tract 10.01 (part), District Remainder of 3, District 3, Raleigh County, West Virginia",0,0,0,0,0,0,0,0,0,0,0,0,0,0,0,0,0,0,0,0
ACSSF,2010e5,wv,000,0034,0002590,080,54,081,08000US540819086499999001002,"Census Tract 10.02 (part), District Remainder of 3, District 3, Raleigh County, West Virginia",11,11,11,0,11,0,0,0,0,0,0,0,0,0,0,0,0,0,0,0
ACSSF,2010e5,wv,000,0034,0002591,080,54,081,08000US540819086499999001500,"Census Tract 15 (part), District Remainder of 3, District 3, Raleigh County, West Virginia",129,84,60,0,27,33,24,45,13,13,13,0,0,0,32,13,7,0,6,19
ACSSF,2010e5,wv,000,0034,0002592,080,54,083,08000US540839015606988966400,"Census Tract 9664 (part), Beverly town, Beverly district, Randolph County, West Virginia",163,116,44,4,0,40,72,47,10,10,0,0,10,0,37,29,25,0,4,8
ACSSF,2010e5,wv,000,0034,0002593,080,54,083,08000US540839015609364966300,"Census Tract 9663 (part), Bowden CDP, Beverly district, Randolph County, West Virginia",0,0,0,0,0,0,0,0,0,0,0,0,0,0,0,0,0,0,0,0
ACSSF,2010e5,wv,000,0034,0002594,080,54,083,08000US540839015624580966000,"Census Tract 9660 (part), Elkins city (part), Beverly district, Randolph County, West Virginia",0,0,0,0,0,0,0,0,0,0,0,0,0,0,0,0,0,0,0,0
ACSSF,2010e5,wv,000,0034,0002595,080,54,083,08000US540839015624580966400,"Census Tract 9664 (part), Elkins city (part), Beverly district, Randolph County, West Virginia",12,0,0,0,0,0,0,12,12,12,0,0,12,0,0,0,0,0,0,0
ACSSF,2010e5,wv,000,0034,0002596,080,54,083,08000US540839015699999965900,"Census Tract 9659 (part), Remainder of Beverly district, Beverly district, Randolph County, West Virginia",83,70,0,0,0,0,70,13,13,0,0,0,0,13,0,0,0,0,0,0
ACSSF,2010e5,wv,000,0034,0002597,080,54,083,08000US540839015699999966000,"Census Tract 9660 (part), Remainder of Beverly district, Beverly district, Randolph County, West Virginia",0,0,0,0,0,0,0,0,0,0,0,0,0,0,0,0,0,0,0,0
ACSSF,2010e5,wv,000,0034,0002598,080,54,083,08000US540839015699999966200,"Census Tract 9662 (part), Remainder of Beverly district, Beverly district, Randolph County, West Virginia",0,0,0,0,0,0,0,0,0,0,0,0,0,0,0,0,0,0,0,0
ACSSF,2010e5,wv,000,0034,0002599,080,54,083,08000US540839015699999966300,"Census Tract 9663 (part), Remainder of Beverly district, Beverly district, Randolph County, West Virginia",54,46,0,0,0,0,46,8,0,0,0,0,0,0,8,0,0,0,0,8
ACSSF,2010e5,wv,000,0034,0002600,080,54,083,08000US540839015699999966400,"Census Tract 9664 (part), Remainder of Beverly district, Beverly district, Randolph County, West Virginia",893,640,195,10,39,146,445,253,98,15,0,0,15,83,155,138,15,50,73,17
ACSSF,2010e5,wv,000,0034,0002601,080,54,083,08000US540839015699999966500,"Census Tract 9665 (part), Remainder of Beverly district, Beverly district, Randolph County, West Virginia",21,21,21,4,0,17,0,0,0,0,0,0,0,0,0,0,0,0,0,0
ACSSF,2010e5,wv,000,0034,0002602,080,54,083,08000US540839093635092966300,"Census Tract 9663 (part), Harman town, Dry Fork district, Randolph County, West Virginia",43,22,3,3,0,0,19,21,4,4,0,0,4,0,17,14,5,0,9,3
ACSSF,2010e5,wv,000,0034,0002603,080,54,083,08000US540839093686932966300,"Census Tract 9663 (part), Whitmer CDP, Dry Fork district, Randolph County, West Virginia",67,67,50,27,0,23,17,0,0,0,0,0,0,0,0,0,0,0,0,0
ACSSF,2010e5,wv,000,0034,0002604,080,54,083,08000US540839093699999966300,"Census Tract 9663 (part), Remainder of Dry Fork district, Dry Fork district, Randolph County, West Virginia",469,399,26,26,0,0,373,70,9,0,0,0,0,9,61,30,0,0,30,31
ACSSF,2010e5,wv,000,0034,0002605,080,54,083,08000US540839093699999966500,"Census Tract 9665 (part), Remainder of Dry Fork district, Dry Fork district, Randolph County, West Virginia",0,0,0,0,0,0,0,0,0,0,0,0,0,0,0,0,0,0,0,0
ACSSF,2010e5,wv,000,0034,0002606,080,54,083,08000US540839166839628966500,"Census Tract 9665 (part), Huttonsville town, Huttonsville district, Randolph County, West Virginia",31,28,13,3,4,6,15,3,0,0,0,0,0,0,3,3,0,0,3,0
ACSSF,2010e5,wv,000,0034,0002607,080,54,083,08000US540839166854100966500,"Census Tract 9665 (part), Mill Creek town, Huttonsville district, Randolph County, West Virginia",176,143,50,0,14,36,93,33,3,3,0,0,3,0,30,13,0,0,13,17
ACSSF,2010e5,wv,000,0034,0002608,080,54,083,08000US540839166899999966500,"Census Tract 9665 (part), Remainder of Huttonsville district, Huttonsville district, Randolph County, West Virginia",371,367,82,19,15,48,285,4,0,0,0,0,0,0,4,0,0,0,0,4
ACSSF,2010e5,wv,000,0034,0002609,080,54,083,08000US540839182424580966000,"Census Tract 9660 (part), Elkins city (part), Leadsville district, Randolph County, West Virginia",622,466,152,34,24,94,314,156,46,31,16,0,15,15,110,75,0,47,28,35
ACSSF,2010e5,wv,000,0034,0002610,080,54,083,08000US540839182424580966100,"Census Tract 9661 (part), Elkins city (part), Leadsville district, Randolph County, West Virginia",795,560,220,29,16,175,340,235,35,26,21,5,0,9,200,115,9,35,71,85
ACSSF,2010e5,wv,000,0034,0002611,080,54,083,08000US540839182424580966200,"Census Tract 9662 (part), Elkins city (part), Leadsville district, Randolph County, West Virginia",270,212,115,0,8,107,97,58,10,10,10,0,0,0,48,48,30,0,18,0
ACSSF,2010e5,wv,000,0034,0002612,080,54,083,08000US540839182499999965900,"Census Tract 9659 (part), Remainder of Leadsville district, Leadsville district, Randolph County, West Virginia",24,24,0,0,0,0,24,0,0,0,0,0,0,0,0,0,0,0,0,0
ACSSF,2010e5,wv,000,0034,0002613,080,54,083,08000US540839182499999966000,"Census Tract 9660 (part), Remainder of Leadsville district, Leadsville district, Randolph County, West Virginia",297,220,65,0,29,36,155,77,0,0,0,0,0,0,77,41,0,0,41,36
ACSSF,2010e5,wv,000,0034,0002614,080,54,083,08000US540839182499999966100,"Census Tract 9661 (part), Remainder of Leadsville district, Leadsville district, Randolph County, West Virginia",14,14,14,0,14,0,0,0,0,0,0,0,0,0,0,0,0,0,0,0
ACSSF,2010e5,wv,000,0034,0002615,080,54,083,08000US540839182499999966200,"Census Tract 9662 (part), Remainder of Leadsville district, Leadsville district, Randolph County, West Virginia",856,715,233,50,21,162,482,141,55,11,0,0,11,44,86,14,0,0,14,72
ACSSF,2010e5,wv,000,0034,0002616,080,54,083,08000US540839182499999966300,"Census Tract 9663 (part), Remainder of Leadsville district, Leadsville district, Randolph County, West Virginia",51,44,22,14,0,8,22,7,7,7,7,0,0,0,0,0,0,0,0,0
ACSSF,2010e5,wv,000,0034,0002617,080,54,083,08000US540839182499999966400,"Census Tract 9664 (part), Remainder of Leadsville district, Leadsville district, Randolph County, West Virginia",367,367,116,0,27,89,251,0,0,0,0,0,0,0,0,0,0,0,0,0
ACSSF,2010e5,wv,000,0034,0002618,080,54,083,08000US540839214836340965900,"Census Tract 9659 (part), Helvetia CDP, Middle Fork district, Randolph County, West Virginia",4,4,0,0,0,0,4,0,0,0,0,0,0,0,0,0,0,0,0,0
ACSSF,2010e5,wv,000,0034,0002619,080,54,083,08000US540839214863484965900,"Census Tract 9659 (part), Pickens CDP, Middle Fork district, Randolph County, West Virginia",29,14,0,0,0,0,14,15,0,0,0,0,0,0,15,15,0,0,15,0
ACSSF,2010e5,wv,000,0034,0002620,080,54,083,08000US540839214899999965900,"Census Tract 9659 (part), Remainder of Middle Fork district, Middle Fork district, Randolph County, West Virginia",143,124,59,0,26,33,65,19,18,18,0,0,18,0,1,0,0,0,0,1
ACSSF,2010e5,wv,000,0034,0002621,080,54,083,08000US540839214899999966500,"Census Tract 9665 (part), Remainder of Middle Fork district, Middle Fork district, Randolph County, West Virginia",41,41,0,0,0,0,41,0,0,0,0,0,0,0,0,0,0,0,0,0
ACSSF,2010e5,wv,000,0034,0002622,080,54,083,08000US540839222082756966500,"Census Tract 9665 (part), Valley Head CDP, Mingo district, Randolph County, West Virginia",87,52,34,18,0,16,18,35,0,0,0,0,0,0,35,0,0,0,0,35
ACSSF,2010e5,wv,000,0034,0002623,080,54,083,08000US540839222099999965900,"Census Tract 9659 (part), Remainder of Mingo district, Mingo district, Randolph County, West Virginia",21,21,21,8,0,13,0,0,0,0,0,0,0,0,0,0,0,0,0,0
ACSSF,2010e5,wv,000,0034,0002624,080,54,083,08000US540839222099999966500,"Census Tract 9665 (part), Remainder of Mingo district, Mingo district, Randolph County, West Virginia",288,277,84,0,11,73,193,11,0,0,0,0,0,0,11,0,0,0,0,11
ACSSF,2010e5,wv,000,0034,0002625,080,54,083,08000US540839229255540966300,"Census Tract 9663 (part), Montrose town, New Interest district, Randolph County, West Virginia",39,20,6,0,0,6,14,19,4,0,0,0,0,4,15,4,0,0,4,11
ACSSF,2010e5,wv,000,0034,0002626,080,54,083,08000US540839229299999966200,"Census Tract 9662 (part), Remainder of New Interest district, New Interest district, Randolph County, West Virginia",124,124,0,0,0,0,124,0,0,0,0,0,0,0,0,0,0,0,0,0
ACSSF,2010e5,wv,000,0034,0002627,080,54,083,08000US540839229299999966300,"Census Tract 9663 (part), Remainder of New Interest district, New Interest district, Randolph County, West Virginia",232,202,70,7,14,49,132,30,20,20,20,0,0,0,10,0,0,0,0,10
ACSSF,2010e5,wv,000,0034,0002628,080,54,083,08000US540839264088324965900,"Census Tract 9659 (part), Womelsdorf (Coalton) town, Roaring Creek district, Randolph County, West Virginia",59,38,12,0,6,6,26,21,11,4,4,0,0,7,10,4,0,0,4,6
ACSSF,2010e5,wv,000,0034,0002629,080,54,083,08000US540839264099999965900,"Census Tract 9659 (part), Remainder of Roaring Creek district, Roaring Creek district, Randolph County, West Virginia",487,438,159,0,44,115,279,49,26,0,0,0,0,26,23,0,0,0,0,23
ACSSF,2010e5,wv,000,0034,0002630,080,54,083,08000US540839264099999966000,"Census Tract 9660 (part), Remainder of Roaring Creek district, Roaring Creek district, Randolph County, West Virginia",0,0,0,0,0,0,0,0,0,0,0,0,0,0,0,0,0,0,0,0
ACSSF,2010e5,wv,000,0034,0002631,080,54,083,08000US540839342019948965900,"Census Tract 9659 (part), Dailey CDP, Valley Bend district, Randolph County, West Virginia",15,15,0,0,0,0,15,0,0,0,0,0,0,0,0,0,0,0,0,0
ACSSF,2010e5,wv,000,0034,0002632,080,54,083,08000US540839342019948966400,"Census Tract 9664 (part), Dailey CDP, Valley Bend district, Randolph County, West Virginia",0,0,0,0,0,0,0,0,0,0,0,0,0,0,0,0,0,0,0,0
ACSSF,2010e5,wv,000,0034,0002633,080,54,083,08000US540839342023140966400,"Census Tract 9664 (part), East Dailey CDP, Valley Bend district, Randolph County, West Virginia",150,138,56,22,34,0,82,12,12,0,0,0,0,12,0,0,0,0,0,0
ACSSF,2010e5,wv,000,0034,0002634,080,54,083,08000US540839342082564965900,"Census Tract 9659 (part), Valley Bend CDP, Valley Bend district, Randolph County, West Virginia",141,126,86,0,44,42,40,15,0,0,0,0,0,0,15,15,0,15,0,0
ACSSF,2010e5,wv,000,0034,0002635,080,54,083,08000US540839342099999965900,"Census Tract 9659 (part), Remainder of Valley Bend district, Valley Bend district, Randolph County, West Virginia",79,64,14,0,0,14,50,15,0,0,0,0,0,0,15,0,0,0,0,15
ACSSF,2010e5,wv,000,0034,0002636,080,54,083,08000US540839342099999966300,"Census Tract 9663 (part), Remainder of Valley Bend district, Valley Bend district, Randolph County, West Virginia",0,0,0,0,0,0,0,0,0,0,0,0,0,0,0,0,0,0,0,0
ACSSF,2010e5,wv,000,0034,0002637,080,54,083,08000US540839342099999966400,"Census Tract 9664 (part), Remainder of Valley Bend district, Valley Bend district, Randolph County, West Virginia",27,10,0,0,0,0,10,17,0,0,0,0,0,0,17,17,0,17,0,0
ACSSF,2010e5,wv,000,0034,0002638,080,54,083,08000US540839342099999966500,"Census Tract 9665 (part), Remainder of Valley Bend district, Valley Bend district, Randolph County, West Virginia",46,46,12,0,0,12,34,0,0,0,0,0,0,0,0,0,0,0,0,0
ACSSF,2010e5,wv,000,0034,0002639,080,54,085,08000US540859055224844962300,"Census Tract 9623 (part), Ellenboro town, Clay district, Ritchie County, West Virginia",164,138,23,0,2,21,115,26,2,0,0,0,0,2,24,18,0,0,18,6
ACSSF,2010e5,wv,000,0034,0002640,080,54,085,08000US540859055224844962500,"Census Tract 9625 (part), Ellenboro town, Clay district, Ritchie County, West Virginia",0,0,0,0,0,0,0,0,0,0,0,0,0,0,0,0,0,0,0,0
ACSSF,2010e5,wv,000,0034,0002641,080,54,085,08000US540859055235428962500,"Census Tract 9625 (part), Harrisville town (part), Clay district, Ritchie County, West Virginia",0,0,0,0,0,0,0,0,0,0,0,0,0,0,0,0,0,0,0,0
ACSSF,2010e5,wv,000,0034,0002642,080,54,085,08000US540859055262764962300,"Census Tract 9623 (part), Pennsboro city, Clay district, Ritchie County, West Virginia",342,213,59,8,14,37,154,129,24,11,0,0,11,13,105,59,10,3,46,46
ACSSF,2010e5,wv,000,0034,0002643,080,54,085,08000US540859055299999962300,"Census Tract 9623 (part), Remainder of Clay district, Clay district, Ritchie County, West Virginia",540,431,198,30,106,62,233,109,67,42,42,0,0,25,42,0,0,0,0,42
ACSSF,2010e5,wv,000,0034,0002644,080,54,085,08000US540859055299999962500,"Census Tract 9625 (part), Remainder of Clay district, Clay district, Ritchie County, West Virginia",15,15,0,0,0,0,15,0,0,0,0,0,0,0,0,0,0,0,0,0
ACSSF,2010e5,wv,000,0034,0002645,080,54,085,08000US540859138012124962400,"Census Tract 9624 (part), Cairo town, Grant district, Ritchie County, West Virginia",100,71,3,0,0,3,68,29,14,5,0,0,5,9,15,15,0,5,10,0
ACSSF,2010e5,wv,000,0034,0002646,080,54,085,08000US540859138099999962300,"Census Tract 9623 (part), Remainder of Grant district, Grant district, Ritchie County, West Virginia",49,24,12,12,0,0,12,25,11,0,0,0,0,11,14,14,0,0,14,0
ACSSF,2010e5,wv,000,0034,0002647,080,54,085,08000US540859138099999962400,"Census Tract 9624 (part), Remainder of Grant district, Grant district, Ritchie County, West Virginia",381,351,99,41,0,58,252,30,15,0,0,0,0,15,15,15,0,8,7,0
ACSSF,2010e5,wv,000,0034,0002648,080,54,085,08000US540859138099999962500,"Census Tract 9625 (part), Remainder of Grant district, Grant district, Ritchie County, West Virginia",0,0,0,0,0,0,0,0,0,0,0,0,0,0,0,0,0,0,0,0
ACSSF,2010e5,wv,000,0034,0002649,080,54,085,08000US540859224499999962400,"Census Tract 9624 (part), Murphy district, Murphy district, Ritchie County, West Virginia",322,238,50,0,0,50,188,84,21,0,0,0,0,21,63,21,0,0,21,42
ACSSF,2010e5,wv,000,0034,0002650,080,54,085,08000US540859224499999962500,"Census Tract 9625 (part), Murphy district, Murphy district, Ritchie County, West Virginia",17,17,0,0,0,0,17,0,0,0,0,0,0,0,0,0,0,0,0,0
ACSSF,2010e5,wv,000,0034,0002651,080,54,085,08000US540859333603364962500,"Census Tract 9625 (part), Auburn town, Union district, Ritchie County, West Virginia",21,13,0,0,0,0,13,8,2,0,0,0,0,2,6,5,0,0,5,1
ACSSF,2010e5,wv,000,0034,0002652,080,54,085,08000US540859333635428962500,"Census Tract 9625 (part), Harrisville town (part), Union district, Ritchie County, West Virginia",606,433,179,21,47,111,254,173,32,14,6,0,8,18,141,96,29,11,56,45
ACSSF,2010e5,wv,000,0034,0002653,080,54,085,08000US540859333665956962300,"Census Tract 9623 (part), Pullman town, Union district, Ritchie County, West Virginia",61,53,33,11,3,19,20,8,2,2,0,2,0,0,6,0,0,0,0,6
ACSSF,2010e5,wv,000,0034,0002654,080,54,085,08000US540859333665956962500,"Census Tract 9625 (part), Pullman town, Union district, Ritchie County, West Virginia",2,2,0,0,0,0,2,0,0,0,0,0,0,0,0,0,0,0,0,0
ACSSF,2010e5,wv,000,0034,0002655,080,54,085,08000US540859333699999962300,"Census Tract 9623 (part), Remainder of Union district, Union district, Ritchie County, West Virginia",8,8,0,0,0,0,8,0,0,0,0,0,0,0,0,0,0,0,0,0
ACSSF,2010e5,wv,000,0034,0002656,080,54,085,08000US540859333699999962400,"Census Tract 9624 (part), Remainder of Union district, Union district, Ritchie County, West Virginia",83,83,14,0,0,14,69,0,0,0,0,0,0,0,0,0,0,0,0,0
ACSSF,2010e5,wv,000,0034,0002657,080,54,085,08000US540859333699999962500,"Census Tract 9625 (part), Remainder of Union district, Union district, Ritchie County, West Virginia",213,164,23,0,11,12,141,49,40,19,0,0,19,21,9,0,0,0,0,9
ACSSF,2010e5,wv,000,0034,0002658,080,54,087,08000US540879079367660962800,"Census Tract 9628 (part), Reedy town, District I, Roane County, West Virginia",31,28,10,0,4,6,18,3,3,0,0,0,0,3,0,0,0,0,0,0
ACSSF,2010e5,wv,000,0034,0002659,080,54,087,08000US540879079375820963000,"Census Tract 9630 (part), Spencer city (part), District I, Roane County, West Virginia",196,176,76,18,49,9,100,20,20,0,0,0,0,20,0,0,0,0,0,0
ACSSF,2010e5,wv,000,0034,0002660,080,54,087,08000US540879079399999962800,"Census Tract 9628 (part), District Remainder of I, District I, Roane County, West Virginia",247,230,19,0,6,13,211,17,17,0,0,0,0,17,0,0,0,0,0,0
ACSSF,2010e5,wv,000,0034,0002661,080,54,087,08000US540879079399999962900,"Census Tract 9629 (part), District Remainder of I, District I, Roane County, West Virginia",595,501,218,110,0,108,283,94,13,13,0,0,13,0,81,18,0,0,18,63
ACSSF,2010e5,wv,000,0034,0002662,080,54,087,08000US540879079399999963000,"Census Tract 9630 (part), District Remainder of I, District I, Roane County, West Virginia",185,91,54,6,23,25,37,94,0,0,0,0,0,0,94,41,31,0,10,53
ACSSF,2010e5,wv,000,0034,0002663,080,54,087,08000US540879082975820963000,"Census Tract 9630 (part), Spencer city (part), District II, Roane County, West Virginia",412,272,128,5,28,95,144,140,25,20,0,0,20,5,115,23,7,0,16,92
ACSSF,2010e5,wv,000,0034,0002664,080,54,087,08000US540879082999999962800,"Census Tract 9628 (part), District Remainder of II, District II, Roane County, West Virginia",408,372,124,0,18,106,248,36,0,0,0,0,0,0,36,0,0,0,0,36
ACSSF,2010e5,wv,000,0034,0002665,080,54,087,08000US540879082999999962900,"Census Tract 9629 (part), District Remainder of II, District II, Roane County, West Virginia",122,68,14,0,0,14,54,54,16,0,0,0,0,16,38,0,0,0,0,38
ACSSF,2010e5,wv,000,0034,0002666,080,54,087,08000US540879082999999963000,"Census Tract 9630 (part), District Remainder of II, District II, Roane County, West Virginia",110,90,10,0,10,0,80,20,0,0,0,0,0,0,20,20,0,20,0,0
ACSSF,2010e5,wv,000,0034,0002667,080,54,087,08000US540879082999999963100,"Census Tract 9631 (part), District Remainder of II, District II, Roane County, West Virginia",176,176,70,0,0,70,106,0,0,0,0,0,0,0,0,0,0,0,0,0
ACSSF,2010e5,wv,000,0034,0002668,080,54,087,08000US540879086599999962900,"Census Tract 9629 (part), District III, District III, Roane County, West Virginia",412,345,84,18,12,54,261,67,14,0,0,0,0,14,53,0,0,0,0,53
ACSSF,2010e5,wv,000,0034,0002669,080,54,087,08000US540879086599999963100,"Census Tract 9631 (part), District III, District III, Roane County, West Virginia",1114,924,249,99,0,150,675,190,31,0,0,0,0,31,159,120,24,96,0,39
ACSSF,2010e5,wv,000,0034,0002670,080,54,089,08000US540899021637636000500,"Census Tract 5 (part), Hinton city (part), Bluestone River district, Summers County, West Virginia",85,21,21,0,0,21,0,64,19,19,0,0,19,0,45,25,0,0,25,20
ACSSF,2010e5,wv,000,0034,0002671,080,54,089,08000US540899021637636000600,"Census Tract 6 (part), Hinton city (part), Bluestone River district, Summers County, West Virginia",0,0,0,0,0,0,0,0,0,0,0,0,0,0,0,0,0,0,0,0
ACSSF,2010e5,wv,000,0034,0002672,080,54,089,08000US540899021637636000700,"Census Tract 7 (part), Hinton city (part), Bluestone River district, Summers County, West Virginia",88,45,30,10,14,6,15,43,11,11,0,0,11,0,32,0,0,0,0,32
ACSSF,2010e5,wv,000,0034,0002673,080,54,089,08000US540899021637636000800,"Census Tract 8 (part), Hinton city (part), Bluestone River district, Summers County, West Virginia",0,0,0,0,0,0,0,0,0,0,0,0,0,0,0,0,0,0,0,0
ACSSF,2010e5,wv,000,0034,0002674,080,54,089,08000US540899021699999000500,"Census Tract 5 (part), Remainder of Bluestone River district, Bluestone River district, Summers County, West Virginia",0,0,0,0,0,0,0,0,0,0,0,0,0,0,0,0,0,0,0,0
ACSSF,2010e5,wv,000,0034,0002675,080,54,089,08000US540899021699999000600,"Census Tract 6 (part), Remainder of Bluestone River district, Bluestone River district, Summers County, West Virginia",0,0,0,0,0,0,0,0,0,0,0,0,0,0,0,0,0,0,0,0
ACSSF,2010e5,wv,000,0034,0002676,080,54,089,08000US540899021699999000700,"Census Tract 7 (part), Remainder of Bluestone River district, Bluestone River district, Summers County, West Virginia",0,0,0,0,0,0,0,0,0,0,0,0,0,0,0,0,0,0,0,0
ACSSF,2010e5,wv,000,0034,0002677,080,54,089,08000US540899021699999000800,"Census Tract 8 (part), Remainder of Bluestone River district, Bluestone River district, Summers County, West Virginia",1089,886,297,94,37,166,589,203,57,20,0,0,20,37,146,78,0,0,78,68
ACSSF,2010e5,wv,000,0034,0002678,080,54,089,08000US540899144037636000600,"Census Tract 6 (part), Hinton city (part), Greenbrier River district, Summers County, West Virginia",38,38,13,0,0,13,25,0,0,0,0,0,0,0,0,0,0,0,0,0
ACSSF,2010e5,wv,000,0034,0002679,080,54,089,08000US540899144037636000700,"Census Tract 7 (part), Hinton city (part), Greenbrier River district, Summers County, West Virginia",203,161,77,7,0,70,84,42,20,0,0,0,0,20,22,11,0,0,11,11
ACSSF,2010e5,wv,000,0034,0002680,080,54,089,08000US540899144099999000500,"Census Tract 5 (part), Remainder of Greenbrier River district, Greenbrier River district, Summers County, West Virginia",0,0,0,0,0,0,0,0,0,0,0,0,0,0,0,0,0,0,0,0
ACSSF,2010e5,wv,000,0034,0002681,080,54,089,08000US540899144099999000600,"Census Tract 6 (part), Remainder of Greenbrier River district, Greenbrier River district, Summers County, West Virginia",805,686,163,29,34,100,523,119,51,28,0,0,28,23,68,16,0,0,16,52
ACSSF,2010e5,wv,000,0034,0002682,080,54,089,08000US540899144099999000700,"Census Tract 7 (part), Remainder of Greenbrier River district, Greenbrier River district, Summers County, West Virginia",0,0,0,0,0,0,0,0,0,0,0,0,0,0,0,0,0,0,0,0
ACSSF,2010e5,wv,000,0034,0002683,080,54,089,08000US540899231637636000500,"Census Tract 5 (part), Hinton city (part), New River district, Summers County, West Virginia",94,66,8,8,0,0,58,28,19,19,19,0,0,0,9,9,0,0,9,0
ACSSF,2010e5,wv,000,0034,0002684,080,54,089,08000US540899231637636000700,"Census Tract 7 (part), Hinton city (part), New River district, Summers County, West Virginia",52,15,0,0,0,0,15,37,0,0,0,0,0,0,37,0,0,0,0,37
ACSSF,2010e5,wv,000,0034,0002685,080,54,089,08000US540899231699999000500,"Census Tract 5 (part), Remainder of New River district, New River district, Summers County, West Virginia",498,362,46,14,8,24,316,136,38,0,0,0,0,38,98,30,0,0,30,68
ACSSF,2010e5,wv,000,0034,0002686,080,54,089,08000US540899231699999000600,"Census Tract 6 (part), Remainder of New River district, New River district, Summers County, West Virginia",244,163,61,0,29,32,102,81,51,19,0,0,19,32,30,14,0,14,0,16
ACSSF,2010e5,wv,000,0034,0002687,080,54,091,08000US540919099332716964600,"Census Tract 9646 (part), Grafton city (part), Eastern district, Taylor County, West Virginia",480,285,74,0,0,74,211,195,22,0,0,0,0,22,173,121,0,53,68,52
ACSSF,2010e5,wv,000,0034,0002688,080,54,091,08000US540919099332716964700,"Census Tract 9647 (part), Grafton city (part), Eastern district, Taylor County, West Virginia",0,0,0,0,0,0,0,0,0,0,0,0,0,0,0,0,0,0,0,0
ACSSF,2010e5,wv,000,0034,0002689,080,54,091,08000US540919099332716964900,"Census Tract 9649 (part), Grafton city (part), Eastern district, Taylor County, West Virginia",0,0,0,0,0,0,0,0,0,0,0,0,0,0,0,0,0,0,0,0
ACSSF,2010e5,wv,000,0034,0002690,080,54,091,08000US540919099399999964600,"Census Tract 9646 (part), Remainder of Eastern district, Eastern district, Taylor County, West Virginia",609,526,158,53,30,75,368,83,37,0,0,0,0,37,46,27,0,0,27,19
ACSSF,2010e5,wv,000,0034,0002691,080,54,091,08000US540919099399999964700,"Census Tract 9647 (part), Remainder of Eastern district, Eastern district, Taylor County, West Virginia",0,0,0,0,0,0,0,0,0,0,0,0,0,0,0,0,0,0,0,0
ACSSF,2010e5,wv,000,0034,0002692,080,54,091,08000US540919099399999964800,"Census Tract 9648 (part), Remainder of Eastern district, Eastern district, Taylor County, West Virginia",0,0,0,0,0,0,0,0,0,0,0,0,0,0,0,0,0,0,0,0
ACSSF,2010e5,wv,000,0034,0002693,080,54,091,08000US540919099399999964900,"Census Tract 9649 (part), Remainder of Eastern district, Eastern district, Taylor County, West Virginia",380,345,105,20,19,66,240,35,11,0,0,0,0,11,24,0,0,0,0,24
ACSSF,2010e5,wv,000,0034,0002694,080,54,091,08000US540919317532716964600,"Census Tract 9646 (part), Grafton city (part), Tygart district, Taylor County, West Virginia",349,144,69,0,14,55,75,205,65,19,0,0,19,46,140,66,0,16,50,74
ACSSF,2010e5,wv,000,0034,0002695,080,54,091,08000US540919317532716964800,"Census Tract 9648 (part), Grafton city (part), Tygart district, Taylor County, West Virginia",396,295,81,6,36,39,214,101,0,0,0,0,0,0,101,57,11,0,46,44
ACSSF,2010e5,wv,000,0034,0002696,080,54,091,08000US540919317532716964900,"Census Tract 9649 (part), Grafton city (part), Tygart district, Taylor County, West Virginia",130,84,53,39,0,14,31,46,8,0,0,0,0,8,38,38,0,19,19,0
ACSSF,2010e5,wv,000,0034,0002697,080,54,091,08000US540919317599999964600,"Census Tract 9646 (part), Remainder of Tygart district, Tygart district, Taylor County, West Virginia",0,0,0,0,0,0,0,0,0,0,0,0,0,0,0,0,0,0,0,0
ACSSF,2010e5,wv,000,0034,0002698,080,54,091,08000US540919317599999964800,"Census Tract 9648 (part), Remainder of Tygart district, Tygart district, Taylor County, West Virginia",310,296,164,0,73,91,132,14,0,0,0,0,0,0,14,11,11,0,0,3
ACSSF,2010e5,wv,000,0034,0002699,080,54,091,08000US540919317599999964900,"Census Tract 9649 (part), Remainder of Tygart district, Tygart district, Taylor County, West Virginia",0,0,0,0,0,0,0,0,0,0,0,0,0,0,0,0,0,0,0,0
ACSSF,2010e5,wv,000,0034,0002700,080,54,091,08000US540919362127940964800,"Census Tract 9648 (part), Flemington town, Western district, Taylor County, West Virginia",91,68,27,0,12,15,41,23,7,4,0,0,4,3,16,6,0,0,6,10
ACSSF,2010e5,wv,000,0034,0002701,080,54,091,08000US540919362199999964600,"Census Tract 9646 (part), Remainder of Western district, Western district, Taylor County, West Virginia",0,0,0,0,0,0,0,0,0,0,0,0,0,0,0,0,0,0,0,0
ACSSF,2010e5,wv,000,0034,0002702,080,54,091,08000US540919362199999964700,"Census Tract 9647 (part), Remainder of Western district, Western district, Taylor County, West Virginia",1238,1064,368,156,30,182,696,174,38,11,0,0,11,27,136,105,21,0,84,31
ACSSF,2010e5,wv,000,0034,0002703,080,54,091,08000US540919362199999964800,"Census Tract 9648 (part), Remainder of Western district, Western district, Taylor County, West Virginia",605,430,224,27,47,150,206,175,62,15,0,15,0,47,113,44,0,0,44,69
ACSSF,2010e5,wv,000,0034,0002704,080,54,093,08000US540939019234492965300,"Census Tract 9653 (part), Hambleton town, Black Fork district, Tucker County, West Virginia",70,63,20,3,8,9,43,7,7,3,0,0,3,4,0,0,0,0,0,0
ACSSF,2010e5,wv,000,0034,0002705,080,54,093,08000US540939019236460965300,"Census Tract 9653 (part), Hendricks town, Black Fork district, Tucker County, West Virginia",101,88,35,7,8,20,53,13,2,2,2,0,0,0,11,0,0,0,0,11
ACSSF,2010e5,wv,000,0034,0002706,080,54,093,08000US540939019262284965400,"Census Tract 9654 (part), Parsons city, Black Fork district, Tucker County, West Virginia",489,362,149,41,20,88,213,127,30,6,6,0,0,24,97,53,24,21,8,44
ACSSF,2010e5,wv,000,0034,0002707,080,54,093,08000US540939019299999965200,"Census Tract 9652 (part), Remainder of Black Fork district, Black Fork district, Tucker County, West Virginia",0,0,0,0,0,0,0,0,0,0,0,0,0,0,0,0,0,0,0,0
ACSSF,2010e5,wv,000,0034,0002708,080,54,093,08000US540939019299999965300,"Census Tract 9653 (part), Remainder of Black Fork district, Black Fork district, Tucker County, West Virginia",30,16,16,0,0,16,0,14,14,14,0,0,14,0,0,0,0,0,0,0
ACSSF,2010e5,wv,000,0034,0002709,080,54,093,08000US540939019299999965400,"Census Tract 9654 (part), Remainder of Black Fork district, Black Fork district, Tucker County, West Virginia",465,417,185,31,31,123,232,48,18,0,0,0,0,18,30,19,19,0,0,11
ACSSF,2010e5,wv,000,0034,0002710,080,54,093,08000US540939062499999965200,"Census Tract 9652 (part), Clover district, Clover district, Tucker County, West Virginia",99,99,24,0,0,24,75,0,0,0,0,0,0,0,0,0,0,0,0,0
ACSSF,2010e5,wv,000,0034,0002711,080,54,093,08000US540939062499999965400,"Census Tract 9654 (part), Clover district, Clover district, Tucker County, West Virginia",0,0,0,0,0,0,0,0,0,0,0,0,0,0,0,0,0,0,0,0
ACSSF,2010e5,wv,000,0034,0002712,080,54,093,08000US540939074420428965300,"Census Tract 9653 (part), Davis town, Davis district, Tucker County, West Virginia",146,116,35,14,4,17,81,30,10,5,0,0,5,5,20,0,0,0,0,20
ACSSF,2010e5,wv,000,0034,0002713,080,54,093,08000US540939074480020965300,"Census Tract 9653 (part), Thomas city (part), Davis district, Tucker County, West Virginia",0,0,0,0,0,0,0,0,0,0,0,0,0,0,0,0,0,0,0,0
ACSSF,2010e5,wv,000,0034,0002714,080,54,093,08000US540939074499999965300,"Census Tract 9653 (part), Remainder of Davis district, Davis district, Tucker County, West Virginia",0,0,0,0,0,0,0,0,0,0,0,0,0,0,0,0,0,0,0,0
ACSSF,2010e5,wv,000,0034,0002715,080,54,093,08000US540939094899999965300,"Census Tract 9653 (part), Dry Fork district, Dry Fork district, Tucker County, West Virginia",201,174,3,0,0,3,171,27,0,0,0,0,0,0,27,0,0,0,0,27
ACSSF,2010e5,wv,000,0034,0002716,080,54,093,08000US540939105680020965200,"Census Tract 9652 (part), Thomas city (part), Fairfax district, Tucker County, West Virginia",132,99,21,3,0,18,78,33,10,0,0,0,0,10,23,18,7,6,5,5
ACSSF,2010e5,wv,000,0034,0002717,080,54,093,08000US540939105680020965300,"Census Tract 9653 (part), Thomas city (part), Fairfax district, Tucker County, West Virginia",0,0,0,0,0,0,0,0,0,0,0,0,0,0,0,0,0,0,0,0
ACSSF,2010e5,wv,000,0034,0002718,080,54,093,08000US540939105699999965200,"Census Tract 9652 (part), Remainder of Fairfax district, Fairfax district, Tucker County, West Virginia",43,43,0,0,0,0,43,0,0,0,0,0,0,0,0,0,0,0,0,0
ACSSF,2010e5,wv,000,0034,0002719,080,54,093,08000US540939105699999965300,"Census Tract 9653 (part), Remainder of Fairfax district, Fairfax district, Tucker County, West Virginia",0,0,0,0,0,0,0,0,0,0,0,0,0,0,0,0,0,0,0,0
ACSSF,2010e5,wv,000,0034,0002720,080,54,093,08000US540939105699999965400,"Census Tract 9654 (part), Remainder of Fairfax district, Fairfax district, Tucker County, West Virginia",0,0,0,0,0,0,0,0,0,0,0,0,0,0,0,0,0,0,0,0
ACSSF,2010e5,wv,000,0034,0002721,080,54,093,08000US540939189699999965200,"Census Tract 9652 (part), Licking district, Licking district, Tucker County, West Virginia",44,14,0,0,0,0,14,30,0,0,0,0,0,0,30,0,0,0,0,30
ACSSF,2010e5,wv,000,0034,0002722,080,54,093,08000US540939268899999965200,"Census Tract 9652 (part), St. George district, St. George district, Tucker County, West Virginia",199,143,49,0,0,49,94,56,29,14,14,0,0,15,27,0,0,0,0,27
ACSSF,2010e5,wv,000,0034,0002723,080,54,093,08000US540939268899999965400,"Census Tract 9654 (part), St. George district, St. George district, Tucker County, West Virginia",53,39,13,0,0,13,26,14,14,14,0,0,14,0,0,0,0,0,0,0
ACSSF,2010e5,wv,000,0034,0002724,080,54,095,08000US540959046929404961900,"Census Tract 9619 (part), Friendly town, Central district, Tyler County, West Virginia",33,30,15,6,4,5,15,3,0,0,0,0,0,0,3,0,0,0,0,3
ACSSF,2010e5,wv,000,0034,0002725,080,54,095,08000US540959046953572961900,"Census Tract 9619 (part), Middlebourne town, Central district, Tyler County, West Virginia",220,157,64,10,7,47,93,63,17,8,8,0,0,9,46,15,5,0,10,31
ACSSF,2010e5,wv,000,0034,0002726,080,54,095,08000US540959046999999961800,"Census Tract 9618 (part), Remainder of Central district, Central district, Tyler County, West Virginia",0,0,0,0,0,0,0,0,0,0,0,0,0,0,0,0,0,0,0,0
ACSSF,2010e5,wv,000,0034,0002727,080,54,095,08000US540959046999999961900,"Census Tract 9619 (part), Remainder of Central district, Central district, Tyler County, West Virginia",344,330,83,43,0,40,247,14,0,0,0,0,0,0,14,6,0,6,0,8
ACSSF,2010e5,wv,000,0034,0002728,080,54,095,08000US540959046999999962000,"Census Tract 9620 (part), Remainder of Central district, Central district, Tyler County, West Virginia",0,0,0,0,0,0,0,0,0,0,0,0,0,0,0,0,0,0,0,0
ACSSF,2010e5,wv,000,0034,0002729,080,54,095,08000US540959233461636961800,"Census Tract 9618 (part), Paden City city (part), North district, Tyler County, West Virginia",251,201,94,9,35,50,107,50,28,23,23,0,0,5,22,22,0,0,22,0
ACSSF,2010e5,wv,000,0034,0002730,080,54,095,08000US540959233499999961800,"Census Tract 9618 (part), Remainder of North district, North district, Tyler County, West Virginia",81,81,50,23,0,27,31,0,0,0,0,0,0,0,0,0,0,0,0,0
ACSSF,2010e5,wv,000,0034,0002731,080,54,095,08000US540959233499999961900,"Census Tract 9619 (part), Remainder of North district, North district, Tyler County, West Virginia",351,255,38,0,13,25,217,96,11,0,0,0,0,11,85,33,0,0,33,52
ACSSF,2010e5,wv,000,0034,0002732,080,54,095,08000US540959233499999962000,"Census Tract 9620 (part), Remainder of North district, North district, Tyler County, West Virginia",10,10,0,0,0,0,10,0,0,0,0,0,0,0,0,0,0,0,0,0
ACSSF,2010e5,wv,000,0034,0002733,080,54,095,08000US540959289899999961900,"Census Tract 9619 (part), South district, South district, Tyler County, West Virginia",82,73,20,0,20,0,53,9,9,0,0,0,0,9,0,0,0,0,0,0
ACSSF,2010e5,wv,000,0034,0002734,080,54,095,08000US540959289899999962000,"Census Tract 9620 (part), South district, South district, Tyler County, West Virginia",666,481,162,17,16,129,319,185,102,57,24,0,33,45,83,10,0,0,10,73
ACSSF,2010e5,wv,000,0034,0002735,080,54,095,08000US540959359274380961800,"Census Tract 9618 (part), Sistersville city, West district, Tyler County, West Virginia",394,303,94,10,19,65,209,91,11,8,0,3,5,3,80,58,7,0,51,22
ACSSF,2010e5,wv,000,0034,0002736,080,54,095,08000US540959359299999961800,"Census Tract 9618 (part), Remainder of West district, West district, Tyler County, West Virginia",125,125,44,10,7,27,81,0,0,0,0,0,0,0,0,0,0,0,0,0
ACSSF,2010e5,wv,000,0034,0002737,080,54,095,08000US540959359299999961900,"Census Tract 9619 (part), Remainder of West district, West district, Tyler County, West Virginia",28,28,0,0,0,0,28,0,0,0,0,0,0,0,0,0,0,0,0,0
ACSSF,2010e5,wv,000,0034,0002738,080,54,097,08000US540979110211188966600,"Census Tract 9666 (part), Buckhannon city (part), First district, Upshur County, West Virginia",65,41,15,15,0,0,26,24,0,0,0,0,0,0,24,24,0,24,0,0
ACSSF,2010e5,wv,000,0034,0002739,080,54,097,08000US540979110211188966700,"Census Tract 9667 (part), Buckhannon city (part), First district, Upshur County, West Virginia",524,423,169,29,38,102,254,101,6,6,6,0,0,0,95,62,0,23,39,33
ACSSF,2010e5,wv,000,0034,0002740,080,54,097,08000US540979110211188966800,"Census Tract 9668 (part), Buckhannon city (part), First district, Upshur County, West Virginia",166,112,38,21,0,17,74,54,0,0,0,0,0,0,54,34,0,11,23,20
ACSSF,2010e5,wv,000,0034,0002741,080,54,097,08000US540979110211188966900,"Census Tract 9669 (part), Buckhannon city (part), First district, Upshur County, West Virginia",259,153,62,8,23,31,91,106,8,0,0,0,0,8,98,22,0,0,22,76
ACSSF,2010e5,wv,000,0034,0002742,080,54,097,08000US540979110299999966600,"Census Tract 9666 (part), Remainder of First district, First district, Upshur County, West Virginia",537,385,212,41,0,171,173,152,90,26,0,0,26,64,62,21,21,0,0,41
ACSSF,2010e5,wv,000,0034,0002743,080,54,097,08000US540979110299999966700,"Census Tract 9667 (part), Remainder of First district, First district, Upshur County, West Virginia",0,0,0,0,0,0,0,0,0,0,0,0,0,0,0,0,0,0,0,0
ACSSF,2010e5,wv,000,0034,0002744,080,54,097,08000US540979110299999966800,"Census Tract 9668 (part), Remainder of First district, First district, Upshur County, West Virginia",45,37,0,0,0,0,37,8,8,0,0,0,0,8,0,0,0,0,0,0
ACSSF,2010e5,wv,000,0034,0002745,080,54,097,08000US540979110299999966900,"Census Tract 9669 (part), Remainder of First district, First district, Upshur County, West Virginia",0,0,0,0,0,0,0,0,0,0,0,0,0,0,0,0,0,0,0,0
ACSSF,2010e5,wv,000,0034,0002746,080,54,097,08000US540979274511188966800,"Census Tract 9668 (part), Buckhannon city (part), Second district, Upshur County, West Virginia",39,28,28,0,0,28,0,11,0,0,0,0,0,0,11,0,0,0,0,11
ACSSF,2010e5,wv,000,0034,0002747,080,54,097,08000US540979274599999966600,"Census Tract 9666 (part), Remainder of Second district, Second district, Upshur County, West Virginia",620,559,278,60,90,128,281,61,0,0,0,0,0,0,61,35,0,0,35,26
ACSSF,2010e5,wv,000,0034,0002748,080,54,097,08000US540979274599999966700,"Census Tract 9667 (part), Remainder of Second district, Second district, Upshur County, West Virginia",0,0,0,0,0,0,0,0,0,0,0,0,0,0,0,0,0,0,0,0
ACSSF,2010e5,wv,000,0034,0002749,080,54,097,08000US540979274599999966800,"Census Tract 9668 (part), Remainder of Second district, Second district, Upshur County, West Virginia",377,305,149,15,57,77,156,72,0,0,0,0,0,0,72,64,0,64,0,8
ACSSF,2010e5,wv,000,0034,0002750,080,54,097,08000US540979274599999967000,"Census Tract 9670 (part), Remainder of Second district, Second district, Upshur County, West Virginia",74,74,16,0,16,0,58,0,0,0,0,0,0,0,0,0,0,0,0,0
ACSSF,2010e5,wv,000,0034,0002751,080,54,097,08000US540979274599999967100,"Census Tract 9671 (part), Remainder of Second district, Second district, Upshur County, West Virginia",1264,1114,320,100,26,194,794,150,111,16,16,0,0,95,39,15,15,0,0,24
ACSSF,2010e5,wv,000,0034,0002752,080,54,097,08000US540979310511188966900,"Census Tract 9669 (part), Buckhannon city (part), Third district, Upshur County, West Virginia",0,0,0,0,0,0,0,0,0,0,0,0,0,0,0,0,0,0,0,0
ACSSF,2010e5,wv,000,0034,0002753,080,54,097,08000US540979310599999966600,"Census Tract 9666 (part), Remainder of Third district, Third district, Upshur County, West Virginia",129,100,37,0,25,12,63,29,15,0,0,0,0,15,14,0,0,0,0,14
ACSSF,2010e5,wv,000,0034,0002754,080,54,097,08000US540979310599999966700,"Census Tract 9667 (part), Remainder of Third district, Third district, Upshur County, West Virginia",0,0,0,0,0,0,0,0,0,0,0,0,0,0,0,0,0,0,0,0
ACSSF,2010e5,wv,000,0034,0002755,080,54,097,08000US540979310599999966800,"Census Tract 9668 (part), Remainder of Third district, Third district, Upshur County, West Virginia",374,363,97,19,14,64,266,11,0,0,0,0,0,0,11,11,0,11,0,0
ACSSF,2010e5,wv,000,0034,0002756,080,54,097,08000US540979310599999966900,"Census Tract 9669 (part), Remainder of Third district, Third district, Upshur County, West Virginia",552,440,177,47,0,130,263,112,22,22,22,0,0,0,90,0,0,0,0,90
ACSSF,2010e5,wv,000,0034,0002757,080,54,097,08000US540979310599999967000,"Census Tract 9670 (part), Remainder of Third district, Third district, Upshur County, West Virginia",1171,973,258,13,64,181,715,198,89,60,0,31,29,29,109,61,0,44,17,48
ACSSF,2010e5,wv,000,0034,0002758,080,54,097,08000US540979310599999967100,"Census Tract 9671 (part), Remainder of Third district, Third district, Upshur County, West Virginia",0,0,0,0,0,0,0,0,0,0,0,0,0,0,0,0,0,0,0,0
ACSSF,2010e5,wv,000,0034,0002759,080,54,099,08000US540999032428516020800,"Census Tract 208 (part), Fort Gay town, Butler district, Wayne County, West Virginia",206,140,47,4,23,20,93,66,23,8,0,0,8,15,43,14,0,0,14,29
ACSSF,2010e5,wv,000,0034,0002760,080,54,099,08000US540999032445580020600,"Census Tract 206 (part), Lavalette CDP (part), Butler district, Wayne County, West Virginia",66,45,24,12,12,0,21,21,0,0,0,0,0,0,21,0,0,0,0,21
ACSSF,2010e5,wv,000,0034,0002761,080,54,099,08000US540999032465596020700,"Census Tract 207 (part), Prichard CDP, Butler district, Wayne County, West Virginia",116,95,63,0,11,52,32,21,8,0,0,0,0,8,13,13,0,0,13,0
ACSSF,2010e5,wv,000,0034,0002762,080,54,099,08000US540999032499999020400,"Census Tract 204 (part), Remainder of Butler district, Butler district, Wayne County, West Virginia",463,352,145,52,0,93,207,111,20,20,0,20,0,0,91,0,0,0,0,91
ACSSF,2010e5,wv,000,0034,0002763,080,54,099,08000US540999032499999020600,"Census Tract 206 (part), Remainder of Butler district, Butler district, Wayne County, West Virginia",302,217,76,11,29,36,141,85,0,0,0,0,0,0,85,12,0,0,12,73
ACSSF,2010e5,wv,000,0034,0002764,080,54,099,08000US540999032499999020700,"Census Tract 207 (part), Remainder of Butler district, Butler district, Wayne County, West Virginia",846,755,314,84,49,181,441,91,33,0,0,0,0,33,58,11,0,0,11,47
ACSSF,2010e5,wv,000,0034,0002765,080,54,099,08000US540999032499999020800,"Census Tract 208 (part), Remainder of Butler district, Butler district, Wayne County, West Virginia",412,298,115,33,16,66,183,114,46,14,0,14,0,32,68,34,0,0,34,34
ACSSF,2010e5,wv,000,0034,0002766,080,54,099,08000US540999032499999020900,"Census Tract 209 (part), Remainder of Butler district, Butler district, Wayne County, West Virginia",79,64,15,15,0,0,49,15,0,0,0,0,0,0,15,15,0,15,0,0
ACSSF,2010e5,wv,000,0034,0002767,080,54,099,08000US540999049214308005200,"Census Tract 52 (part), Ceredo city (part), Ceredo district, Wayne County, West Virginia",14,0,0,0,0,0,0,14,0,0,0,0,0,0,14,0,0,0,0,14
ACSSF,2010e5,wv,000,0034,0002768,080,54,099,08000US540999049214308020100,"Census Tract 201 (part), Ceredo city (part), Ceredo district, Wayne County, West Virginia",7,7,0,0,0,0,7,0,0,0,0,0,0,0,0,0,0,0,0,0
ACSSF,2010e5,wv,000,0034,0002769,080,54,099,08000US540999049214308020300,"Census Tract 203 (part), Ceredo city (part), Ceredo district, Wayne County, West Virginia",322,231,17,0,9,8,214,91,37,14,14,0,0,23,54,31,0,0,31,23
ACSSF,2010e5,wv,000,0034,0002770,080,54,099,08000US540999049214308020400,"Census Tract 204 (part), Ceredo city (part), Ceredo district, Wayne County, West Virginia",98,79,42,34,0,8,37,19,19,14,14,0,0,5,0,0,0,0,0,0
ACSSF,2010e5,wv,000,0034,0002771,080,54,099,08000US540999049243180020300,"Census Tract 203 (part), Kenova city, Ceredo district, Wayne County, West Virginia",781,522,165,44,26,95,357,259,95,85,0,0,85,10,164,103,53,0,50,61
ACSSF,2010e5,wv,000,0034,0002772,080,54,099,08000US540999049243180020400,"Census Tract 204 (part), Kenova city, Ceredo district, Wayne County, West Virginia",0,0,0,0,0,0,0,0,0,0,0,0,0,0,0,0,0,0,0,0
ACSSF,2010e5,wv,000,0034,0002773,080,54,099,08000US540999049299999020300,"Census Tract 203 (part), Remainder of Ceredo district, Ceredo district, Wayne County, West Virginia",116,116,32,0,26,6,84,0,0,0,0,0,0,0,0,0,0,0,0,0
ACSSF,2010e5,wv,000,0034,0002774,080,54,099,08000US540999049299999020400,"Census Tract 204 (part), Remainder of Ceredo district, Ceredo district, Wayne County, West Virginia",712,632,199,75,14,110,433,80,20,20,0,0,20,0,60,34,0,23,11,26
ACSSF,2010e5,wv,000,0034,0002775,080,54,099,08000US540999303619300021000,"Census Tract 210 (part), Crum CDP, Stonewall district, Wayne County, West Virginia",37,24,8,0,0,8,16,13,0,0,0,0,0,0,13,0,0,0,0,13
ACSSF,2010e5,wv,000,0034,0002776,080,54,099,08000US540999303699999020500,"Census Tract 205 (part), Remainder of Stonewall district, Stonewall district, Wayne County, West Virginia",190,143,10,0,0,10,133,47,0,0,0,0,0,0,47,19,0,0,19,28
ACSSF,2010e5,wv,000,0034,0002777,080,54,099,08000US540999303699999020800,"Census Tract 208 (part), Remainder of Stonewall district, Stonewall district, Wayne County, West Virginia",496,382,115,14,49,52,267,114,68,35,0,0,35,33,46,12,12,0,0,34
ACSSF,2010e5,wv,000,0034,0002778,080,54,099,08000US540999303699999020900,"Census Tract 209 (part), Remainder of Stonewall district, Stonewall district, Wayne County, West Virginia",645,514,159,23,0,136,355,131,71,35,25,0,10,36,60,32,0,32,0,28
ACSSF,2010e5,wv,000,0034,0002779,080,54,099,08000US540999303699999021000,"Census Tract 210 (part), Remainder of Stonewall district, Stonewall district, Wayne County, West Virginia",919,746,295,26,81,188,451,173,59,13,0,13,0,46,114,24,0,0,24,90
ACSSF,2010e5,wv,000,0034,0002780,080,54,099,08000US540999337245580020500,"Census Tract 205 (part), Lavalette CDP (part), Union district, Wayne County, West Virginia",73,73,33,0,0,33,40,0,0,0,0,0,0,0,0,0,0,0,0,0
ACSSF,2010e5,wv,000,0034,0002781,080,54,099,08000US540999337245580020600,"Census Tract 206 (part), Lavalette CDP (part), Union district, Wayne County, West Virginia",57,43,18,0,18,0,25,14,0,0,0,0,0,0,14,0,0,0,0,14
ACSSF,2010e5,wv,000,0034,0002782,080,54,099,08000US540999337284940020500,"Census Tract 205 (part), Wayne town, Union district, Wayne County, West Virginia",201,142,79,30,0,49,63,59,18,0,0,0,0,18,41,41,0,0,41,0
ACSSF,2010e5,wv,000,0034,0002783,080,54,099,08000US540999337284940020600,"Census Tract 206 (part), Wayne town, Union district, Wayne County, West Virginia",249,181,77,32,8,37,104,68,7,0,0,0,0,7,61,26,19,0,7,35
ACSSF,2010e5,wv,000,0034,0002784,080,54,099,08000US540999337284940020900,"Census Tract 209 (part), Wayne town, Union district, Wayne County, West Virginia",34,34,6,0,0,6,28,0,0,0,0,0,0,0,0,0,0,0,0,0
ACSSF,2010e5,wv,000,0034,0002785,080,54,099,08000US540999337299999020400,"Census Tract 204 (part), Remainder of Union district, Union district, Wayne County, West Virginia",285,272,102,45,30,27,170,13,0,0,0,0,0,0,13,0,0,0,0,13
ACSSF,2010e5,wv,000,0034,0002786,080,54,099,08000US540999337299999020500,"Census Tract 205 (part), Remainder of Union district, Union district, Wayne County, West Virginia",913,767,296,93,25,178,471,146,21,0,0,0,0,21,125,122,18,0,104,3
ACSSF,2010e5,wv,000,0034,0002787,080,54,099,08000US540999337299999020600,"Census Tract 206 (part), Remainder of Union district, Union district, Wayne County, West Virginia",758,656,352,79,62,211,304,102,17,0,0,0,0,17,85,14,0,0,14,71
ACSSF,2010e5,wv,000,0034,0002788,080,54,099,08000US540999337299999020700,"Census Tract 207 (part), Remainder of Union district, Union district, Wayne County, West Virginia",17,9,0,0,0,0,9,8,0,0,0,0,0,0,8,0,0,0,0,8
ACSSF,2010e5,wv,000,0034,0002789,080,54,099,08000US540999337299999020900,"Census Tract 209 (part), Remainder of Union district, Union district, Wayne County, West Virginia",73,55,0,0,0,0,55,18,0,0,0,0,0,0,18,18,0,0,18,0
ACSSF,2010e5,wv,000,0034,0002790,080,54,099,08000US540999362414308005100,"Census Tract 51 (part), Ceredo city (part), Westmoreland district, Wayne County, West Virginia",0,0,0,0,0,0,0,0,0,0,0,0,0,0,0,0,0,0,0,0
ACSSF,2010e5,wv,000,0034,0002791,080,54,099,08000US540999362414308005200,"Census Tract 52 (part), Ceredo city (part), Westmoreland district, Wayne County, West Virginia",0,0,0,0,0,0,0,0,0,0,0,0,0,0,0,0,0,0,0,0
ACSSF,2010e5,wv,000,0034,0002792,080,54,099,08000US540999362414308020100,"Census Tract 201 (part), Ceredo city (part), Westmoreland district, Wayne County, West Virginia",41,41,10,0,0,10,31,0,0,0,0,0,0,0,0,0,0,0,0,0
ACSSF,2010e5,wv,000,0034,0002793,080,54,099,08000US540999362439460005100,"Census Tract 51 (part), Huntington city (part), Westmoreland district, Wayne County, West Virginia",547,382,94,23,39,32,288,165,60,39,13,0,26,21,105,49,39,7,3,56
ACSSF,2010e5,wv,000,0034,0002794,080,54,099,08000US540999362439460005200,"Census Tract 52 (part), Huntington city (part), Westmoreland district, Wayne County, West Virginia",462,337,140,18,39,83,197,125,5,5,0,0,5,0,120,61,10,0,51,59
ACSSF,2010e5,wv,000,0034,0002795,080,54,099,08000US540999362439460020100,"Census Tract 201 (part), Huntington city (part), Westmoreland district, Wayne County, West Virginia",0,0,0,0,0,0,0,0,0,0,0,0,0,0,0,0,0,0,0,0
ACSSF,2010e5,wv,000,0034,0002796,080,54,099,08000US540999362439460020400,"Census Tract 204 (part), Huntington city (part), Westmoreland district, Wayne County, West Virginia",0,0,0,0,0,0,0,0,0,0,0,0,0,0,0,0,0,0,0,0
ACSSF,2010e5,wv,000,0034,0002797,080,54,099,08000US540999362499999005100,"Census Tract 51 (part), Remainder of Westmoreland district, Westmoreland district, Wayne County, West Virginia",15,15,0,0,0,0,15,0,0,0,0,0,0,0,0,0,0,0,0,0
ACSSF,2010e5,wv,000,0034,0002798,080,54,099,08000US540999362499999005200,"Census Tract 52 (part), Remainder of Westmoreland district, Westmoreland district, Wayne County, West Virginia",20,10,0,0,0,0,10,10,0,0,0,0,0,0,10,0,0,0,0,10
ACSSF,2010e5,wv,000,0034,0002799,080,54,099,08000US540999362499999020100,"Census Tract 201 (part), Remainder of Westmoreland district, Westmoreland district, Wayne County, West Virginia",653,548,197,31,85,81,351,105,10,0,0,0,0,10,95,68,9,14,45,27
ACSSF,2010e5,wv,000,0034,0002800,080,54,099,08000US540999362499999020400,"Census Tract 204 (part), Remainder of Westmoreland district, Westmoreland district, Wayne County, West Virginia",416,293,95,0,10,85,198,123,0,0,0,0,0,0,123,123,0,0,123,0
ACSSF,2010e5,wv,000,0034,0002801,080,54,099,08000US540999362499999020600,"Census Tract 206 (part), Remainder of Westmoreland district, Westmoreland district, Wayne County, West Virginia",115,39,0,0,0,0,39,76,0,0,0,0,0,0,76,45,39,0,6,31
ACSSF,2010e5,wv,000,0034,0002802,080,54,101,08000US541019047100364970100,"Census Tract 9701 (part), Addison (Webster Springs) town, Central district, Webster County, West Virginia",3,1,0,0,0,0,1,2,0,0,0,0,0,0,2,0,0,0,0,2
ACSSF,2010e5,wv,000,0034,0002803,080,54,101,08000US541019047100364970200,"Census Tract 9702 (part), Addison (Webster Springs) town, Central district, Webster County, West Virginia",316,183,62,7,13,42,121,133,0,0,0,0,0,0,133,62,46,3,13,71
ACSSF,2010e5,wv,000,0034,0002804,080,54,101,08000US541019047199999970100,"Census Tract 9701 (part), Remainder of Central district, Central district, Webster County, West Virginia",346,310,151,0,0,151,159,36,26,4,4,0,0,22,10,0,0,0,0,10
ACSSF,2010e5,wv,000,0034,0002805,080,54,101,08000US541019047199999970200,"Census Tract 9702 (part), Remainder of Central district, Central district, Webster County, West Virginia",207,165,112,10,41,61,53,42,0,0,0,0,0,0,42,19,19,0,0,23
ACSSF,2010e5,wv,000,0034,0002806,080,54,101,08000US541019047199999970300,"Census Tract 9703 (part), Remainder of Central district, Central district, Webster County, West Virginia",40,40,0,0,0,0,40,0,0,0,0,0,0,0,0,0,0,0,0,0
ACSSF,2010e5,wv,000,0034,0002807,080,54,101,08000US541019236006436970200,"Census Tract 9702 (part), Bergoo CDP, Northern district, Webster County, West Virginia",15,0,0,0,0,0,0,15,0,0,0,0,0,0,15,15,0,0,15,0
ACSSF,2010e5,wv,000,0034,0002808,080,54,101,08000US541019236099999970100,"Census Tract 9701 (part), Remainder of Northern district, Northern district, Webster County, West Virginia",628,582,159,37,44,78,423,46,46,13,0,0,13,33,0,0,0,0,0,0
ACSSF,2010e5,wv,000,0034,0002809,080,54,101,08000US541019236099999970200,"Census Tract 9702 (part), Remainder of Northern district, Northern district, Webster County, West Virginia",173,122,39,0,9,30,83,51,27,17,17,0,0,10,24,0,0,0,0,24
ACSSF,2010e5,wv,000,0034,0002810,080,54,101,08000US541019292512436970300,"Census Tract 9703 (part), Camden-on-Gauley town, Southern district, Webster County, West Virginia",30,16,0,0,0,0,16,14,0,0,0,0,0,0,14,5,1,0,4,9
ACSSF,2010e5,wv,000,0034,0002811,080,54,101,08000US541019292518412970100,"Census Tract 9701 (part), Cowen town, Southern district, Webster County, West Virginia",3,3,0,0,0,0,3,0,0,0,0,0,0,0,0,0,0,0,0,0
ACSSF,2010e5,wv,000,0034,0002812,080,54,101,08000US541019292518412970300,"Census Tract 9703 (part), Cowen town, Southern district, Webster County, West Virginia",188,126,64,53,7,4,62,62,28,10,0,0,10,18,34,9,0,7,2,25
ACSSF,2010e5,wv,000,0034,0002813,080,54,101,08000US541019292599999970100,"Census Tract 9701 (part), Remainder of Southern district, Southern district, Webster County, West Virginia",532,459,145,22,39,84,314,73,20,20,0,0,20,0,53,53,53,0,0,0
ACSSF,2010e5,wv,000,0034,0002814,080,54,101,08000US541019292599999970300,"Census Tract 9703 (part), Remainder of Southern district, Southern district, Webster County, West Virginia",446,358,152,20,25,107,206,88,69,59,36,0,23,10,19,19,0,0,19,0
ACSSF,2010e5,wv,000,0034,0002815,080,54,103,08000US541039079439340030400,"Census Tract 304 (part), Hundred town, District 1, Wetzel County, West Virginia",78,73,27,5,3,19,46,5,2,0,0,0,0,2,3,3,0,0,3,0
ACSSF,2010e5,wv,000,0034,0002816,080,54,103,08000US541039079440636030500,"Census Tract 305 (part), Jacksonburg CDP, District 1, Wetzel County, West Virginia",15,15,0,0,0,0,15,0,0,0,0,0,0,0,0,0,0,0,0,0
ACSSF,2010e5,wv,000,0034,0002817,080,54,103,08000US541039079447788030400,"Census Tract 304 (part), Littleton CDP, District 1, Wetzel County, West Virginia",69,7,3,0,0,3,4,62,21,21,8,13,0,0,41,41,0,0,41,0
ACSSF,2010e5,wv,000,0034,0002818,080,54,103,08000US541039079463892030500,"Census Tract 305 (part), Pine Grove town, District 1, Wetzel County, West Virginia",136,102,41,6,4,31,61,34,10,7,7,0,0,3,24,13,3,0,10,11
ACSSF,2010e5,wv,000,0034,0002819,080,54,103,08000US541039079467252030500,"Census Tract 305 (part), Reader CDP, District 1, Wetzel County, West Virginia",202,152,86,36,0,50,66,50,22,22,0,0,22,0,28,28,11,0,17,0
ACSSF,2010e5,wv,000,0034,0002820,080,54,103,08000US541039079474788030500,"Census Tract 305 (part), Smithfield town, District 1, Wetzel County, West Virginia",16,10,4,0,0,4,6,6,0,0,0,0,0,0,6,6,4,2,0,0
ACSSF,2010e5,wv,000,0034,0002821,080,54,103,08000US541039079499999030400,"Census Tract 304 (part), District Remainder of 1, District 1, Wetzel County, West Virginia",288,253,43,19,12,12,210,35,35,20,0,0,20,15,0,0,0,0,0,0
ACSSF,2010e5,wv,000,0034,0002822,080,54,103,08000US541039079499999030500,"Census Tract 305 (part), District Remainder of 1, District 1, Wetzel County, West Virginia",825,758,328,45,49,234,430,67,30,0,0,0,0,30,37,11,11,0,0,26
ACSSF,2010e5,wv,000,0034,0002823,080,54,103,08000US541039079499999030700,"Census Tract 307 (part), District Remainder of 1, District 1, Wetzel County, West Virginia",89,78,12,0,0,12,66,11,11,11,0,0,11,0,0,0,0,0,0,0
ACSSF,2010e5,wv,000,0034,0002824,080,54,103,08000US541039079499999030800,"Census Tract 308 (part), District Remainder of 1, District 1, Wetzel County, West Virginia",45,45,0,0,0,0,45,0,0,0,0,0,0,0,0,0,0,0,0,0
ACSSF,2010e5,wv,000,0034,0002825,080,54,103,08000US541039083061636030700,"Census Tract 307 (part), Paden City city (part), District 2, Wetzel County, West Virginia",466,345,105,20,32,53,240,121,16,7,0,0,7,9,105,69,34,0,35,36
ACSSF,2010e5,wv,000,0034,0002826,080,54,103,08000US541039083099999004900,"Census Tract 49 (part), District Remainder of 2, District 2, Wetzel County, West Virginia",35,0,0,0,0,0,0,35,0,0,0,0,0,0,35,35,0,35,0,0
ACSSF,2010e5,wv,000,0034,0002827,080,54,103,08000US541039083099999030400,"Census Tract 304 (part), District Remainder of 2, District 2, Wetzel County, West Virginia",462,378,132,21,36,75,246,84,22,16,16,0,0,6,62,0,0,0,0,62
ACSSF,2010e5,wv,000,0034,0002828,080,54,103,08000US541039083099999030500,"Census Tract 305 (part), District Remainder of 2, District 2, Wetzel County, West Virginia",114,114,13,0,0,13,101,0,0,0,0,0,0,0,0,0,0,0,0,0
ACSSF,2010e5,wv,000,0034,0002829,080,54,103,08000US541039083099999030700,"Census Tract 307 (part), District Remainder of 2, District 2, Wetzel County, West Virginia",308,231,90,18,27,45,141,77,0,0,0,0,0,0,77,69,0,37,32,8
ACSSF,2010e5,wv,000,0034,0002830,080,54,103,08000US541039083099999030800,"Census Tract 308 (part), District Remainder of 2, District 2, Wetzel County, West Virginia",210,162,72,20,0,52,90,48,13,0,0,0,0,13,35,0,0,0,0,35
ACSSF,2010e5,wv,000,0034,0002831,080,54,103,08000US541039086758684004900,"Census Tract 49 (part), New Martinsville city, District 3, Wetzel County, West Virginia",904,708,183,57,60,66,525,196,16,0,0,0,0,16,180,62,17,0,45,118
ACSSF,2010e5,wv,000,0034,0002832,080,54,103,08000US541039086758684030700,"Census Tract 307 (part), New Martinsville city, District 3, Wetzel County, West Virginia",308,285,71,0,0,71,214,23,0,0,0,0,0,0,23,12,0,0,12,11
ACSSF,2010e5,wv,000,0034,0002833,080,54,103,08000US541039086758684030800,"Census Tract 308 (part), New Martinsville city, District 3, Wetzel County, West Virginia",155,129,65,0,2,63,64,26,0,0,0,0,0,0,26,0,0,0,0,26
ACSSF,2010e5,wv,000,0034,0002834,080,54,103,08000US541039086799999004900,"Census Tract 49 (part), District Remainder of 3, District 3, Wetzel County, West Virginia",0,0,0,0,0,0,0,0,0,0,0,0,0,0,0,0,0,0,0,0
ACSSF,2010e5,wv,000,0034,0002835,080,54,103,08000US541039086799999030700,"Census Tract 307 (part), District Remainder of 3, District 3, Wetzel County, West Virginia",0,0,0,0,0,0,0,0,0,0,0,0,0,0,0,0,0,0,0,0
ACSSF,2010e5,wv,000,0034,0002836,080,54,105,08000US541059047324364030101,"Census Tract 301.01 (part), Elizabeth town, Central district, Wirt County, West Virginia",341,215,79,0,30,49,136,126,39,31,14,0,17,8,87,79,17,12,50,8
ACSSF,2010e5,wv,000,0034,0002837,080,54,105,08000US541059047324364030102,"Census Tract 301.02 (part), Elizabeth town, Central district, Wirt County, West Virginia",0,0,0,0,0,0,0,0,0,0,0,0,0,0,0,0,0,0,0,0
ACSSF,2010e5,wv,000,0034,0002838,080,54,105,08000US541059047399999030101,"Census Tract 301.01 (part), Remainder of Central district, Central district, Wirt County, West Virginia",194,148,0,0,0,0,148,46,25,0,0,0,0,25,21,0,0,0,0,21
ACSSF,2010e5,wv,000,0034,0002839,080,54,105,08000US541059047399999030102,"Census Tract 301.02 (part), Remainder of Central district, Central district, Wirt County, West Virginia",113,113,27,0,27,0,86,0,0,0,0,0,0,0,0,0,0,0,0,0
ACSSF,2010e5,wv,000,0034,0002840,080,54,105,08000US541059234499999030101,"Census Tract 301.01 (part), Northeast district, Northeast district, Wirt County, West Virginia",94,94,55,0,0,55,39,0,0,0,0,0,0,0,0,0,0,0,0,0
ACSSF,2010e5,wv,000,0034,0002841,080,54,105,08000US541059234499999030102,"Census Tract 301.02 (part), Northeast district, Northeast district, Wirt County, West Virginia",451,373,100,0,24,76,273,78,0,0,0,0,0,0,78,50,0,0,50,28
ACSSF,2010e5,wv,000,0034,0002842,080,54,105,08000US541059295899999030101,"Census Tract 301.01 (part), Southwest district, Southwest district, Wirt County, West Virginia",469,469,153,112,21,20,316,0,0,0,0,0,0,0,0,0,0,0,0,0
ACSSF,2010e5,wv,000,0034,0002843,080,54,105,08000US541059295899999030102,"Census Tract 301.02 (part), Southwest district, Southwest district, Wirt County, West Virginia",35,35,27,0,0,27,8,0,0,0,0,0,0,0,0,0,0,0,0,0
ACSSF,2010e5,wv,000,0034,0002844,080,54,107,08000US541079058899999010601,"Census Tract 106.01 (part), Clay district, Clay district, Wood County, West Virginia",28,28,0,0,0,0,28,0,0,0,0,0,0,0,0,0,0,0,0,0
ACSSF,2010e5,wv,000,0034,0002845,080,54,107,08000US541079058899999010602,"Census Tract 106.02 (part), Clay district, Clay district, Wood County, West Virginia",384,324,97,13,26,58,227,60,0,0,0,0,0,0,60,26,15,0,11,34
ACSSF,2010e5,wv,000,0034,0002846,080,54,107,08000US541079058899999010701,"Census Tract 107.01 (part), Clay district, Clay district, Wood County, West Virginia",1320,1105,438,102,139,197,667,215,36,5,5,0,0,31,179,140,31,25,84,39
ACSSF,2010e5,wv,000,0034,0002847,080,54,107,08000US541079156099999010800,"Census Tract 108 (part), Harris district, Harris district, Wood County, West Virginia",540,501,173,28,12,133,328,39,15,15,0,0,15,0,24,24,0,0,24,0
ACSSF,2010e5,wv,000,0034,0002848,080,54,107,08000US541079156099999010901,"Census Tract 109.01 (part), Harris district, Harris district, Wood County, West Virginia",0,0,0,0,0,0,0,0,0,0,0,0,0,0,0,0,0,0,0,0
ACSSF,2010e5,wv,000,0034,0002849,080,54,107,08000US541079198008308010901,"Census Tract 109.01 (part), Blennerhassett CDP, Lubeck district, Wood County, West Virginia",180,150,20,9,0,11,130,30,3,3,0,0,3,0,27,12,0,0,12,15
ACSSF,2010e5,wv,000,0034,0002850,080,54,107,08000US541079198008308010902,"Census Tract 109.02 (part), Blennerhassett CDP, Lubeck district, Wood County, West Virginia",761,535,115,10,8,97,420,226,94,16,4,0,12,78,132,45,0,19,26,87
ACSSF,2010e5,wv,000,0034,0002851,080,54,107,08000US541079198049156010901,"Census Tract 109.01 (part), Lubeck CDP, Lubeck district, Wood County, West Virginia",375,274,130,20,11,99,144,101,83,83,31,0,52,0,18,18,0,0,18,0
ACSSF,2010e5,wv,000,0034,0002852,080,54,107,08000US541079198062140000902,"Census Tract 9.02 (part), Parkersburg city (part), Lubeck district, Wood County, West Virginia",285,266,59,0,21,38,207,19,19,19,19,0,0,0,0,0,0,0,0,0
ACSSF,2010e5,wv,000,0034,0002853,080,54,107,08000US541079198062140010902,"Census Tract 109.02 (part), Parkersburg city (part), Lubeck district, Wood County, West Virginia",0,0,0,0,0,0,0,0,0,0,0,0,0,0,0,0,0,0,0,0
ACSSF,2010e5,wv,000,0034,0002854,080,54,107,08000US541079198084724010901,"Census Tract 109.01 (part), Washington CDP, Lubeck district, Wood County, West Virginia",475,440,214,69,38,107,226,35,0,0,0,0,0,0,35,9,0,0,9,26
ACSSF,2010e5,wv,000,0034,0002855,080,54,107,08000US541079198099999000902,"Census Tract 9.02 (part), Remainder of Lubeck district, Lubeck district, Wood County, West Virginia",73,71,48,0,27,21,23,2,0,0,0,0,0,0,2,0,0,0,0,2
ACSSF,2010e5,wv,000,0034,0002856,080,54,107,08000US541079198099999010702,"Census Tract 107.02 (part), Remainder of Lubeck district, Lubeck district, Wood County, West Virginia",215,205,79,39,0,40,126,10,10,0,0,0,0,10,0,0,0,0,0,0
ACSSF,2010e5,wv,000,0034,0002857,080,54,107,08000US541079198099999010800,"Census Tract 108 (part), Remainder of Lubeck district, Lubeck district, Wood County, West Virginia",0,0,0,0,0,0,0,0,0,0,0,0,0,0,0,0,0,0,0,0
ACSSF,2010e5,wv,000,0034,0002858,080,54,107,08000US541079198099999010901,"Census Tract 109.01 (part), Remainder of Lubeck district, Lubeck district, Wood County, West Virginia",444,444,152,18,31,103,292,0,0,0,0,0,0,0,0,0,0,0,0,0
ACSSF,2010e5,wv,000,0034,0002859,080,54,107,08000US541079198099999010902,"Census Tract 109.02 (part), Remainder of Lubeck district, Lubeck district, Wood County, West Virginia",309,185,107,27,19,61,78,124,0,0,0,0,0,0,124,115,76,7,32,9
ACSSF,2010e5,wv,000,0034,0002860,080,54,107,08000US541079242459458010102,"Census Tract 101.02 (part), North Hills town (part), Parkersburg district, Wood County, West Virginia",70,53,15,0,5,10,38,17,17,17,0,0,17,0,0,0,0,0,0,0
ACSSF,2010e5,wv,000,0034,0002861,080,54,107,08000US541079242462140000100,"Census Tract 1 (part), Parkersburg city (part), Parkersburg district, Wood County, West Virginia",868,634,192,47,26,119,442,234,53,44,0,11,33,9,181,93,33,0,60,88
ACSSF,2010e5,wv,000,0034,0002862,080,54,107,08000US541079242462140000300,"Census Tract 3, Parkersburg city (part), Parkersburg district, Wood County, West Virginia",791,412,150,35,0,115,262,379,109,100,7,37,56,9,270,113,84,0,29,157
ACSSF,2010e5,wv,000,0034,0002863,080,54,107,08000US541079242462140000400,"Census Tract 4, Parkersburg city (part), Parkersburg district, Wood County, West Virginia",669,521,141,8,32,101,380,148,14,0,0,0,0,14,134,70,7,15,48,64
ACSSF,2010e5,wv,000,0034,0002864,080,54,107,08000US541079242462140000500,"Census Tract 5, Parkersburg city (part), Parkersburg district, Wood County, West Virginia",1155,638,256,57,44,155,382,517,95,50,0,16,34,45,422,231,78,8,145,191
ACSSF,2010e5,wv,000,0034,0002865,080,54,107,08000US541079242462140000701,"Census Tract 7.01, Parkersburg city (part), Parkersburg district, Wood County, West Virginia",590,320,184,27,44,113,136,270,64,43,0,43,0,21,206,121,8,46,67,85
ACSSF,2010e5,wv,000,0034,0002866,080,54,107,08000US541079242462140000702,"Census Tract 7.02, Parkersburg city (part), Parkersburg district, Wood County, West Virginia",396,355,107,21,0,86,248,41,0,0,0,0,0,0,41,13,0,5,8,28
ACSSF,2010e5,wv,000,0034,0002867,080,54,107,08000US541079242462140010102,"Census Tract 101.02 (part), Parkersburg city (part), Parkersburg district, Wood County, West Virginia",0,0,0,0,0,0,0,0,0,0,0,0,0,0,0,0,0,0,0,0
ACSSF,2010e5,wv,000,0034,0002868,080,54,107,08000US541079242462140010502,"Census Tract 105.02 (part), Parkersburg city (part), Parkersburg district, Wood County, West Virginia",73,55,18,0,0,18,37,18,0,0,0,0,0,0,18,0,0,0,0,18
ACSSF,2010e5,wv,000,0034,0002869,080,54,107,08000US541079242462140010602,"Census Tract 106.02 (part), Parkersburg city (part), Parkersburg district, Wood County, West Virginia",129,111,74,15,0,59,37,18,0,0,0,0,0,0,18,6,0,0,6,12
ACSSF,2010e5,wv,000,0034,0002870,080,54,107,08000US541079242462140011000,"Census Tract 110 (part), Parkersburg city (part), Parkersburg district, Wood County, West Virginia",569,338,122,49,41,32,216,231,54,7,0,0,7,47,177,80,22,0,58,97
ACSSF,2010e5,wv,000,0034,0002871,080,54,107,08000US541079242483500010300,"Census Tract 103 (part), Vienna city (part), Parkersburg district, Wood County, West Virginia",27,27,14,14,0,0,13,0,0,0,0,0,0,0,0,0,0,0,0,0
ACSSF,2010e5,wv,000,0034,0002872,080,54,107,08000US541079242483500010400,"Census Tract 104 (part), Vienna city (part), Parkersburg district, Wood County, West Virginia",34,34,0,0,0,0,34,0,0,0,0,0,0,0,0,0,0,0,0,0
ACSSF,2010e5,wv,000,0034,0002873,080,54,107,08000US541079242483500010501,"Census Tract 105.01 (part), Vienna city (part), Parkersburg district, Wood County, West Virginia",425,362,114,29,37,48,248,63,25,13,0,0,13,12,38,11,0,0,11,27
ACSSF,2010e5,wv,000,0034,0002874,080,54,107,08000US541079242483500010502,"Census Tract 105.02 (part), Vienna city (part), Parkersburg district, Wood County, West Virginia",783,625,130,0,47,83,495,158,42,0,0,0,0,42,116,44,0,0,44,72
ACSSF,2010e5,wv,000,0034,0002875,080,54,107,08000US541079242499999000100,"Census Tract 1 (part), Remainder of Parkersburg district, Parkersburg district, Wood County, West Virginia",129,68,25,0,0,25,43,61,31,31,7,0,24,0,30,0,0,0,0,30
ACSSF,2010e5,wv,000,0034,0002876,080,54,107,08000US541079242499999000801,"Census Tract 8.01 (part), Remainder of Parkersburg district, Parkersburg district, Wood County, West Virginia",0,0,0,0,0,0,0,0,0,0,0,0,0,0,0,0,0,0,0,0
ACSSF,2010e5,wv,000,0034,0002877,080,54,107,08000US541079242499999000802,"Census Tract 8.02 (part), Remainder of Parkersburg district, Parkersburg district, Wood County, West Virginia",0,0,0,0,0,0,0,0,0,0,0,0,0,0,0,0,0,0,0,0
ACSSF,2010e5,wv,000,0034,0002878,080,54,107,08000US541079242499999010102,"Census Tract 101.02 (part), Remainder of Parkersburg district, Parkersburg district, Wood County, West Virginia",150,114,19,0,11,8,95,36,0,0,0,0,0,0,36,23,12,0,11,13
ACSSF,2010e5,wv,000,0034,0002879,080,54,107,08000US541079242499999010400,"Census Tract 104 (part), Remainder of Parkersburg district, Parkersburg district, Wood County, West Virginia",0,0,0,0,0,0,0,0,0,0,0,0,0,0,0,0,0,0,0,0
ACSSF,2010e5,wv,000,0034,0002880,080,54,107,08000US541079242499999010501,"Census Tract 105.01 (part), Remainder of Parkersburg district, Parkersburg district, Wood County, West Virginia",0,0,0,0,0,0,0,0,0,0,0,0,0,0,0,0,0,0,0,0
ACSSF,2010e5,wv,000,0034,0002881,080,54,107,08000US541079242499999010502,"Census Tract 105.02 (part), Remainder of Parkersburg district, Parkersburg district, Wood County, West Virginia",71,42,0,0,0,0,42,29,29,29,29,0,0,0,0,0,0,0,0,0
ACSSF,2010e5,wv,000,0034,0002882,080,54,107,08000US541079242499999010601,"Census Tract 106.01 (part), Remainder of Parkersburg district, Parkersburg district, Wood County, West Virginia",0,0,0,0,0,0,0,0,0,0,0,0,0,0,0,0,0,0,0,0
ACSSF,2010e5,wv,000,0034,0002883,080,54,107,08000US541079242499999010602,"Census Tract 106.02 (part), Remainder of Parkersburg district, Parkersburg district, Wood County, West Virginia",226,172,38,0,0,38,134,54,32,32,23,0,9,0,22,14,6,0,8,8
ACSSF,2010e5,wv,000,0034,0002884,080,54,107,08000US541079242499999010701,"Census Tract 107.01 (part), Remainder of Parkersburg district, Parkersburg district, Wood County, West Virginia",64,64,35,6,0,29,29,0,0,0,0,0,0,0,0,0,0,0,0,0
ACSSF,2010e5,wv,000,0034,0002885,080,54,107,08000US541079242499999011000,"Census Tract 110 (part), Remainder of Parkersburg district, Parkersburg district, Wood County, West Virginia",0,0,0,0,0,0,0,0,0,0,0,0,0,0,0,0,0,0,0,0
ACSSF,2010e5,wv,000,0034,0002886,080,54,107,08000US541079285654580010702,"Census Tract 107.02 (part), Mineralwells CDP, Slate district, Wood County, West Virginia",495,415,179,0,33,146,236,80,26,0,0,0,0,26,54,41,0,19,22,13
ACSSF,2010e5,wv,000,0034,0002887,080,54,107,08000US541079285699999010702,"Census Tract 107.02 (part), Remainder of Slate district, Slate district, Wood County, West Virginia",813,698,364,83,83,198,334,115,42,14,0,0,14,28,73,59,28,15,16,14
ACSSF,2010e5,wv,000,0034,0002888,080,54,107,08000US541079285699999010800,"Census Tract 108 (part), Remainder of Slate district, Slate district, Wood County, West Virginia",0,0,0,0,0,0,0,0,0,0,0,0,0,0,0,0,0,0,0,0
ACSSF,2010e5,wv,000,0034,0002889,080,54,107,08000US541079302499999010702,"Census Tract 107.02 (part), Steele district, Steele district, Wood County, West Virginia",22,22,0,0,0,0,22,0,0,0,0,0,0,0,0,0,0,0,0,0
ACSSF,2010e5,wv,000,0034,0002890,080,54,107,08000US541079302499999010800,"Census Tract 108 (part), Steele district, Steele district, Wood County, West Virginia",317,266,130,0,9,121,136,51,10,10,0,0,10,0,41,19,19,0,0,22
ACSSF,2010e5,wv,000,0034,0002891,080,54,107,08000US541079318062140000801,"Census Tract 8.01 (part), Parkersburg city (part), Tygart district, Wood County, West Virginia",367,250,113,19,19,75,137,117,31,31,31,0,0,0,86,19,0,9,10,67
ACSSF,2010e5,wv,000,0034,0002892,080,54,107,08000US541079318062140000802,"Census Tract 8.02 (part), Parkersburg city (part), Tygart district, Wood County, West Virginia",830,548,142,37,0,105,406,282,20,20,0,0,20,0,262,117,49,11,57,145
ACSSF,2010e5,wv,000,0034,0002893,080,54,107,08000US541079318062140000901,"Census Tract 9.01, Parkersburg city (part), Tygart district, Wood County, West Virginia",334,265,99,0,35,64,166,69,25,0,0,0,0,25,44,8,0,0,8,36
ACSSF,2010e5,wv,000,0034,0002894,080,54,107,08000US541079318062140000903,"Census Tract 9.03 (part), Parkersburg city (part), Tygart district, Wood County, West Virginia",1125,821,219,53,71,95,602,304,11,0,0,0,0,11,293,218,77,29,112,75
ACSSF,2010e5,wv,000,0034,0002895,080,54,107,08000US541079318062140010702,"Census Tract 107.02 (part), Parkersburg city (part), Tygart district, Wood County, West Virginia",30,11,0,0,0,0,11,19,19,19,19,0,0,0,0,0,0,0,0,0
ACSSF,2010e5,wv,000,0034,0002896,080,54,107,08000US541079318099999000801,"Census Tract 8.01 (part), Remainder of Tygart district, Tygart district, Wood County, West Virginia",26,26,0,0,0,0,26,0,0,0,0,0,0,0,0,0,0,0,0,0
ACSSF,2010e5,wv,000,0034,0002897,080,54,107,08000US541079318099999000802,"Census Tract 8.02 (part), Remainder of Tygart district, Tygart district, Wood County, West Virginia",208,155,48,11,0,37,107,53,0,0,0,0,0,0,53,28,0,0,28,25
ACSSF,2010e5,wv,000,0034,0002898,080,54,107,08000US541079318099999000903,"Census Tract 9.03 (part), Remainder of Tygart district, Tygart district, Wood County, West Virginia",49,39,16,8,0,8,23,10,0,0,0,0,0,0,10,10,0,0,10,0
ACSSF,2010e5,wv,000,0034,0002899,080,54,107,08000US541079318099999010701,"Census Tract 107.01 (part), Remainder of Tygart district, Tygart district, Wood County, West Virginia",0,0,0,0,0,0,0,0,0,0,0,0,0,0,0,0,0,0,0,0
ACSSF,2010e5,wv,000,0034,0002900,080,54,107,08000US541079318099999010702,"Census Tract 107.02 (part), Remainder of Tygart district, Tygart district, Wood County, West Virginia",693,583,131,38,27,66,452,110,37,0,0,0,0,37,73,57,12,0,45,16
ACSSF,2010e5,wv,000,0034,0002901,080,54,107,08000US541079318099999010800,"Census Tract 108 (part), Remainder of Tygart district, Tygart district, Wood County, West Virginia",10,10,0,0,0,0,10,0,0,0,0,0,0,0,0,0,0,0,0,0
ACSSF,2010e5,wv,000,0034,0002902,080,54,107,08000US541079338484916010601,"Census Tract 106.01 (part), Waverly CDP, Union district, Wood County, West Virginia",156,141,38,0,0,38,103,15,0,0,0,0,0,0,15,15,0,0,15,0
ACSSF,2010e5,wv,000,0034,0002903,080,54,107,08000US541079338499999010102,"Census Tract 101.02 (part), Remainder of Union district, Union district, Wood County, West Virginia",10,10,10,0,0,10,0,0,0,0,0,0,0,0,0,0,0,0,0,0
ACSSF,2010e5,wv,000,0034,0002904,080,54,107,08000US541079338499999010601,"Census Tract 106.01 (part), Remainder of Union district, Union district, Wood County, West Virginia",875,794,195,22,0,173,599,81,45,10,10,0,0,35,36,26,0,26,0,10
ACSSF,2010e5,wv,000,0034,0002905,080,54,107,08000US541079338499999010602,"Census Tract 106.02 (part), Remainder of Union district, Union district, Wood County, West Virginia",432,353,169,37,41,91,184,79,60,20,12,0,8,40,19,19,0,0,19,0
ACSSF,2010e5,wv,000,0034,0002906,080,54,107,08000US541079344499999010602,"Census Tract 106.02 (part), Walker district, Walker district, Wood County, West Virginia",59,59,22,0,6,16,37,0,0,0,0,0,0,0,0,0,0,0,0,0
ACSSF,2010e5,wv,000,0034,0002907,080,54,107,08000US541079344499999010701,"Census Tract 107.01 (part), Walker district, Walker district, Wood County, West Virginia",249,178,59,29,8,22,119,71,46,0,0,0,0,46,25,18,18,0,0,7
ACSSF,2010e5,wv,000,0034,0002908,080,54,107,08000US541079367208836010101,"Census Tract 101.01 (part), Boaz CDP, Williams district, Wood County, West Virginia",504,426,188,44,53,91,238,78,24,24,0,0,24,0,54,54,18,8,28,0
ACSSF,2010e5,wv,000,0034,0002909,080,54,107,08000US541079367259458010102,"Census Tract 101.02 (part), North Hills town (part), Williams district, Wood County, West Virginia",177,156,76,1,24,51,80,21,13,10,10,0,0,3,8,8,0,0,8,0
ACSSF,2010e5,wv,000,0034,0002910,080,54,107,08000US541079367283500010101,"Census Tract 101.01 (part), Vienna city (part), Williams district, Wood County, West Virginia",0,0,0,0,0,0,0,0,0,0,0,0,0,0,0,0,0,0,0,0
ACSSF,2010e5,wv,000,0034,0002911,080,54,107,08000US541079367283500010102,"Census Tract 101.02 (part), Vienna city (part), Williams district, Wood County, West Virginia",0,0,0,0,0,0,0,0,0,0,0,0,0,0,0,0,0,0,0,0
ACSSF,2010e5,wv,000,0034,0002912,080,54,107,08000US541079367283500010300,"Census Tract 103 (part), Vienna city (part), Williams district, Wood County, West Virginia",1199,1004,411,118,72,221,593,195,38,15,0,0,15,23,157,90,23,10,57,67
ACSSF,2010e5,wv,000,0034,0002913,080,54,107,08000US541079367283500010400,"Census Tract 104 (part), Vienna city (part), Williams district, Wood County, West Virginia",548,496,223,57,22,144,273,52,45,35,35,0,0,10,7,0,0,0,0,7
ACSSF,2010e5,wv,000,0034,0002914,080,54,107,08000US541079367283500010502,"Census Tract 105.02 (part), Vienna city (part), Williams district, Wood County, West Virginia",0,0,0,0,0,0,0,0,0,0,0,0,0,0,0,0,0,0,0,0
ACSSF,2010e5,wv,000,0034,0002915,080,54,107,08000US541079367287556010200,"Census Tract 102 (part), Williamstown city, Williams district, Wood County, West Virginia",815,649,257,27,24,206,392,166,61,51,0,0,51,10,105,79,0,26,53,26
ACSSF,2010e5,wv,000,0034,0002916,080,54,107,08000US541079367299999010101,"Census Tract 101.01 (part), Remainder of Williams district, Williams district, Wood County, West Virginia",214,170,82,0,0,82,88,44,0,0,0,0,0,0,44,21,21,0,0,23
ACSSF,2010e5,wv,000,0034,0002917,080,54,107,08000US541079367299999010102,"Census Tract 101.02 (part), Remainder of Williams district, Williams district, Wood County, West Virginia",82,0,0,0,0,0,0,82,22,22,11,0,11,0,60,0,0,0,0,60
ACSSF,2010e5,wv,000,0034,0002918,080,54,107,08000US541079367299999010200,"Census Tract 102 (part), Remainder of Williams district, Williams district, Wood County, West Virginia",0,0,0,0,0,0,0,0,0,0,0,0,0,0,0,0,0,0,0,0
ACSSF,2010e5,wv,000,0034,0002919,080,54,107,08000US541079367299999010300,"Census Tract 103 (part), Remainder of Williams district, Williams district, Wood County, West Virginia",81,81,32,0,0,32,49,0,0,0,0,0,0,0,0,0,0,0,0,0
ACSSF,2010e5,wv,000,0034,0002920,080,54,107,08000US541079367299999010400,"Census Tract 104 (part), Remainder of Williams district, Williams district, Wood County, West Virginia",18,18,0,0,0,0,18,0,0,0,0,0,0,0,0,0,0,0,0,0
ACSSF,2010e5,wv,000,0034,0002921,080,54,107,08000US541079367299999010502,"Census Tract 105.02 (part), Remainder of Williams district, Williams district, Wood County, West Virginia",7,7,0,0,0,0,7,0,0,0,0,0,0,0,0,0,0,0,0,0
ACSSF,2010e5,wv,000,0034,0002922,080,54,107,08000US541079367299999010601,"Census Tract 106.01 (part), Remainder of Williams district, Williams district, Wood County, West Virginia",581,517,197,11,71,115,320,64,0,0,0,0,0,0,64,54,13,0,41,10
ACSSF,2010e5,wv,000,0034,0002923,080,54,109,08000US541099079511212003200,"Census Tract 32 (part), Bud CDP, District 1, Wyoming County, West Virginia",64,43,0,0,0,0,43,21,0,0,0,0,0,0,21,21,21,0,0,0
ACSSF,2010e5,wv,000,0034,0002924,080,54,109,08000US541099079517836003200,"Census Tract 32 (part), Corinne CDP, District 1, Wyoming County, West Virginia",98,63,21,0,0,21,42,35,17,17,0,0,17,0,18,18,0,0,18,0
ACSSF,2010e5,wv,000,0034,0002925,080,54,109,08000US541099079518388003200,"Census Tract 32 (part), Covel CDP, District 1, Wyoming County, West Virginia",19,19,0,0,0,0,19,0,0,0,0,0,0,0,0,0,0,0,0,0
ACSSF,2010e5,wv,000,0034,0002926,080,54,109,08000US541099079531756002800,"Census Tract 28 (part), Glen Fork CDP, District 1, Wyoming County, West Virginia",11,11,0,0,0,0,11,0,0,0,0,0,0,0,0,0,0,0,0,0
ACSSF,2010e5,wv,000,0034,0002927,080,54,109,08000US541099079531756003100,"Census Tract 31 (part), Glen Fork CDP, District 1, Wyoming County, West Virginia",28,28,0,0,0,0,28,0,0,0,0,0,0,0,0,0,0,0,0,0
ACSSF,2010e5,wv,000,0034,0002928,080,54,109,08000US541099079540444003200,"Census Tract 32 (part), Itmann CDP, District 1, Wyoming County, West Virginia",107,107,0,0,0,0,107,0,0,0,0,0,0,0,0,0,0,0,0,0
ACSSF,2010e5,wv,000,0034,0002929,080,54,109,08000US541099079557148003200,"Census Tract 32 (part), Mullens city, District 1, Wyoming County, West Virginia",436,321,134,56,24,54,187,115,20,3,0,0,3,17,95,60,34,0,26,35
ACSSF,2010e5,wv,000,0034,0002930,080,54,109,08000US541099079599999002800,"Census Tract 28 (part), District Remainder of 1, District 1, Wyoming County, West Virginia",502,439,84,33,0,51,355,63,0,0,0,0,0,0,63,50,25,0,25,13
ACSSF,2010e5,wv,000,0034,0002931,080,54,109,08000US541099079599999003100,"Census Tract 31 (part), District Remainder of 1, District 1, Wyoming County, West Virginia",0,0,0,0,0,0,0,0,0,0,0,0,0,0,0,0,0,0,0,0
ACSSF,2010e5,wv,000,0034,0002932,080,54,109,08000US541099079599999003200,"Census Tract 32 (part), District Remainder of 1, District 1, Wyoming County, West Virginia",687,493,187,0,22,165,306,194,50,37,0,0,37,13,144,85,42,0,43,59
ACSSF,2010e5,wv,000,0034,0002933,080,54,109,08000US541099083109964002902,"Census Tract 29.02 (part), Brenton CDP, District 2, Wyoming County, West Virginia",53,53,40,0,13,27,13,0,0,0,0,0,0,0,0,0,0,0,0,0
ACSSF,2010e5,wv,000,0034,0002934,080,54,109,08000US541099083158756003100,"Census Tract 31 (part), New Richmond CDP, District 2, Wyoming County, West Virginia",38,38,18,0,18,0,20,0,0,0,0,0,0,0,0,0,0,0,0,0
ACSSF,2010e5,wv,000,0034,0002935,080,54,109,08000US541099083163940003100,"Census Tract 31 (part), Pineville town, District 2, Wyoming County, West Virginia",241,196,43,12,6,25,153,45,8,0,0,0,0,8,37,19,6,0,13,18
ACSSF,2010e5,wv,000,0034,0002936,080,54,109,08000US541099083163940003200,"Census Tract 32 (part), Pineville town, District 2, Wyoming County, West Virginia",0,0,0,0,0,0,0,0,0,0,0,0,0,0,0,0,0,0,0,0
ACSSF,2010e5,wv,000,0034,0002937,080,54,109,08000US541099083199999002800,"Census Tract 28 (part), District Remainder of 2, District 2, Wyoming County, West Virginia",78,78,25,0,0,25,53,0,0,0,0,0,0,0,0,0,0,0,0,0
ACSSF,2010e5,wv,000,0034,0002938,080,54,109,08000US541099083199999002901,"Census Tract 29.01 (part), District Remainder of 2, District 2, Wyoming County, West Virginia",0,0,0,0,0,0,0,0,0,0,0,0,0,0,0,0,0,0,0,0
ACSSF,2010e5,wv,000,0034,0002939,080,54,109,08000US541099083199999002902,"Census Tract 29.02 (part), District Remainder of 2, District 2, Wyoming County, West Virginia",115,76,63,36,0,27,13,39,9,9,0,0,9,0,30,15,0,0,15,15
ACSSF,2010e5,wv,000,0034,0002940,080,54,109,08000US541099083199999003000,"Census Tract 30 (part), District Remainder of 2, District 2, Wyoming County, West Virginia",656,584,260,42,0,218,324,72,28,0,0,0,0,28,44,0,0,0,0,44
ACSSF,2010e5,wv,000,0034,0002941,080,54,109,08000US541099083199999003100,"Census Tract 31 (part), District Remainder of 2, District 2, Wyoming County, West Virginia",926,763,302,52,80,170,461,163,42,15,0,0,15,27,121,33,0,0,33,88
ACSSF,2010e5,wv,000,0034,0002942,080,54,109,08000US541099083199999003200,"Census Tract 32 (part), District Remainder of 2, District 2, Wyoming County, West Virginia",0,0,0,0,0,0,0,0,0,0,0,0,0,0,0,0,0,0,0,0
ACSSF,2010e5,wv,000,0034,0002943,080,54,109,08000US541099086844548002901,"Census Tract 29.01 (part), Kopperston CDP, District 3, Wyoming County, West Virginia",188,174,127,15,29,83,47,14,0,0,0,0,0,0,14,14,0,0,14,0
ACSSF,2010e5,wv,000,0034,0002944,080,54,109,08000US541099086852372002902,"Census Tract 29.02 (part), Matheny CDP, District 3, Wyoming County, West Virginia",172,118,16,16,0,0,102,54,0,0,0,0,0,0,54,12,0,0,12,42
ACSSF,2010e5,wv,000,0034,0002945,080,54,109,08000US541099086852372003100,"Census Tract 31 (part), Matheny CDP, District 3, Wyoming County, West Virginia",0,0,0,0,0,0,0,0,0,0,0,0,0,0,0,0,0,0,0,0
ACSSF,2010e5,wv,000,0034,0002946,080,54,109,08000US541099086860364002901,"Census Tract 29.01 (part), Oceana town, District 3, Wyoming County, West Virginia",173,105,64,16,18,30,41,68,23,12,0,0,12,11,45,31,0,15,16,14
ACSSF,2010e5,wv,000,0034,0002947,080,54,109,08000US541099086860364002902,"Census Tract 29.02 (part), Oceana town, District 3, Wyoming County, West Virginia",262,210,51,0,14,37,159,52,5,5,0,0,5,0,47,23,11,3,9,24
ACSSF,2010e5,wv,000,0034,0002948,080,54,109,08000US541099086899999002800,"Census Tract 28 (part), District Remainder of 3, District 3, Wyoming County, West Virginia",90,59,33,0,0,33,26,31,13,13,0,0,13,0,18,18,18,0,0,0
ACSSF,2010e5,wv,000,0034,0002949,080,54,109,08000US541099086899999002901,"Census Tract 29.01 (part), District Remainder of 3, District 3, Wyoming County, West Virginia",1014,815,252,53,64,135,563,199,52,0,0,0,0,52,147,49,0,0,49,98
ACSSF,2010e5,wv,000,0034,0002950,080,54,109,08000US541099086899999002902,"Census Tract 29.02 (part), District Remainder of 3, District 3, Wyoming County, West Virginia",421,369,94,15,0,79,275,52,30,0,0,0,0,30,22,22,0,22,0,0
ACSSF,2010e5,wv,000,0034,0002951,080,54,109,08000US541099086899999003000,"Census Tract 30 (part), District Remainder of 3, District 3, Wyoming County, West Virginia",82,44,7,0,0,7,37,38,0,0,0,0,0,0,38,29,0,0,29,9
ACSSF,2010e5,wv,000,0034,0002952,080,54,109,08000US541099086899999003100,"Census Tract 31 (part), District Remainder of 3, District 3, Wyoming County, West Virginia",104,82,22,0,0,22,60,22,22,22,0,0,22,0,0,0,0,0,0,0
ACSSF,2010e5,wv,000,0034,0005029,155,54,045,15500US5400196045,"Logan County (part), Accoville CDP, West Virginia",174,149,65,17,0,48,84,25,0,0,0,0,0,0,25,0,0,0,0,25
ACSSF,2010e5,wv,000,0034,0005030,155,54,101,15500US5400364101,"Webster County (part), Addison (Webster Springs) town, West Virginia",319,184,62,7,13,42,122,135,0,0,0,0,0,0,135,62,46,3,13,73
ACSSF,2010e5,wv,000,0034,0005031,155,54,077,15500US5400748077,"Preston County (part), Albright town, West Virginia",81,76,37,8,2,27,39,5,0,0,0,0,0,0,5,0,0,0,0,5
ACSSF,2010e5,wv,000,0034,0005032,155,54,025,15500US5400772025,"Greenbrier County (part), Alderson town, West Virginia",280,156,47,21,11,15,109,124,48,45,41,0,4,3,76,43,25,5,13,33
ACSSF,2010e5,wv,000,0034,0005033,155,54,063,15500US5400772063,"Monroe County (part), Alderson town, West Virginia",72,32,17,12,5,0,15,40,3,0,0,0,0,3,37,16,0,0,16,21
ACSSF,2010e5,wv,000,0034,0005034,155,54,039,15500US5401396039,"Kanawha County (part), Alum Creek CDP, West Virginia",71,59,7,0,0,7,52,12,12,12,0,12,0,0,0,0,0,0,0,0
ACSSF,2010e5,wv,000,0034,0005035,155,54,043,15500US5401396043,"Lincoln County (part), Alum Creek CDP, West Virginia",274,204,115,37,0,78,89,70,0,0,0,0,0,0,70,13,0,13,0,57
ACSSF,2010e5,wv,000,0034,0005036,155,54,045,15500US5401660045,"Logan County (part), Amherstdale CDP, West Virginia",101,40,15,0,0,15,25,61,37,0,0,0,0,37,24,24,24,0,0,0
ACSSF,2010e5,wv,000,0034,0005037,155,54,047,15500US5401780047,"McDowell County (part), Anawalt town, West Virginia",77,60,12,0,0,12,48,17,6,4,0,0,4,2,11,5,0,5,0,6
ACSSF,2010e5,wv,000,0034,0005038,155,54,033,15500US5401900033,"Harrison County (part), Anmoore town, West Virginia",302,157,88,55,6,27,69,145,29,19,0,0,19,10,116,87,0,0,87,29
ACSSF,2010e5,wv,000,0034,0005039,155,54,019,15500US5401996019,"Fayette County (part), Ansted town, West Virginia",445,364,128,42,20,66,236,81,17,3,0,0,3,14,64,40,14,4,22,24
ACSSF,2010e5,wv,000,0034,0005040,155,54,053,15500US5402188053,"Mason County (part), Apple Grove CDP, West Virginia",45,22,0,0,0,0,22,23,23,0,0,0,0,23,0,0,0,0,0,0
ACSSF,2010e5,wv,000,0034,0005041,155,54,055,15500US5403292055,"Mercer County (part), Athens town, West Virginia",180,149,29,7,11,11,120,31,0,0,0,0,0,0,31,22,19,0,3,9
ACSSF,2010e5,wv,000,0034,0005042,155,54,085,15500US5403364085,"Ritchie County (part), Auburn town, West Virginia",21,13,0,0,0,0,13,8,2,0,0,0,0,2,6,5,0,0,5,1
ACSSF,2010e5,wv,000,0034,0005043,155,54,077,15500US5403460077,"Preston County (part), Aurora CDP, West Virginia",40,40,30,0,0,30,10,0,0,0,0,0,0,0,0,0,0,0,0,0
ACSSF,2010e5,wv,000,0034,0005044,155,54,079,15500US5404204079,"Putnam County (part), Bancroft town, West Virginia",50,39,14,0,0,14,25,11,0,0,0,0,0,0,11,0,0,0,0,11
ACSSF,2010e5,wv,000,0034,0005045,155,54,011,15500US5404276011,"Cabell County (part), Barboursville village, West Virginia",1179,1002,229,63,74,92,773,177,29,13,0,0,13,16,148,102,0,0,102,46
ACSSF,2010e5,wv,000,0034,0005046,155,54,049,15500US5404612049,"Marion County (part), Barrackville town, West Virginia",404,315,105,17,20,68,210,89,36,3,0,0,3,33,53,23,11,11,1,30
ACSSF,2010e5,wv,000,0034,0005047,155,54,047,15500US5404732047,"McDowell County (part), Bartley CDP, West Virginia",21,21,0,0,0,0,21,0,0,0,0,0,0,0,0,0,0,0,0,0
ACSSF,2010e5,wv,000,0034,0005048,155,54,075,15500US5404780075,"Pocahontas County (part), Bartow CDP, West Virginia",30,30,0,0,0,0,30,0,0,0,0,0,0,0,0,0,0,0,0,0
ACSSF,2010e5,wv,000,0034,0005049,155,54,065,15500US5404876065,"Morgan County (part), Bath (Berkeley Springs) town, West Virginia",155,115,44,4,18,22,71,40,2,0,0,0,0,2,38,20,0,6,14,18
ACSSF,2010e5,wv,000,0034,0005050,155,54,023,15500US5404924023,"Grant County (part), Bayard town, West Virginia",110,90,43,10,0,33,47,20,4,4,0,0,4,0,16,8,8,0,0,8
ACSSF,2010e5,wv,000,0034,0005051,155,54,019,15500US5405068019,"Fayette County (part), Beards Fork CDP, West Virginia",52,36,0,0,0,0,36,16,0,0,0,0,0,0,16,0,0,0,0,16
ACSSF,2010e5,wv,000,0034,0005052,155,54,081,15500US5405260081,"Raleigh County (part), Beaver CDP, West Virginia",415,287,89,12,32,45,198,128,65,21,21,0,0,44,63,53,11,0,42,10
ACSSF,2010e5,wv,000,0034,0005053,155,54,081,15500US5405332081,"Raleigh County (part), Beckley city, West Virginia",4451,3043,1033,259,214,560,2010,1408,324,116,30,63,23,208,1084,486,89,53,344,598
ACSSF,2010e5,wv,000,0034,0005054,155,54,009,15500US5405452009,"Brooke County (part), Beech Bottom village, West Virginia",111,76,22,6,5,11,54,35,7,0,0,0,0,7,28,16,4,0,12,12
ACSSF,2010e5,wv,000,0034,0005055,155,54,001,15500US5405788001,"Barbour County (part), Belington town, West Virginia",570,409,129,26,22,81,280,161,45,28,9,3,16,17,116,59,3,5,51,57
ACSSF,2010e5,wv,000,0034,0005056,155,54,039,15500US5405836039,"Kanawha County (part), Belle town, West Virginia",326,200,47,5,18,24,153,126,21,19,3,0,16,2,105,52,0,6,46,53
ACSSF,2010e5,wv,000,0034,0005057,155,54,073,15500US5406004073,"Pleasants County (part), Belmont city, West Virginia",213,168,57,3,19,35,111,45,10,0,0,0,0,10,35,15,0,0,15,20
ACSSF,2010e5,wv,000,0034,0005058,155,54,067,15500US5406052067,"Nicholas County (part), Belva CDP, West Virginia",8,0,0,0,0,0,0,8,0,0,0,0,0,0,8,8,0,0,8,0
ACSSF,2010e5,wv,000,0034,0005059,155,54,051,15500US5406340051,"Marshall County (part), Benwood city, West Virginia",363,230,77,5,28,44,153,133,44,27,0,0,27,17,89,57,8,13,36,32
ACSSF,2010e5,wv,000,0034,0005060,155,54,101,15500US5406436101,"Webster County (part), Bergoo CDP, West Virginia",15,0,0,0,0,0,0,15,0,0,0,0,0,0,15,15,0,0,15,0
ACSSF,2010e5,wv,000,0034,0005061,155,54,047,15500US5406748047,"McDowell County (part), Berwind CDP, West Virginia",54,25,0,0,0,0,25,29,12,0,0,0,0,12,17,17,0,0,17,0
ACSSF,2010e5,wv,000,0034,0005062,155,54,009,15500US5406844009,"Brooke County (part), Bethany town, West Virginia",115,92,21,4,0,17,71,23,7,7,0,0,7,0,16,0,0,0,0,16
ACSSF,2010e5,wv,000,0034,0005063,155,54,069,15500US5406940069,"Ohio County (part), Bethlehem village, West Virginia",775,701,243,31,27,185,458,74,15,10,10,0,0,5,59,21,0,15,6,38
ACSSF,2010e5,wv,000,0034,0005064,155,54,083,15500US5406988083,"Randolph County (part), Beverly town, West Virginia",163,116,44,4,0,40,72,47,10,10,0,0,10,0,37,29,25,0,4,8
ACSSF,2010e5,wv,000,0034,0005065,155,54,039,15500US5407204039,"Kanawha County (part), Big Chimney CDP, West Virginia",179,179,14,0,0,14,165,0,0,0,0,0,0,0,0,0,0,0,0,0
ACSSF,2010e5,wv,000,0034,0005066,155,54,045,15500US5407228045,"Logan County (part), Big Creek CDP, West Virginia",58,25,0,0,0,0,25,33,0,0,0,0,0,0,33,0,0,0,0,33
ACSSF,2010e5,wv,000,0034,0005067,155,54,047,15500US5407516047,"McDowell County (part), Big Sandy CDP, West Virginia",63,63,33,19,0,14,30,0,0,0,0,0,0,0,0,0,0,0,0,0
ACSSF,2010e5,wv,000,0034,0005068,155,54,067,15500US5407756067,"Nicholas County (part), Birch River CDP, West Virginia",72,62,0,0,0,0,62,10,0,0,0,0,0,0,10,0,0,0,0,10
ACSSF,2010e5,wv,000,0034,0005069,155,54,061,15500US5408092061,"Monongalia County (part), Blacksville town, West Virginia",33,21,7,0,3,4,14,12,4,0,0,0,0,4,8,2,0,0,2,6
ACSSF,2010e5,wv,000,0034,0005070,155,54,107,15500US5408308107,"Wood County (part), Blennerhassett CDP, West Virginia",941,685,135,19,8,108,550,256,97,19,4,0,15,78,159,57,0,19,38,102
ACSSF,2010e5,wv,000,0034,0005071,155,54,055,15500US5408524055,"Mercer County (part), Bluefield city, West Virginia",2538,1858,552,83,119,350,1306,680,54,14,0,0,14,40,626,403,107,54,242,223
ACSSF,2010e5,wv,000,0034,0005072,155,54,055,15500US5408764055,"Mercer County (part), Bluewell CDP, West Virginia",542,414,166,40,17,109,248,128,43,0,0,0,0,43,85,55,17,0,38,30
ACSSF,2010e5,wv,000,0034,0005073,155,54,107,15500US5408836107,"Wood County (part), Boaz CDP, West Virginia",504,426,188,44,53,91,238,78,24,24,0,0,24,0,54,54,18,8,28,0
ACSSF,2010e5,wv,000,0034,0005074,155,54,037,15500US5408932037,"Jefferson County (part), Bolivar town, West Virginia",197,162,59,5,9,45,103,35,3,0,0,0,0,3,32,11,3,0,8,21
ACSSF,2010e5,wv,000,0034,0005075,155,54,081,15500US5408956081,"Raleigh County (part), Bolt CDP, West Virginia",156,156,62,20,0,42,94,0,0,0,0,0,0,0,0,0,0,0,0,0
ACSSF,2010e5,wv,000,0034,0005076,155,54,019,15500US5409100019,"Fayette County (part), Boomer CDP, West Virginia",235,138,36,0,9,27,102,97,66,34,17,0,17,32,31,0,0,0,0,31
ACSSF,2010e5,wv,000,0034,0005077,155,54,083,15500US5409364083,"Randolph County (part), Bowden CDP, West Virginia",0,0,0,0,0,0,0,0,0,0,0,0,0,0,0,0,0,0,0,0
ACSSF,2010e5,wv,000,0034,0005078,155,54,081,15500US5409676081,"Raleigh County (part), Bradley CDP, West Virginia",555,468,155,73,42,40,313,87,24,12,12,0,0,12,63,63,21,0,42,0
ACSSF,2010e5,wv,000,0034,0005079,155,54,047,15500US5409700047,"McDowell County (part), Bradshaw town, West Virginia",70,50,15,2,3,10,35,20,8,0,0,0,0,8,12,9,6,0,3,3
ACSSF,2010e5,wv,000,0034,0005080,155,54,055,15500US5409796055,"Mercer County (part), Bramwell town, West Virginia",113,59,13,2,4,7,46,54,6,4,4,0,0,2,48,10,2,0,8,38
ACSSF,2010e5,wv,000,0034,0005081,155,54,077,15500US5409844077,"Preston County (part), Brandonville town, West Virginia",24,15,2,2,0,0,13,9,0,0,0,0,0,0,9,2,0,0,2,7
ACSSF,2010e5,wv,000,0034,0005082,155,54,071,15500US5409868071,"Pendleton County (part), Brandywine CDP, West Virginia",113,99,42,0,31,11,57,14,0,0,0,0,0,0,14,0,0,0,0,14
ACSSF,2010e5,wv,000,0034,0005083,155,54,109,15500US5409964109,"Wyoming County (part), Brenton CDP, West Virginia",53,53,40,0,13,27,13,0,0,0,0,0,0,0,0,0,0,0,0,0
ACSSF,2010e5,wv,000,0034,0005084,155,54,033,15500US5410180033,"Harrison County (part), Bridgeport city, West Virginia",2306,1900,662,95,161,406,1238,406,137,91,17,0,74,46,269,111,0,22,89,158
ACSSF,2010e5,wv,000,0034,0005085,155,54,061,15500US5410420061,"Monongalia County (part), Brookhaven CDP, West Virginia",1358,949,476,92,118,266,473,409,193,95,58,0,37,98,216,141,81,0,60,75
ACSSF,2010e5,wv,000,0034,0005086,155,54,077,15500US5410852077,"Preston County (part), Bruceton Mills town, West Virginia",39,18,11,0,8,3,7,21,9,9,0,0,9,0,12,9,5,0,4,3
ACSSF,2010e5,wv,000,0034,0005087,155,54,045,15500US5410876045,"Logan County (part), Bruno CDP, West Virginia",145,126,19,19,0,0,107,19,0,0,0,0,0,0,19,0,0,0,0,19
ACSSF,2010e5,wv,000,0034,0005088,155,54,055,15500US5410948055,"Mercer County (part), Brush Fork CDP, West Virginia",219,123,39,0,14,25,84,96,9,0,0,0,0,9,87,32,32,0,0,55
ACSSF,2010e5,wv,000,0034,0005089,155,54,097,15500US5411188097,"Upshur County (part), Buckhannon city, West Virginia",1053,757,312,73,61,178,445,296,14,6,6,0,0,8,282,142,0,58,84,140
ACSSF,2010e5,wv,000,0034,0005090,155,54,109,15500US5411212109,"Wyoming County (part), Bud CDP, West Virginia",64,43,0,0,0,0,43,21,0,0,0,0,0,0,21,21,21,0,0,0
ACSSF,2010e5,wv,000,0034,0005091,155,54,079,15500US5411284079,"Putnam County (part), Buffalo town, West Virginia",361,276,108,0,3,105,168,85,43,25,6,6,13,18,42,30,9,6,15,12
ACSSF,2010e5,wv,000,0034,0005092,155,54,057,15500US5411620057,"Mineral County (part), Burlington CDP, West Virginia",0,0,0,0,0,0,0,0,0,0,0,0,0,0,0,0,0,0,0,0
ACSSF,2010e5,wv,000,0034,0005093,155,54,007,15500US5411716007,"Braxton County (part), Burnsville town, West Virginia",150,101,32,10,0,22,69,49,14,8,0,0,8,6,35,10,0,4,6,25
ACSSF,2010e5,wv,000,0034,0005094,155,54,085,15500US5412124085,"Ritchie County (part), Cairo town, West Virginia",100,71,3,0,0,3,68,29,14,5,0,0,5,9,15,15,0,5,10,0
ACSSF,2010e5,wv,000,0034,0005095,155,54,101,15500US5412436101,"Webster County (part), Camden-on-Gauley town, West Virginia",30,16,0,0,0,0,16,14,0,0,0,0,0,0,14,5,1,0,4,9
ACSSF,2010e5,wv,000,0034,0005096,155,54,051,15500US5412484051,"Marshall County (part), Cameron city, West Virginia",256,197,101,27,27,47,96,59,30,23,23,0,0,7,29,13,5,0,8,16
ACSSF,2010e5,wv,000,0034,0005097,155,54,027,15500US5413108027,"Hampshire County (part), Capon Bridge town, West Virginia",103,55,22,11,6,5,33,48,0,0,0,0,0,0,48,32,0,0,32,16
ACSSF,2010e5,wv,000,0034,0005098,155,54,049,15500US5413468049,"Marion County (part), Carolina CDP, West Virginia",110,93,70,9,17,44,23,17,17,0,0,0,0,17,0,0,0,0,0,0
ACSSF,2010e5,wv,000,0034,0005099,155,54,057,15500US5413525057,"Mineral County (part), Carpendale town, West Virginia",293,254,43,4,4,35,211,39,3,3,0,0,3,0,36,2,0,0,2,34
ACSSF,2010e5,wv,000,0034,0005100,155,54,075,15500US5413684075,"Pocahontas County (part), Cass CDP, West Virginia",0,0,0,0,0,0,0,0,0,0,0,0,0,0,0,0,0,0,0,0
ACSSF,2010e5,wv,000,0034,0005101,155,54,061,15500US5413756061,"Monongalia County (part), Cassville CDP, West Virginia",248,248,97,28,53,16,151,0,0,0,0,0,0,0,0,0,0,0,0,0
ACSSF,2010e5,wv,000,0034,0005102,155,54,039,15500US5413924039,"Kanawha County (part), Cedar Grove town, West Virginia",253,155,38,7,12,19,117,98,23,15,0,0,15,8,75,41,7,20,14,34
ACSSF,2010e5,wv,000,0034,0005103,155,54,001,15500US5414212001,"Barbour County (part), Century CDP, West Virginia",21,21,13,0,0,13,8,0,0,0,0,0,0,0,0,0,0,0,0,0
ACSSF,2010e5,wv,000,0034,0005104,155,54,099,15500US5414308099,"Wayne County (part), Ceredo city, West Virginia",482,358,69,34,9,26,289,124,56,28,28,0,0,28,68,31,0,0,31,37
ACSSF,2010e5,wv,000,0034,0005105,155,54,045,15500US5414524045,"Logan County (part), Chapmanville town, West Virginia",411,323,137,27,32,78,186,88,0,0,0,0,0,0,88,43,13,0,30,45
ACSSF,2010e5,wv,000,0034,0005106,155,54,039,15500US5414600039,"Kanawha County (part), Charleston city, West Virginia",12327,8817,3194,755,521,1918,5623,3510,764,435,102,76,257,329,2746,1577,546,233,798,1169
ACSSF,2010e5,wv,000,0034,0005107,155,54,037,15500US5414610037,"Jefferson County (part), Charles Town city, West Virginia",1142,931,551,189,115,247,380,211,84,40,0,0,40,44,127,0,0,0,0,127
ACSSF,2010e5,wv,000,0034,0005108,155,54,019,15500US5414630019,"Fayette County (part), Charlton Heights CDP, West Virginia",75,59,19,0,19,0,40,16,0,0,0,0,0,0,16,0,0,0,0,16
ACSSF,2010e5,wv,000,0034,0005109,155,54,059,15500US5414692059,"Mingo County (part), Chattaroy CDP, West Virginia",256,207,45,28,0,17,162,49,0,0,0,0,0,0,49,32,0,0,32,17
ACSSF,2010e5,wv,000,0034,0005110,155,54,045,15500US5414716045,"Logan County (part), Chauncey CDP, West Virginia",177,157,59,20,20,19,98,20,0,0,0,0,0,0,20,0,0,0,0,20
ACSSF,2010e5,wv,000,0034,0005111,155,54,061,15500US5414775061,"Monongalia County (part), Cheat Lake CDP, West Virginia",2042,1792,719,172,161,386,1073,250,78,52,38,0,14,26,172,69,0,5,64,103
ACSSF,2010e5,wv,000,0034,0005112,155,54,039,15500US5414812039,"Kanawha County (part), Chelyan CDP, West Virginia",112,77,0,0,0,0,77,35,0,0,0,0,0,0,35,18,0,0,18,17
ACSSF,2010e5,wv,000,0034,0005113,155,54,039,15500US5415028039,"Kanawha County (part), Chesapeake town, West Virginia",448,305,124,56,11,57,181,143,43,18,9,0,9,25,100,45,0,4,41,55
ACSSF,2010e5,wv,000,0034,0005114,155,54,029,15500US5415076029,"Hancock County (part), Chester city, West Virginia",666,539,213,40,41,132,326,127,54,54,9,0,45,0,73,37,5,16,16,36
ACSSF,2010e5,wv,000,0034,0005115,155,54,033,15500US5415628033,"Harrison County (part), Clarksburg city, West Virginia",4157,2786,1056,267,159,630,1730,1371,283,158,12,15,131,125,1088,566,198,97,271,522
ACSSF,2010e5,wv,000,0034,0005116,155,54,015,15500US5415676015,"Clay County (part), Clay town, West Virginia",100,84,35,0,0,35,49,16,0,0,0,0,0,0,16,7,0,0,7,9
ACSSF,2010e5,wv,000,0034,0005117,155,54,069,15500US5415916069,"Ohio County (part), Clearview village, West Virginia",204,178,47,3,6,38,131,26,0,0,0,0,0,0,26,13,9,4,0,13
ACSSF,2010e5,wv,000,0034,0005118,155,54,039,15500US5416012039,"Kanawha County (part), Clendenin town, West Virginia",340,246,89,29,11,49,157,94,7,0,0,0,0,7,87,48,7,14,27,39
ACSSF,2010e5,wv,000,0034,0005119,155,54,081,15500US5416516081,"Raleigh County (part), Coal City CDP, West Virginia",463,348,208,38,35,135,140,115,41,0,0,0,0,41,74,12,0,12,0,62
ACSSF,2010e5,wv,000,0034,0005120,155,54,039,15500US5416612039,"Kanawha County (part), Coal Fork CDP, West Virginia",343,299,62,8,0,54,237,44,0,0,0,0,0,0,44,25,25,0,0,19
ACSSF,2010e5,wv,000,0034,0005121,155,54,005,15500US5417380005,"Boone County (part), Comfort CDP, West Virginia",133,122,85,0,0,85,37,11,0,0,0,0,0,0,11,0,0,0,0,11
ACSSF,2010e5,wv,000,0034,0005122,155,54,109,15500US5417836109,"Wyoming County (part), Corinne CDP, West Virginia",98,63,21,0,0,21,42,35,17,17,0,0,17,0,18,18,0,0,18,0
ACSSF,2010e5,wv,000,0034,0005123,155,54,109,15500US5418388109,"Wyoming County (part), Covel CDP, West Virginia",19,19,0,0,0,0,19,0,0,0,0,0,0,0,0,0,0,0,0,0
ACSSF,2010e5,wv,000,0034,0005124,155,54,101,15500US5418412101,"Webster County (part), Cowen town, West Virginia",191,129,64,53,7,4,65,62,28,10,0,0,10,18,34,9,0,7,2,25
ACSSF,2010e5,wv,000,0034,0005125,155,54,081,15500US5418508081,"Raleigh County (part), Crab Orchard CDP, West Virginia",825,693,240,45,63,132,453,132,72,25,0,25,0,47,60,0,0,0,0,60
ACSSF,2010e5,wv,000,0034,0005126,155,54,067,15500US5418604067,"Nicholas County (part), Craigsville CDP, West Virginia",836,703,298,91,105,102,405,133,51,21,0,0,21,30,82,44,19,0,25,38
ACSSF,2010e5,wv,000,0034,0005127,155,54,039,15500US5419108039,"Kanawha County (part), Cross Lanes CDP, West Virginia",2496,2024,675,178,98,399,1349,472,111,59,48,0,11,52,361,202,82,11,109,159
ACSSF,2010e5,wv,000,0034,0005128,155,54,099,15500US5419300099,"Wayne County (part), Crum CDP, West Virginia",37,24,8,0,0,8,16,13,0,0,0,0,0,0,13,0,0,0,0,13
ACSSF,2010e5,wv,000,0034,0005129,155,54,047,15500US5419324047,"McDowell County (part), Crumpler CDP, West Virginia",61,57,25,0,0,25,32,4,4,4,0,0,4,0,0,0,0,0,0,0
ACSSF,2010e5,wv,000,0034,0005130,155,54,047,15500US5419492047,"McDowell County (part), Cucumber CDP, West Virginia",35,19,6,6,0,0,13,16,0,0,0,0,0,0,16,16,0,0,16,0
ACSSF,2010e5,wv,000,0034,0005131,155,54,011,15500US5419516011,"Cabell County (part), Culloden CDP, West Virginia",716,590,265,55,47,163,325,126,58,0,0,0,0,58,68,29,0,0,29,39
ACSSF,2010e5,wv,000,0034,0005132,155,54,079,15500US5419516079,"Putnam County (part), Culloden CDP, West Virginia",50,35,13,13,0,0,22,15,0,0,0,0,0,0,15,0,0,0,0,15
ACSSF,2010e5,wv,000,0034,0005133,155,54,083,15500US5419948083,"Randolph County (part), Dailey CDP, West Virginia",15,15,0,0,0,0,15,0,0,0,0,0,0,0,0,0,0,0,0,0
ACSSF,2010e5,wv,000,0034,0005134,155,54,081,15500US5420164081,"Raleigh County (part), Daniels CDP, West Virginia",442,392,83,7,34,42,309,50,0,0,0,0,0,0,50,38,38,0,0,12
ACSSF,2010e5,wv,000,0034,0005135,155,54,005,15500US5420212005,"Boone County (part), Danville town, West Virginia",245,197,73,6,13,54,124,48,6,6,0,0,6,0,42,28,0,9,19,14
ACSSF,2010e5,wv,000,0034,0005136,155,54,093,15500US5420428093,"Tucker County (part), Davis town, West Virginia",146,116,35,14,4,17,81,30,10,5,0,0,5,5,20,0,0,0,0,20
ACSSF,2010e5,wv,000,0034,0005137,155,54,047,15500US5420500047,"McDowell County (part), Davy town, West Virginia",94,84,7,7,0,0,77,10,0,0,0,0,0,0,10,0,0,0,0,10
ACSSF,2010e5,wv,000,0034,0005138,155,54,019,15500US5420764019,"Fayette County (part), Deep Water CDP, West Virginia",35,13,13,0,0,13,0,22,12,0,0,0,0,12,10,10,0,0,10,0
ACSSF,2010e5,wv,000,0034,0005139,155,54,059,15500US5420980059,"Mingo County (part), Delbarton town, West Virginia",263,210,96,8,26,62,114,53,14,0,0,0,0,14,39,12,0,5,7,27
ACSSF,2010e5,wv,000,0034,0005140,155,54,033,15500US5421316033,"Harrison County (part), Despard CDP, West Virginia",216,120,39,0,27,12,81,96,0,0,0,0,0,0,96,46,0,0,46,50
ACSSF,2010e5,wv,000,0034,0005141,155,54,019,15500US5421628019,"Fayette County (part), Dixie CDP, West Virginia",40,40,0,0,0,0,40,0,0,0,0,0,0,0,0,0,0,0,0,0
ACSSF,2010e5,wv,000,0034,0005142,155,54,067,15500US5421628067,"Nicholas County (part), Dixie CDP, West Virginia",68,68,53,0,0,53,15,0,0,0,0,0,0,0,0,0,0,0,0,0
ACSSF,2010e5,wv,000,0034,0005143,155,54,039,15500US5422564039,"Kanawha County (part), Dunbar city, West Virginia",2139,1435,418,94,61,263,1017,704,100,18,9,0,9,82,604,309,73,41,195,295
ACSSF,2010e5,wv,000,0034,0005144,155,54,075,15500US5422852075,"Pocahontas County (part), Durbin town, West Virginia",88,63,5,0,0,5,58,25,8,6,0,0,6,2,17,11,11,0,0,6
ACSSF,2010e5,wv,000,0034,0005145,155,54,039,15500US5423092039,"Kanawha County (part), East Bank town, West Virginia",303,176,40,16,0,24,136,127,33,20,15,0,5,13,94,65,9,33,23,29
ACSSF,2010e5,wv,000,0034,0005146,155,54,083,15500US5423140083,"Randolph County (part), East Dailey CDP, West Virginia",150,138,56,22,34,0,82,12,12,0,0,0,0,12,0,0,0,0,0,0
ACSSF,2010e5,wv,000,0034,0005147,155,54,081,15500US5423644081,"Raleigh County (part), Eccles CDP, West Virginia",118,64,64,14,0,50,0,54,23,23,0,0,23,0,31,0,0,0,0,31
ACSSF,2010e5,wv,000,0034,0005148,155,54,079,15500US5424292079,"Putnam County (part), Eleanor town, West Virginia",501,402,154,27,36,91,248,99,6,0,0,0,0,6,93,45,4,0,41,48
ACSSF,2010e5,wv,000,0034,0005149,155,54,105,15500US5424364105,"Wirt County (part), Elizabeth town, West Virginia",341,215,79,0,30,49,136,126,39,31,14,0,17,8,87,79,17,12,50,8
ACSSF,2010e5,wv,000,0034,0005150,155,54,057,15500US5424484057,"Mineral County (part), Elk Garden town, West Virginia",80,50,18,3,8,7,32,30,11,3,0,0,3,8,19,14,0,0,14,5
ACSSF,2010e5,wv,000,0034,0005151,155,54,083,15500US5424580083,"Randolph County (part), Elkins city, West Virginia",1699,1238,487,63,48,376,751,461,103,79,47,5,27,24,358,238,39,82,117,120
ACSSF,2010e5,wv,000,0034,0005152,155,54,039,15500US5424748039,"Kanawha County (part), Elkview CDP, West Virginia",408,346,100,22,20,58,246,62,12,0,0,0,0,12,50,0,0,0,0,50
ACSSF,2010e5,wv,000,0034,0005153,155,54,085,15500US5424844085,"Ritchie County (part), Ellenboro town, West Virginia",164,138,23,0,2,21,115,26,2,0,0,0,0,2,24,18,0,0,18,6
ACSSF,2010e5,wv,000,0034,0005154,155,54,033,15500US5425516033,"Harrison County (part), Enterprise CDP, West Virginia",343,222,54,0,20,34,168,121,24,0,0,0,0,24,97,19,19,0,0,78
ACSSF,2010e5,wv,000,0034,0005155,155,54,025,15500US5426428025,"Greenbrier County (part), Fairlea CDP, West Virginia",614,460,200,96,66,38,260,154,43,0,0,0,0,43,111,42,0,42,0,69
ACSSF,2010e5,wv,000,0034,0005156,155,54,049,15500US5426452049,"Marion County (part), Fairmont city, West Virginia",4310,2906,900,220,162,518,2006,1404,332,233,18,0,215,99,1072,578,187,92,299,494
ACSSF,2010e5,wv,000,0034,0005157,155,54,049,15500US5426524049,"Marion County (part), Fairview town, West Virginia",110,85,41,5,6,30,44,25,9,5,5,0,0,4,16,10,2,0,8,6
ACSSF,2010e5,wv,000,0034,0005158,155,54,025,15500US5426692025,"Greenbrier County (part), Falling Spring town, West Virginia",51,45,11,0,4,7,34,6,3,3,0,3,0,0,3,0,0,0,0,3
ACSSF,2010e5,wv,000,0034,0005159,155,54,003,15500US5426716003,"Berkeley County (part), Falling Waters CDP, West Virginia",233,216,84,0,64,20,132,17,2,0,0,0,0,2,15,8,0,0,8,7
ACSSF,2010e5,wv,000,0034,0005160,155,54,019,15500US5426812019,"Fayette County (part), Falls View CDP, West Virginia",42,25,0,0,0,0,25,17,17,0,0,0,0,17,0,0,0,0,0,0
ACSSF,2010e5,wv,000,0034,0005161,155,54,049,15500US5426932049,"Marion County (part), Farmington town, West Virginia",92,64,18,8,2,8,46,28,2,0,0,0,0,2,26,10,0,0,10,16
ACSSF,2010e5,wv,000,0034,0005162,155,54,019,15500US5427028019,"Fayette County (part), Fayetteville town, West Virginia",755,579,243,37,47,159,336,176,80,35,0,5,30,45,96,48,0,13,35,48
ACSSF,2010e5,wv,000,0034,0005163,155,54,067,15500US5427196067,"Nicholas County (part), Fenwick CDP, West Virginia",50,28,14,0,0,14,14,22,0,0,0,0,0,0,22,0,0,0,0,22
ACSSF,2010e5,wv,000,0034,0005164,155,54,007,15500US5427868007,"Braxton County (part), Flatwoods town, West Virginia",38,34,9,0,3,6,25,4,0,0,0,0,0,0,4,0,0,0,0,4
ACSSF,2010e5,wv,000,0034,0005165,155,54,091,15500US5427940091,"Taylor County (part), Flemington town, West Virginia",91,68,27,0,12,15,41,23,7,4,0,0,4,3,16,6,0,0,6,10
ACSSF,2010e5,wv,000,0034,0005166,155,54,009,15500US5428204009,"Brooke County (part), Follansbee city, West Virginia",822,643,155,12,45,98,488,179,73,39,29,0,10,34,106,57,0,0,57,49
ACSSF,2010e5,wv,000,0034,0005167,155,54,057,15500US5428444057,"Mineral County (part), Fort Ashby CDP, West Virginia",539,492,194,25,78,91,298,47,0,0,0,0,0,0,47,47,17,0,30,0
ACSSF,2010e5,wv,000,0034,0005168,155,54,099,15500US5428516099,"Wayne County (part), Fort Gay town, West Virginia",206,140,47,4,23,20,93,66,23,8,0,0,8,15,43,14,0,0,14,29
ACSSF,2010e5,wv,000,0034,0005169,155,54,075,15500US5428948075,"Pocahontas County (part), Frank CDP, West Virginia",56,56,56,0,0,56,0,0,0,0,0,0,0,0,0,0,0,0,0,0
ACSSF,2010e5,wv,000,0034,0005170,155,54,071,15500US5429044071,"Pendleton County (part), Franklin town, West Virginia",212,133,57,16,9,32,76,79,3,0,0,0,0,3,76,25,9,0,16,51
ACSSF,2010e5,wv,000,0034,0005171,155,54,095,15500US5429404095,"Tyler County (part), Friendly town, West Virginia",33,30,15,6,4,5,15,3,0,0,0,0,0,0,3,0,0,0,0,3
ACSSF,2010e5,wv,000,0034,0005172,155,54,053,15500US5429716053,"Mason County (part), Gallipolis Ferry CDP, West Virginia",307,242,39,6,0,33,203,65,7,0,0,0,0,7,58,46,0,34,12,12
ACSSF,2010e5,wv,000,0034,0005173,155,54,001,15500US5429740001,"Barbour County (part), Galloway CDP, West Virginia",51,28,0,0,0,0,28,23,0,0,0,0,0,0,23,23,0,0,23,0
ACSSF,2010e5,wv,000,0034,0005174,155,54,047,15500US5430196047,"McDowell County (part), Gary city, West Virginia",233,148,30,20,0,10,118,85,0,0,0,0,0,0,85,35,0,15,20,50
ACSSF,2010e5,wv,000,0034,0005175,155,54,007,15500US5430220007,"Braxton County (part), Gassaway town, West Virginia",217,169,52,15,8,29,117,48,0,0,0,0,0,0,48,39,18,3,18,9
ACSSF,2010e5,wv,000,0034,0005176,155,54,019,15500US5430364019,"Fayette County (part), Gauley Bridge town, West Virginia",175,102,27,0,3,24,75,73,9,0,0,0,0,9,64,42,11,6,25,22
ACSSF,2010e5,wv,000,0034,0005177,155,54,081,15500US5430724081,"Raleigh County (part), Ghent CDP, West Virginia",166,134,21,0,21,0,113,32,0,0,0,0,0,0,32,0,0,0,0,32
ACSSF,2010e5,wv,000,0034,0005178,155,54,059,15500US5430772059,"Mingo County (part), Gilbert town, West Virginia",104,88,28,12,0,16,60,16,5,0,0,0,0,5,11,3,0,0,3,8
ACSSF,2010e5,wv,000,0034,0005179,155,54,059,15500US5430777059,"Mingo County (part), Gilbert Creek CDP, West Virginia",535,476,123,78,0,45,353,59,26,26,0,0,26,0,33,33,19,0,14,0
ACSSF,2010e5,wv,000,0034,0005180,155,54,039,15500US5431324039,"Kanawha County (part), Glasgow town, West Virginia",180,150,55,13,18,24,95,30,10,0,0,0,0,10,20,13,4,9,0,7
ACSSF,2010e5,wv,000,0034,0005181,155,54,051,15500US5431492051,"Marshall County (part), Glen Dale city, West Virginia",487,391,134,45,13,76,257,96,49,29,3,0,26,20,47,15,0,0,15,32
ACSSF,2010e5,wv,000,0034,0005182,155,54,019,15500US5431732019,"Fayette County (part), Glen Ferris CDP, West Virginia",15,15,15,0,0,15,0,0,0,0,0,0,0,0,0,0,0,0,0,0
ACSSF,2010e5,wv,000,0034,0005183,155,54,109,15500US5431756109,"Wyoming County (part), Glen Fork CDP, West Virginia",39,39,0,0,0,0,39,0,0,0,0,0,0,0,0,0,0,0,0,0
ACSSF,2010e5,wv,000,0034,0005184,155,54,019,15500US5431876019,"Fayette County (part), Glen Jean CDP, West Virginia",89,55,0,0,0,0,55,34,0,0,0,0,0,0,34,0,0,0,0,34
ACSSF,2010e5,wv,000,0034,0005185,155,54,021,15500US5432044021,"Gilmer County (part), Glenville town, West Virginia",325,189,104,13,17,74,85,136,25,8,0,0,8,17,111,41,3,23,15,70
ACSSF,2010e5,wv,000,0034,0005186,155,54,081,15500US5432068081,"Raleigh County (part), Glen White CDP, West Virginia",0,0,0,0,0,0,0,0,0,0,0,0,0,0,0,0,0,0,0,0
ACSSF,2010e5,wv,000,0034,0005187,155,54,091,15500US5432716091,"Taylor County (part), Grafton city, West Virginia",1355,808,277,45,50,182,531,547,95,19,0,0,19,76,452,282,11,88,183,170
ACSSF,2010e5,wv,000,0034,0005188,155,54,013,15500US5432884013,"Calhoun County (part), Grantsville town, West Virginia",198,144,58,8,25,25,86,54,31,0,0,0,0,31,23,3,3,0,0,20
ACSSF,2010e5,wv,000,0034,0005189,155,54,049,15500US5432908049,"Marion County (part), Grant Town town, West Virginia",135,88,38,14,3,21,50,47,19,0,0,0,0,19,28,12,0,0,12,16
ACSSF,2010e5,wv,000,0034,0005190,155,54,061,15500US5432932061,"Monongalia County (part), Granville town, West Virginia",146,114,30,4,0,26,84,32,15,5,0,5,0,10,17,5,0,0,5,12
ACSSF,2010e5,wv,000,0034,0005191,155,54,065,15500US5433100065,"Morgan County (part), Great Cacapon CDP, West Virginia",107,92,33,0,13,20,59,15,0,0,0,0,0,0,15,0,0,0,0,15
ACSSF,2010e5,wv,000,0034,0005192,155,54,075,15500US5433124075,"Pocahontas County (part), Green Bank CDP, West Virginia",32,32,24,24,0,0,8,0,0,0,0,0,0,0,0,0,0,0,0,0
ACSSF,2010e5,wv,000,0034,0005193,155,54,027,15500US5433436027,"Hampshire County (part), Green Spring CDP, West Virginia",43,43,13,0,0,13,30,0,0,0,0,0,0,0,0,0,0,0,0,0
ACSSF,2010e5,wv,000,0034,0005194,155,54,005,15500US5433580005,"Boone County (part), Greenview CDP, West Virginia",117,81,32,0,32,0,49,36,0,0,0,0,0,0,36,36,0,0,36,0
ACSSF,2010e5,wv,000,0034,0005195,155,54,033,15500US5434180033,"Harrison County (part), Gypsy CDP, West Virginia",18,0,0,0,0,0,0,18,0,0,0,0,0,0,18,0,0,0,0,18
ACSSF,2010e5,wv,000,0034,0005196,155,54,093,15500US5434492093,"Tucker County (part), Hambleton town, West Virginia",70,63,20,3,8,9,43,7,7,3,0,0,3,4,0,0,0,0,0,0
ACSSF,2010e5,wv,000,0034,0005197,155,54,043,15500US5434516043,"Lincoln County (part), Hamlin town, West Virginia",312,178,70,25,13,32,108,134,29,19,8,0,11,10,105,62,22,3,37,43
ACSSF,2010e5,wv,000,0034,0005198,155,54,039,15500US5434756039,"Kanawha County (part), Handley town, West Virginia",47,34,12,2,4,6,22,13,2,0,0,0,0,2,11,3,3,0,0,8
ACSSF,2010e5,wv,000,0034,0005199,155,54,083,15500US5435092083,"Randolph County (part), Harman town, West Virginia",43,22,3,3,0,0,19,21,4,4,0,0,4,0,17,14,5,0,9,3
ACSSF,2010e5,wv,000,0034,0005200,155,54,037,15500US5435284037,"Jefferson County (part), Harpers Ferry town, West Virginia",60,60,14,9,0,5,46,0,0,0,0,0,0,0,0,0,0,0,0,0
ACSSF,2010e5,wv,000,0034,0005201,155,54,085,15500US5435428085,"Ritchie County (part), Harrisville town, West Virginia",606,433,179,21,47,111,254,173,32,14,6,0,8,18,141,96,29,11,56,45
ACSSF,2010e5,wv,000,0034,0005202,155,54,053,15500US5435500053,"Mason County (part), Hartford City town, West Virginia",206,146,69,25,13,31,77,60,22,4,0,0,4,18,38,21,0,0,21,17
ACSSF,2010e5,wv,000,0034,0005203,155,54,043,15500US5435596043,"Lincoln County (part), Harts CDP, West Virginia",309,186,59,13,17,29,127,123,16,0,0,0,0,16,107,74,9,0,65,33
ACSSF,2010e5,wv,000,0034,0005204,155,54,003,15500US5436220003,"Berkeley County (part), Hedgesville town, West Virginia",63,47,26,2,3,21,21,16,3,0,0,0,0,3,13,10,4,2,4,3
ACSSF,2010e5,wv,000,0034,0005205,155,54,081,15500US5436292081,"Raleigh County (part), Helen CDP, West Virginia",18,18,0,0,0,0,18,0,0,0,0,0,0,0,0,0,0,0,0,0
ACSSF,2010e5,wv,000,0034,0005206,155,54,083,15500US5436340083,"Randolph County (part), Helvetia CDP, West Virginia",4,4,0,0,0,0,4,0,0,0,0,0,0,0,0,0,0,0,0,0
ACSSF,2010e5,wv,000,0034,0005207,155,54,053,15500US5436436053,"Mason County (part), Henderson town, West Virginia",51,26,9,4,0,5,17,25,5,3,0,3,0,2,20,19,6,4,9,1
ACSSF,2010e5,wv,000,0034,0005208,155,54,093,15500US5436460093,"Tucker County (part), Hendricks town, West Virginia",101,88,35,7,8,20,53,13,2,2,2,0,0,0,11,0,0,0,0,11
ACSSF,2010e5,wv,000,0034,0005209,155,54,045,15500US5436484045,"Logan County (part), Henlawson CDP, West Virginia",154,114,0,0,0,0,114,40,19,0,0,0,0,19,21,0,0,0,0,21
ACSSF,2010e5,wv,000,0034,0005210,155,54,033,15500US5436628033,"Harrison County (part), Hepzibah CDP, West Virginia",192,179,49,0,21,28,130,13,13,13,13,0,0,0,0,0,0,0,0,0
ACSSF,2010e5,wv,000,0034,0005211,155,54,019,15500US5437036019,"Fayette County (part), Hico CDP, West Virginia",60,50,16,0,0,16,34,10,0,0,0,0,0,0,10,0,0,0,0,10
ACSSF,2010e5,wv,000,0034,0005212,155,54,075,15500US5437372075,"Pocahontas County (part), Hillsboro town, West Virginia",67,56,36,23,4,9,20,11,0,0,0,0,0,0,11,8,0,0,8,3
ACSSF,2010e5,wv,000,0034,0005213,155,54,019,15500US5437444019,"Fayette County (part), Hilltop CDP, West Virginia",132,54,17,0,0,17,37,78,0,0,0,0,0,0,78,69,0,0,69,9
ACSSF,2010e5,wv,000,0034,0005214,155,54,089,15500US5437636089,"Summers County (part), Hinton city, West Virginia",560,346,149,25,14,110,197,214,69,49,19,0,30,20,145,45,0,0,45,100
ACSSF,2010e5,wv,000,0034,0005215,155,54,045,15500US5437948045,"Logan County (part), Holden CDP, West Virginia",185,121,97,47,21,29,24,64,0,0,0,0,0,0,64,27,0,0,27,37
ACSSF,2010e5,wv,000,0034,0005216,155,54,079,15500US5438260079,"Putnam County (part), Hometown CDP, West Virginia",238,172,18,0,0,18,154,66,0,0,0,0,0,0,66,36,36,0,0,30
ACSSF,2010e5,wv,000,0034,0005217,155,54,009,15500US5438476009,"Brooke County (part), Hooverson Heights CDP, West Virginia",821,657,244,37,61,146,413,164,61,27,0,0,27,34,103,48,23,9,16,55
ACSSF,2010e5,wv,000,0034,0005218,155,54,103,15500US5439340103,"Wetzel County (part), Hundred town, West Virginia",78,73,27,5,3,19,46,5,2,0,0,0,0,2,3,3,0,0,3,0
ACSSF,2010e5,wv,000,0034,0005219,155,54,075,15500US5439412075,"Pocahontas County (part), Huntersville CDP, West Virginia",43,43,8,0,0,8,35,0,0,0,0,0,0,0,0,0,0,0,0,0
ACSSF,2010e5,wv,000,0034,0005220,155,54,011,15500US5439460011,"Cabell County (part), Huntington city, West Virginia",10447,6814,2170,678,374,1118,4644,3633,815,455,127,0,328,360,2818,1531,301,331,899,1287
ACSSF,2010e5,wv,000,0034,0005221,155,54,099,15500US5439460099,"Wayne County (part), Huntington city, West Virginia",1009,719,234,41,78,115,485,290,65,44,13,0,31,21,225,110,49,7,54,115
ACSSF,2010e5,wv,000,0034,0005222,155,54,079,15500US5439532079,"Putnam County (part), Hurricane city, West Virginia",1761,1530,652,156,146,350,878,231,40,15,0,0,15,25,191,146,18,68,60,45
ACSSF,2010e5,wv,000,0034,0005223,155,54,083,15500US5439628083,"Randolph County (part), Huttonsville town, West Virginia",31,28,13,3,4,6,15,3,0,0,0,0,0,0,3,3,0,0,3,0
ACSSF,2010e5,wv,000,0034,0005224,155,54,047,15500US5439652047,"McDowell County (part), Iaeger town, West Virginia",77,74,22,2,2,18,52,3,0,0,0,0,0,0,3,3,0,0,3,0
ACSSF,2010e5,wv,000,0034,0005225,155,54,049,15500US5439676049,"Marion County (part), Idamay CDP, West Virginia",165,151,35,35,0,0,116,14,0,0,0,0,0,0,14,0,0,0,0,14
ACSSF,2010e5,wv,000,0034,0005226,155,54,003,15500US5440204003,"Berkeley County (part), Inwood CDP, West Virginia",819,668,217,36,75,106,451,151,87,38,19,19,0,49,64,11,0,0,11,53
ACSSF,2010e5,wv,000,0034,0005227,155,54,109,15500US5440444109,"Wyoming County (part), Itmann CDP, West Virginia",107,107,0,0,0,0,107,0,0,0,0,0,0,0,0,0,0,0,0,0
ACSSF,2010e5,wv,000,0034,0005228,155,54,103,15500US5440636103,"Wetzel County (part), Jacksonburg CDP, West Virginia",15,15,0,0,0,0,15,0,0,0,0,0,0,0,0,0,0,0,0,0
ACSSF,2010e5,wv,000,0034,0005229,155,54,041,15500US5440828041,"Lewis County (part), Jane Lew town, West Virginia",122,97,19,8,0,11,78,25,0,0,0,0,0,0,25,6,0,0,6,19
ACSSF,2010e5,wv,000,0034,0005230,155,54,039,15500US5441010039,"Kanawha County (part), Jefferson CDP, West Virginia",104,51,12,9,3,0,39,53,0,0,0,0,0,0,53,41,3,15,23,12
ACSSF,2010e5,wv,000,0034,0005231,155,54,001,15500US5442244001,"Barbour County (part), Junior town, West Virginia",93,63,22,0,6,16,41,30,16,9,3,0,6,7,14,4,0,0,4,10
ACSSF,2010e5,wv,000,0034,0005232,155,54,059,15500US5442292059,"Mingo County (part), Justice CDP, West Virginia",151,151,71,0,0,71,80,0,0,0,0,0,0,0,0,0,0,0,0,0
ACSSF,2010e5,wv,000,0034,0005233,155,54,099,15500US5443180099,"Wayne County (part), Kenova city, West Virginia",781,522,165,44,26,95,357,259,95,85,0,0,85,10,164,103,53,0,50,61
ACSSF,2010e5,wv,000,0034,0005234,155,54,059,15500US5443300059,"Mingo County (part), Kermit town, West Virginia",199,144,37,16,0,21,107,55,5,0,0,0,0,5,50,12,0,4,8,38
ACSSF,2010e5,wv,000,0034,0005235,155,54,057,15500US5443492057,"Mineral County (part), Keyser city, West Virginia",1284,900,317,72,103,142,583,384,81,58,14,0,44,23,303,163,26,23,114,140
ACSSF,2010e5,wv,000,0034,0005236,155,54,047,15500US5443516047,"McDowell County (part), Keystone city, West Virginia",61,38,16,4,9,3,22,23,6,0,0,0,0,6,17,0,0,0,0,17
ACSSF,2010e5,wv,000,0034,0005237,155,54,047,15500US5443780047,"McDowell County (part), Kimball town, West Virginia",72,50,9,0,0,9,41,22,2,2,2,0,0,0,20,4,0,4,0,16
ACSSF,2010e5,wv,000,0034,0005238,155,54,019,15500US5443828019,"Fayette County (part), Kimberly CDP, West Virginia",90,68,15,0,0,15,53,22,22,0,0,0,0,22,0,0,0,0,0,0
ACSSF,2010e5,wv,000,0034,0005239,155,54,019,15500US5443852019,"Fayette County (part), Kincaid CDP, West Virginia",93,65,15,0,0,15,50,28,0,0,0,0,0,0,28,0,0,0,0,28
ACSSF,2010e5,wv,000,0034,0005240,155,54,077,15500US5444044077,"Preston County (part), Kingwood city, West Virginia",861,680,216,88,39,89,464,181,27,27,0,0,27,0,154,75,0,12,63,79
ACSSF,2010e5,wv,000,0034,0005241,155,54,045,15500US5444188045,"Logan County (part), Kistler CDP, West Virginia",116,45,0,0,0,0,45,71,0,0,0,0,0,0,71,40,0,0,40,31
ACSSF,2010e5,wv,000,0034,0005242,155,54,109,15500US5444548109,"Wyoming County (part), Kopperston CDP, West Virginia",188,174,127,15,29,83,47,14,0,0,0,0,0,0,14,14,0,0,14,0
ACSSF,2010e5,wv,000,0034,0005243,155,54,055,15500US5445292055,"Mercer County (part), Lashmeet CDP, West Virginia",107,107,10,0,0,10,97,0,0,0,0,0,0,0,0,0,0,0,0,0
ACSSF,2010e5,wv,000,0034,0005244,155,54,099,15500US5445580099,"Wayne County (part), Lavalette CDP, West Virginia",196,161,75,12,30,33,86,35,0,0,0,0,0,0,35,0,0,0,0,35
ACSSF,2010e5,wv,000,0034,0005245,155,54,053,15500US5446300053,"Mason County (part), Leon town, West Virginia",46,39,12,0,4,8,27,7,5,5,0,0,5,0,2,0,0,0,0,2
ACSSF,2010e5,wv,000,0034,0005246,155,54,011,15500US5446420011,"Cabell County (part), Lesage CDP, West Virginia",398,316,122,57,0,65,194,82,0,0,0,0,0,0,82,37,26,0,11,45
ACSSF,2010e5,wv,000,0034,0005247,155,54,081,15500US5446468081,"Raleigh County (part), Lester town, West Virginia",84,51,20,0,0,20,31,33,0,0,0,0,0,0,33,15,3,0,12,18
ACSSF,2010e5,wv,000,0034,0005248,155,54,025,15500US5446636025,"Greenbrier County (part), Lewisburg city, West Virginia",996,891,274,97,48,129,617,105,38,0,0,0,0,38,67,28,0,0,28,39
ACSSF,2010e5,wv,000,0034,0005249,155,54,103,15500US5447788103,"Wetzel County (part), Littleton CDP, West Virginia",69,7,3,0,0,3,4,62,21,21,8,13,0,0,41,41,0,0,41,0
ACSSF,2010e5,wv,000,0034,0005250,155,54,045,15500US5448148045,"Logan County (part), Logan city, West Virginia",376,244,102,26,32,44,142,132,24,18,8,0,10,6,108,43,8,10,25,65
ACSSF,2010e5,wv,000,0034,0005251,155,54,033,15500US5448748033,"Harrison County (part), Lost Creek town, West Virginia",133,76,27,0,6,21,49,57,4,4,4,0,0,0,53,29,4,7,18,24
ACSSF,2010e5,wv,000,0034,0005252,155,54,107,15500US5449156107,"Wood County (part), Lubeck CDP, West Virginia",375,274,130,20,11,99,144,101,83,83,31,0,52,0,18,18,0,0,18,0
ACSSF,2010e5,wv,000,0034,0005253,155,54,033,15500US5449252033,"Harrison County (part), Lumberport town, West Virginia",318,200,65,19,0,46,135,118,29,25,15,5,5,4,89,53,4,4,45,36
ACSSF,2010e5,wv,000,0034,0005254,155,54,081,15500US5449492081,"Raleigh County (part), Mabscott town, West Virginia",453,366,148,26,40,82,218,87,28,0,0,0,0,28,59,32,8,6,18,27
ACSSF,2010e5,wv,000,0034,0005255,155,54,081,15500US5449564081,"Raleigh County (part), MacArthur CDP, West Virginia",393,274,58,0,0,58,216,119,52,52,0,0,52,0,67,58,48,10,0,9
ACSSF,2010e5,wv,000,0034,0005256,155,54,045,15500US5449732045,"Logan County (part), McConnell CDP, West Virginia",207,159,45,0,45,0,114,48,0,0,0,0,0,0,48,12,0,0,12,36
ACSSF,2010e5,wv,000,0034,0005257,155,54,051,15500US5450260051,"Marshall County (part), McMechen city, West Virginia",429,329,86,41,19,26,243,100,26,26,6,0,20,0,74,57,28,0,29,17
ACSSF,2010e5,wv,000,0034,0005258,155,54,005,15500US5450524005,"Boone County (part), Madison city, West Virginia",910,681,236,48,64,124,445,229,70,14,0,0,14,56,159,47,7,0,40,112
ACSSF,2010e5,wv,000,0034,0005259,155,54,045,15500US5450860045,"Logan County (part), Mallory CDP, West Virginia",482,446,102,17,0,85,344,36,20,0,0,0,0,20,16,0,0,0,0,16
ACSSF,2010e5,wv,000,0034,0005260,155,54,045,15500US5450932045,"Logan County (part), Man town, West Virginia",340,266,83,20,15,48,183,74,32,24,5,0,19,8,42,3,0,0,3,39
ACSSF,2010e5,wv,000,0034,0005261,155,54,049,15500US5451100049,"Marion County (part), Mannington city, West Virginia",624,455,214,29,48,137,241,169,60,29,0,29,0,31,109,64,21,12,31,45
ACSSF,2010e5,wv,000,0034,0005262,155,54,075,15500US5451676075,"Pocahontas County (part), Marlinton town, West Virginia",365,176,23,4,0,19,153,189,79,36,0,0,36,43,110,78,56,3,19,32
ACSSF,2010e5,wv,000,0034,0005263,155,54,039,15500US5451724039,"Kanawha County (part), Marmet city, West Virginia",454,328,118,16,8,94,210,126,36,4,0,0,4,32,90,54,13,11,30,36
ACSSF,2010e5,wv,000,0034,0005264,155,54,003,15500US5452060003,"Berkeley County (part), Martinsburg city, West Virginia",4206,2739,979,279,226,474,1760,1467,417,327,87,109,131,90,1050,681,337,58,286,369
ACSSF,2010e5,wv,000,0034,0005265,155,54,053,15500US5452180053,"Mason County (part), Mason town, West Virginia",280,188,62,3,5,54,126,92,3,3,3,0,0,0,89,49,19,5,25,40
ACSSF,2010e5,wv,000,0034,0005266,155,54,077,15500US5452228077,"Preston County (part), Masontown town, West Virginia",234,179,80,6,18,56,99,55,14,7,0,7,0,7,41,32,12,14,6,9
ACSSF,2010e5,wv,000,0034,0005267,155,54,059,15500US5452324059,"Mingo County (part), Matewan town, West Virginia",150,90,38,0,0,38,52,60,21,5,0,0,5,16,39,15,5,0,10,24
ACSSF,2010e5,wv,000,0034,0005268,155,54,109,15500US5452372109,"Wyoming County (part), Matheny CDP, West Virginia",172,118,16,16,0,0,102,54,0,0,0,0,0,0,54,12,0,0,12,42
ACSSF,2010e5,wv,000,0034,0005269,155,54,055,15500US5452420055,"Mercer County (part), Matoaka town, West Virginia",55,24,2,0,0,2,22,31,19,16,6,0,10,3,12,0,0,0,0,12
ACSSF,2010e5,wv,000,0034,0005270,155,54,047,15500US5452588047,"McDowell County (part), Maybeury CDP, West Virginia",66,55,29,0,14,15,26,11,0,0,0,0,0,0,11,0,0,0,0,11
ACSSF,2010e5,wv,000,0034,0005271,155,54,019,15500US5452780019,"Fayette County (part), Meadow Bridge town, West Virginia",93,69,11,3,5,3,58,24,0,0,0,0,0,0,24,15,0,7,8,9
ACSSF,2010e5,wv,000,0034,0005272,155,54,095,15500US5453572095,"Tyler County (part), Middlebourne town, West Virginia",220,157,64,10,7,47,93,63,17,8,8,0,0,9,46,15,5,0,10,31
ACSSF,2010e5,wv,000,0034,0005273,155,54,037,15500US5453692037,"Jefferson County (part), Middleway CDP, West Virginia",51,40,9,0,0,9,31,11,0,0,0,0,0,0,11,0,0,0,0,11
ACSSF,2010e5,wv,000,0034,0005274,155,54,083,15500US5454100083,"Randolph County (part), Mill Creek town, West Virginia",176,143,50,0,14,36,93,33,3,3,0,0,3,0,30,13,0,0,13,17
ACSSF,2010e5,wv,000,0034,0005275,155,54,011,15500US5454484011,"Cabell County (part), Milton town, West Virginia",675,497,189,44,70,75,308,178,35,6,6,0,0,29,143,74,19,0,55,69
ACSSF,2010e5,wv,000,0034,0005276,155,54,019,15500US5454508019,"Fayette County (part), Minden CDP, West Virginia",36,18,0,0,0,0,18,18,0,0,0,0,0,0,18,0,0,0,0,18
ACSSF,2010e5,wv,000,0034,0005277,155,54,107,15500US5454580107,"Wood County (part), Mineralwells CDP, West Virginia",495,415,179,0,33,146,236,80,26,0,0,0,0,26,54,41,0,19,22,13
ACSSF,2010e5,wv,000,0034,0005278,155,54,045,15500US5454892045,"Logan County (part), Mitchell Heights town, West Virginia",116,102,32,4,13,15,70,14,2,2,0,0,2,0,12,4,0,0,4,8
ACSSF,2010e5,wv,000,0034,0005279,155,54,045,15500US5455132045,"Logan County (part), Monaville CDP, West Virginia",104,104,39,9,0,30,65,0,0,0,0,0,0,0,0,0,0,0,0,0
ACSSF,2010e5,wv,000,0034,0005280,155,54,049,15500US5455276049,"Marion County (part), Monongah town, West Virginia",373,245,118,16,4,98,127,128,20,0,0,0,0,20,108,82,26,13,43,26
ACSSF,2010e5,wv,000,0034,0005281,155,54,055,15500US5455372055,"Mercer County (part), Montcalm CDP, West Virginia",143,136,33,0,18,15,103,7,0,0,0,0,0,0,7,0,0,0,0,7
ACSSF,2010e5,wv,000,0034,0005282,155,54,019,15500US5455468019,"Fayette County (part), Montgomery city, West Virginia",169,70,28,3,10,15,42,99,9,3,3,0,0,6,90,31,7,10,14,59
ACSSF,2010e5,wv,000,0034,0005283,155,54,039,15500US5455468039,"Kanawha County (part), Montgomery city, West Virginia",179,105,56,0,0,56,49,74,9,4,2,0,2,5,65,50,29,7,14,15
ACSSF,2010e5,wv,000,0034,0005284,155,54,083,15500US5455540083,"Randolph County (part), Montrose town, West Virginia",39,20,6,0,0,6,14,19,4,0,0,0,0,4,15,4,0,0,4,11
ACSSF,2010e5,wv,000,0034,0005285,155,54,031,15500US5455588031,"Hardy County (part), Moorefield town, West Virginia",514,357,66,7,7,52,291,157,18,0,0,0,0,18,139,103,6,38,59,36
ACSSF,2010e5,wv,000,0034,0005286,155,54,061,15500US5455756061,"Monongalia County (part), Morgantown city, West Virginia",3653,2723,897,219,197,481,1826,930,251,119,35,67,17,132,679,347,92,45,210,332
ACSSF,2010e5,wv,000,0034,0005287,155,54,051,15500US5456020051,"Marshall County (part), Moundsville city, West Virginia",2457,1720,473,41,109,323,1247,737,181,103,38,0,65,78,556,287,96,27,164,269
ACSSF,2010e5,wv,000,0034,0005288,155,54,019,15500US5456212019,"Fayette County (part), Mount Carbon CDP, West Virginia",110,110,13,0,0,13,97,0,0,0,0,0,0,0,0,0,0,0,0,0
ACSSF,2010e5,wv,000,0034,0005289,155,54,045,15500US5456342045,"Logan County (part), Mount Gay-Shamrock CDP, West Virginia",459,344,96,15,18,63,248,115,46,12,0,0,12,34,69,15,15,0,0,54
ACSSF,2010e5,wv,000,0034,0005290,155,54,019,15500US5456404019,"Fayette County (part), Mount Hope city, West Virginia",361,232,78,14,21,43,154,129,29,12,0,0,12,17,100,58,33,0,25,42
ACSSF,2010e5,wv,000,0034,0005291,155,54,109,15500US5457148109,"Wyoming County (part), Mullens city, West Virginia",436,321,134,56,24,54,187,115,20,3,0,0,3,17,95,60,34,0,26,35
ACSSF,2010e5,wv,000,0034,0005292,155,54,045,15500US5457916045,"Logan County (part), Neibert CDP, West Virginia",47,47,12,0,0,12,35,0,0,0,0,0,0,0,0,0,0,0,0,0
ACSSF,2010e5,wv,000,0034,0005293,155,54,067,15500US5458180067,"Nicholas County (part), Nettie CDP, West Virginia",266,266,54,0,0,54,212,0,0,0,0,0,0,0,0,0,0,0,0,0
ACSSF,2010e5,wv,000,0034,0005294,155,54,077,15500US5458300077,"Preston County (part), Newburg town, West Virginia",161,135,47,5,20,22,88,26,10,10,6,0,4,0,16,16,11,0,5,0
ACSSF,2010e5,wv,000,0034,0005295,155,54,029,15500US5458372029,"Hancock County (part), New Cumberland city, West Virginia",346,227,78,24,12,42,149,119,53,47,0,16,31,6,66,24,3,0,21,42
ACSSF,2010e5,wv,000,0034,0005296,155,54,029,15500US5458420029,"Hancock County (part), Newell CDP, West Virginia",312,218,53,27,0,26,165,94,29,29,0,0,29,0,65,48,0,0,48,17
ACSSF,2010e5,wv,000,0034,0005297,155,54,053,15500US5458564053,"Mason County (part), New Haven town, West Virginia",516,352,153,55,24,74,199,164,23,18,12,6,0,5,141,88,12,0,76,53
ACSSF,2010e5,wv,000,0034,0005298,155,54,103,15500US5458684103,"Wetzel County (part), New Martinsville city, West Virginia",1367,1122,319,57,62,200,803,245,16,0,0,0,0,16,229,74,17,0,57,155
ACSSF,2010e5,wv,000,0034,0005299,155,54,109,15500US5458756109,"Wyoming County (part), New Richmond CDP, West Virginia",38,38,18,0,18,0,20,0,0,0,0,0,0,0,0,0,0,0,0,0
ACSSF,2010e5,wv,000,0034,0005300,155,54,039,15500US5459068039,"Kanawha County (part), Nitro city, West Virginia",1529,1105,442,121,197,124,663,424,183,125,48,0,77,58,241,141,13,11,117,100
ACSSF,2010e5,wv,000,0034,0005301,155,54,079,15500US5459068079,"Putnam County (part), Nitro city, West Virginia",345,186,42,30,0,12,144,159,48,38,0,0,38,10,111,80,63,0,17,31
ACSSF,2010e5,wv,000,0034,0005302,155,54,047,15500US5459428047,"McDowell County (part), Northfork town, West Virginia",125,46,10,4,0,6,36,79,5,5,0,0,5,0,74,44,8,8,28,30
ACSSF,2010e5,wv,000,0034,0005303,155,54,107,15500US5459458107,"Wood County (part), North Hills town, West Virginia",247,209,91,1,29,61,118,38,30,27,10,0,17,3,8,8,0,0,8,0
ACSSF,2010e5,wv,000,0034,0005304,155,54,033,15500US5459836033,"Harrison County (part), Nutter Fort town, West Virginia",455,357,93,17,0,76,264,98,26,19,0,0,19,7,72,26,0,0,26,46
ACSSF,2010e5,wv,000,0034,0005305,155,54,019,15500US5460028019,"Fayette County (part), Oak Hill city, West Virginia",2304,1674,522,100,124,298,1152,630,202,94,83,0,11,108,428,211,25,33,153,217
ACSSF,2010e5,wv,000,0034,0005306,155,54,055,15500US5460196055,"Mercer County (part), Oakvale town, West Virginia",27,27,3,0,3,0,24,0,0,0,0,0,0,0,0,0,0,0,0,0
ACSSF,2010e5,wv,000,0034,0005307,155,54,109,15500US5460364109,"Wyoming County (part), Oceana town, West Virginia",435,315,115,16,32,67,200,120,28,17,0,0,17,11,92,54,11,18,25,38
ACSSF,2010e5,wv,000,0034,0005308,155,54,045,15500US5460628045,"Logan County (part), Omar CDP, West Virginia",224,163,54,0,20,34,109,61,0,0,0,0,0,0,61,0,0,0,0,61
ACSSF,2010e5,wv,000,0034,0005309,155,54,095,15500US5461636095,"Tyler County (part), Paden City city, West Virginia",251,201,94,9,35,50,107,50,28,23,23,0,0,5,22,22,0,0,22,0
ACSSF,2010e5,wv,000,0034,0005310,155,54,103,15500US5461636103,"Wetzel County (part), Paden City city, West Virginia",466,345,105,20,32,53,240,121,16,7,0,0,7,9,105,69,34,0,35,36
ACSSF,2010e5,wv,000,0034,0005311,155,54,019,15500US5461660019,"Fayette County (part), Page CDP, West Virginia",42,26,0,0,0,0,26,16,0,0,0,0,0,0,16,16,0,0,16,0
ACSSF,2010e5,wv,000,0034,0005312,155,54,047,15500US5461684047,"McDowell County (part), Pageton CDP, West Virginia",40,40,0,0,0,0,40,0,0,0,0,0,0,0,0,0,0,0,0,0
ACSSF,2010e5,wv,000,0034,0005313,155,54,107,15500US5462140107,"Wood County (part), Parkersburg city, West Virginia",8211,5545,1876,368,333,1175,3669,2666,514,333,76,107,150,181,2152,1089,358,123,608,1063
ACSSF,2010e5,wv,000,0034,0005314,155,54,093,15500US5462284093,"Tucker County (part), Parsons city, West Virginia",489,362,149,41,20,88,213,127,30,6,6,0,0,24,97,53,24,21,8,44
ACSSF,2010e5,wv,000,0034,0005315,155,54,065,15500US5462332065,"Morgan County (part), Paw Paw town, West Virginia",92,51,5,0,0,5,46,41,0,0,0,0,0,0,41,23,6,0,17,18
ACSSF,2010e5,wv,000,0034,0005316,155,54,019,15500US5462356019,"Fayette County (part), Pax town, West Virginia",37,29,12,2,0,10,17,8,0,0,0,0,0,0,8,6,2,0,4,2
ACSSF,2010e5,wv,000,0034,0005317,155,54,011,15500US5462488011,"Cabell County (part), Pea Ridge CDP, West Virginia",1672,1447,446,57,153,236,1001,225,53,17,0,0,17,36,172,31,0,0,31,141
ACSSF,2010e5,wv,000,0034,0005318,155,54,085,15500US5462764085,"Ritchie County (part), Pennsboro city, West Virginia",342,213,59,8,14,37,154,129,24,11,0,0,11,13,105,59,10,3,46,46
ACSSF,2010e5,wv,000,0034,0005319,155,54,061,15500US5462788061,"Monongalia County (part), Pentress CDP, West Virginia",58,58,32,19,0,13,26,0,0,0,0,0,0,0,0,0,0,0,0,0
ACSSF,2010e5,wv,000,0034,0005320,155,54,023,15500US5462956023,"Grant County (part), Petersburg city, West Virginia",731,512,163,41,30,92,349,219,65,50,50,0,0,15,154,96,10,0,86,58
ACSSF,2010e5,wv,000,0034,0005321,155,54,063,15500US5463052063,"Monroe County (part), Peterstown town, West Virginia",130,87,48,6,7,35,39,43,7,0,0,0,0,7,36,8,0,3,5,28
ACSSF,2010e5,wv,000,0034,0005322,155,54,001,15500US5463292001,"Barbour County (part), Philippi city, West Virginia",694,483,77,28,20,29,406,211,43,18,0,0,18,25,168,127,31,0,96,41
ACSSF,2010e5,wv,000,0034,0005323,155,54,083,15500US5463484083,"Randolph County (part), Pickens CDP, West Virginia",29,14,0,0,0,0,14,15,0,0,0,0,0,0,15,15,0,0,15,0
ACSSF,2010e5,wv,000,0034,0005324,155,54,057,15500US5463604057,"Mineral County (part), Piedmont town, West Virginia",269,137,54,3,4,47,83,132,22,16,0,12,4,6,110,83,11,19,53,27
ACSSF,2010e5,wv,000,0034,0005325,155,54,039,15500US5463772039,"Kanawha County (part), Pinch CDP, West Virginia",884,769,240,77,74,89,529,115,10,10,10,0,0,0,105,38,0,0,38,67
ACSSF,2010e5,wv,000,0034,0005326,155,54,103,15500US5463892103,"Wetzel County (part), Pine Grove town, West Virginia",136,102,41,6,4,31,61,34,10,7,7,0,0,3,24,13,3,0,10,11
ACSSF,2010e5,wv,000,0034,0005327,155,54,109,15500US5463940109,"Wyoming County (part), Pineville town, West Virginia",241,196,43,12,6,25,153,45,8,0,0,0,0,8,37,19,6,0,13,18
ACSSF,2010e5,wv,000,0034,0005328,155,54,081,15500US5463988081,"Raleigh County (part), Piney View CDP, West Virginia",244,187,40,0,0,40,147,57,41,0,0,0,0,41,16,16,0,0,16,0
ACSSF,2010e5,wv,000,0034,0005329,155,54,049,15500US5464228049,"Marion County (part), Pleasant Valley city, West Virginia",846,648,298,59,98,141,350,198,71,33,8,0,25,38,127,84,14,0,70,43
ACSSF,2010e5,wv,000,0034,0005330,155,54,079,15500US5464516079,"Putnam County (part), Poca town, West Virginia",369,283,84,24,10,50,199,86,18,0,0,0,0,18,68,50,5,12,33,18
ACSSF,2010e5,wv,000,0034,0005331,155,54,053,15500US5464708053,"Mason County (part), Point Pleasant city, West Virginia",1140,797,320,8,118,194,477,343,95,82,9,0,73,13,248,125,57,0,68,123
ACSSF,2010e5,wv,000,0034,0005332,155,54,019,15500US5465284019,"Fayette County (part), Powellton CDP, West Virginia",144,130,29,15,0,14,101,14,0,0,0,0,0,0,14,0,0,0,0,14
ACSSF,2010e5,wv,000,0034,0005333,155,54,039,15500US5465356039,"Kanawha County (part), Pratt town, West Virginia",145,101,42,9,5,28,59,44,10,5,0,0,5,5,34,8,0,0,8,26
ACSSF,2010e5,wv,000,0034,0005334,155,54,099,15500US5465596099,"Wayne County (part), Prichard CDP, West Virginia",116,95,63,0,11,52,32,21,8,0,0,0,0,8,13,13,0,0,13,0
ACSSF,2010e5,wv,000,0034,0005335,155,54,019,15500US5465668019,"Fayette County (part), Prince CDP, West Virginia",74,26,0,0,0,0,26,48,0,0,0,0,0,0,48,34,0,0,34,14
ACSSF,2010e5,wv,000,0034,0005336,155,54,055,15500US5465692055,"Mercer County (part), Princeton city, West Virginia",1721,1237,369,154,28,187,868,484,268,166,0,44,122,102,216,67,23,0,44,149
ACSSF,2010e5,wv,000,0034,0005337,155,54,081,15500US5465836081,"Raleigh County (part), Prosperity CDP, West Virginia",367,183,83,25,0,58,100,184,19,0,0,0,0,19,165,66,39,0,27,99
ACSSF,2010e5,wv,000,0034,0005338,155,54,085,15500US5465956085,"Ritchie County (part), Pullman town, West Virginia",63,55,33,11,3,19,22,8,2,2,0,2,0,0,6,0,0,0,0,6
ACSSF,2010e5,wv,000,0034,0005339,155,54,025,15500US5466412025,"Greenbrier County (part), Quinwood town, West Virginia",93,65,13,0,0,13,52,28,14,10,6,0,4,4,14,10,0,0,10,4
ACSSF,2010e5,wv,000,0034,0005340,155,54,049,15500US5466460049,"Marion County (part), Rachel CDP, West Virginia",47,32,23,0,0,23,9,15,15,15,0,0,15,0,0,0,0,0,0,0
ACSSF,2010e5,wv,000,0034,0005341,155,54,005,15500US5466484005,"Boone County (part), Racine CDP, West Virginia",86,86,32,32,0,0,54,0,0,0,0,0,0,0,0,0,0,0,0,0
ACSSF,2010e5,wv,000,0034,0005342,155,54,025,15500US5466652025,"Greenbrier County (part), Rainelle town, West Virginia",431,310,119,69,0,50,191,121,30,0,0,0,0,30,91,48,18,23,7,43
ACSSF,2010e5,wv,000,0034,0005343,155,54,039,15500US5466892039,"Kanawha County (part), Rand CDP, West Virginia",394,218,22,0,12,10,196,176,35,16,16,0,0,19,141,92,10,49,33,49
ACSSF,2010e5,wv,000,0034,0005344,155,54,037,15500US5466988037,"Jefferson County (part), Ranson corporation, West Virginia",1120,645,278,84,90,104,367,475,126,30,16,0,14,96,349,226,65,51,110,123
ACSSF,2010e5,wv,000,0034,0005345,155,54,035,15500US5467108035,"Jackson County (part), Ravenswood city, West Virginia",1033,769,251,47,65,139,518,264,59,34,17,0,17,25,205,157,22,0,135,48
ACSSF,2010e5,wv,000,0034,0005346,155,54,047,15500US5467228047,"McDowell County (part), Raysal CDP, West Virginia",69,69,0,0,0,0,69,0,0,0,0,0,0,0,0,0,0,0,0,0
ACSSF,2010e5,wv,000,0034,0005347,155,54,103,15500US5467252103,"Wetzel County (part), Reader CDP, West Virginia",202,152,86,36,0,50,66,50,22,22,0,0,22,0,28,28,11,0,17,0
ACSSF,2010e5,wv,000,0034,0005348,155,54,059,15500US5467396059,"Mingo County (part), Red Jacket CDP, West Virginia",205,141,57,11,0,46,84,64,30,30,30,0,0,0,34,34,14,0,20,0
ACSSF,2010e5,wv,000,0034,0005349,155,54,077,15500US5467636077,"Preston County (part), Reedsville town, West Virginia",145,122,52,31,5,16,70,23,0,0,0,0,0,0,23,13,0,0,13,10
ACSSF,2010e5,wv,000,0034,0005350,155,54,087,15500US5467660087,"Roane County (part), Reedy town, West Virginia",31,28,10,0,4,6,18,3,3,0,0,0,0,3,0,0,0,0,0,0
ACSSF,2010e5,wv,000,0034,0005351,155,54,081,15500US5467996081,"Raleigh County (part), Rhodell town, West Virginia",33,21,10,3,0,7,11,12,0,0,0,0,0,0,12,12,0,0,12,0
ACSSF,2010e5,wv,000,0034,0005352,155,54,067,15500US5468116067,"Nicholas County (part), Richwood city, West Virginia",616,426,87,34,34,19,339,190,55,37,8,0,29,18,135,71,18,51,2,64
ACSSF,2010e5,wv,000,0034,0005353,155,54,057,15500US5468260057,"Mineral County (part), Ridgeley town, West Virginia",191,136,39,4,0,35,97,55,20,5,0,4,1,15,35,31,0,0,31,4
ACSSF,2010e5,wv,000,0034,0005354,155,54,035,15500US5468596035,"Jackson County (part), Ripley city, West Virginia",833,691,260,118,34,108,431,142,59,59,17,0,42,0,83,37,11,0,26,46
ACSSF,2010e5,wv,000,0034,0005355,155,54,049,15500US5468908049,"Marion County (part), Rivesville town, West Virginia",328,224,82,14,20,48,142,104,27,10,0,0,10,17,77,43,5,5,33,34
ACSSF,2010e5,wv,000,0034,0005356,155,54,045,15500US5469100045,"Logan County (part), Robinette CDP, West Virginia",118,90,12,0,0,12,78,28,16,0,0,0,0,16,12,12,0,0,12,0
ACSSF,2010e5,wv,000,0034,0005357,155,54,047,15500US5469844047,"McDowell County (part), Roderfield CDP, West Virginia",16,16,0,0,0,0,16,0,0,0,0,0,0,0,0,0,0,0,0,0
ACSSF,2010e5,wv,000,0034,0005358,155,54,027,15500US5470084027,"Hampshire County (part), Romney city, West Virginia",388,287,88,26,16,46,199,101,18,8,0,0,8,10,83,30,0,0,30,53
ACSSF,2010e5,wv,000,0034,0005359,155,54,025,15500US5470156025,"Greenbrier County (part), Ronceverte city, West Virginia",458,348,109,30,30,49,239,110,21,6,0,0,6,15,89,34,12,3,19,55
ACSSF,2010e5,wv,000,0034,0005360,155,54,045,15500US5470468045,"Logan County (part), Rossmore CDP, West Virginia",68,9,0,0,0,0,9,59,17,0,0,0,0,17,42,16,0,16,0,26
ACSSF,2010e5,wv,000,0034,0005361,155,54,077,15500US5470588077,"Preston County (part), Rowlesburg town, West Virginia",185,163,72,18,5,49,91,22,0,0,0,0,0,0,22,18,0,0,18,4
ACSSF,2010e5,wv,000,0034,0005362,155,54,025,15500US5470828025,"Greenbrier County (part), Rupert town, West Virginia",281,167,50,16,3,31,117,114,25,15,0,0,15,10,89,67,8,0,59,22
ACSSF,2010e5,wv,000,0034,0005363,155,54,039,15500US5471212039,"Kanawha County (part), St. Albans city, West Virginia",2937,2200,675,124,93,458,1525,737,254,173,9,0,164,81,483,257,44,21,192,226
ACSSF,2010e5,wv,000,0034,0005364,155,54,073,15500US5471356073,"Pleasants County (part), St. Marys city, West Virginia",510,373,118,18,8,92,255,137,23,7,0,7,0,16,114,64,19,7,38,50
ACSSF,2010e5,wv,000,0034,0005365,155,54,033,15500US5471380033,"Harrison County (part), Salem city, West Virginia",389,269,77,22,7,48,192,120,27,11,7,0,4,16,93,72,18,5,49,21
ACSSF,2010e5,wv,000,0034,0005366,155,54,011,15500US5471476011,"Cabell County (part), Salt Rock CDP, West Virginia",72,72,22,22,0,0,50,0,0,0,0,0,0,0,0,0,0,0,0,0
ACSSF,2010e5,wv,000,0034,0005367,155,54,021,15500US5471620021,"Gilmer County (part), Sand Fork town, West Virginia",85,46,26,5,14,7,20,39,5,5,0,5,0,0,34,13,8,5,0,21
ACSSF,2010e5,wv,000,0034,0005368,155,54,045,15500US5472004045,"Logan County (part), Sarah Ann CDP, West Virginia",32,19,19,0,0,19,0,13,0,0,0,0,0,0,13,0,0,0,0,13
ACSSF,2010e5,wv,000,0034,0005369,155,54,019,15500US5472292019,"Fayette County (part), Scarbro CDP, West Virginia",155,117,18,18,0,0,99,38,0,0,0,0,0,0,38,0,0,0,0,38
ACSSF,2010e5,wv,000,0034,0005370,155,54,081,15500US5473108081,"Raleigh County (part), Shady Spring CDP, West Virginia",889,668,212,89,0,123,456,221,78,64,0,0,64,14,143,96,29,0,67,47
ACSSF,2010e5,wv,000,0034,0005371,155,54,037,15500US5473252037,"Jefferson County (part), Shannondale CDP, West Virginia",697,646,311,77,33,201,335,51,17,17,0,17,0,0,34,34,0,0,34,0
ACSSF,2010e5,wv,000,0034,0005372,155,54,037,15500US5473444037,"Jefferson County (part), Shenandoah Junction CDP, West Virginia",170,114,37,26,0,11,77,56,16,0,0,0,0,16,40,40,0,10,30,0
ACSSF,2010e5,wv,000,0034,0005373,155,54,037,15500US5473468037,"Jefferson County (part), Shepherdstown town, West Virginia",157,109,43,3,6,34,66,48,14,3,0,0,3,11,34,11,4,0,7,23
ACSSF,2010e5,wv,000,0034,0005374,155,54,033,15500US5473636033,"Harrison County (part), Shinnston city, West Virginia",682,523,172,9,56,107,351,159,24,11,0,0,11,13,135,27,17,10,0,108
ACSSF,2010e5,wv,000,0034,0005375,155,54,039,15500US5473876039,"Kanawha County (part), Shrewsbury CDP, West Virginia",229,200,76,0,55,21,124,29,0,0,0,0,0,0,29,0,0,0,0,29
ACSSF,2010e5,wv,000,0034,0005376,155,54,039,15500US5474356039,"Kanawha County (part), Sissonville CDP, West Virginia",1459,1192,401,84,62,255,791,267,37,25,0,8,17,12,230,116,10,34,72,114
ACSSF,2010e5,wv,000,0034,0005377,155,54,095,15500US5474380095,"Tyler County (part), Sistersville city, West Virginia",394,303,94,10,19,65,209,91,11,8,0,3,5,3,80,58,7,0,51,22
ACSSF,2010e5,wv,000,0034,0005378,155,54,019,15500US5474740019,"Fayette County (part), Smithers city, West Virginia",209,75,15,3,0,12,60,134,44,27,22,0,5,17,90,38,5,8,25,52
ACSSF,2010e5,wv,000,0034,0005379,155,54,039,15500US5474740039,"Kanawha County (part), Smithers city, West Virginia",0,0,0,0,0,0,0,0,0,0,0,0,0,0,0,0,0,0,0,0
ACSSF,2010e5,wv,000,0034,0005380,155,54,103,15500US5474788103,"Wetzel County (part), Smithfield town, West Virginia",16,10,4,0,0,4,6,6,0,0,0,0,0,0,6,6,4,2,0,0
ACSSF,2010e5,wv,000,0034,0005381,155,54,081,15500US5475172081,"Raleigh County (part), Sophia town, West Virginia",343,279,105,26,20,59,174,64,0,0,0,0,0,0,64,34,4,13,17,30
ACSSF,2010e5,wv,000,0034,0005382,155,54,039,15500US5475292039,"Kanawha County (part), South Charleston city, West Virginia",3678,2563,782,222,125,435,1781,1115,187,64,7,0,57,123,928,502,155,63,284,426
ACSSF,2010e5,wv,000,0034,0005383,155,54,033,15500US5475796033,"Harrison County (part), Spelter CDP, West Virginia",88,61,30,21,0,9,31,27,0,0,0,0,0,0,27,0,0,0,0,27
ACSSF,2010e5,wv,000,0034,0005384,155,54,087,15500US5475820087,"Roane County (part), Spencer city, West Virginia",608,448,204,23,77,104,244,160,45,20,0,0,20,25,115,23,7,0,16,92
ACSSF,2010e5,wv,000,0034,0005385,155,54,027,15500US5476084027,"Hampshire County (part), Springfield CDP, West Virginia",172,140,50,38,12,0,90,32,0,0,0,0,0,0,32,0,0,0,0,32
ACSSF,2010e5,wv,000,0034,0005386,155,54,081,15500US5476444081,"Raleigh County (part), Stanaford CDP, West Virginia",460,403,215,64,41,110,188,57,40,30,0,0,30,10,17,7,0,0,7,10
ACSSF,2010e5,wv,000,0034,0005387,155,54,061,15500US5476516061,"Monongalia County (part), Star City town, West Virginia",365,249,81,26,26,29,168,116,52,39,21,0,18,13,64,9,0,0,9,55
ACSSF,2010e5,wv,000,0034,0005388,155,54,045,15500US5476996045,"Logan County (part), Stollings CDP, West Virginia",157,123,15,0,15,0,108,34,18,0,0,0,0,18,16,0,0,0,0,16
ACSSF,2010e5,wv,000,0034,0005389,155,54,033,15500US5477188033,"Harrison County (part), Stonewood city, West Virginia",596,432,121,24,37,60,311,164,13,0,0,0,0,13,151,66,8,0,58,85
ACSSF,2010e5,wv,000,0034,0005390,155,54,067,15500US5477980067,"Nicholas County (part), Summersville town, West Virginia",1093,942,319,29,0,290,623,151,39,0,0,0,0,39,112,16,0,0,16,96
ACSSF,2010e5,wv,000,0034,0005391,155,54,007,15500US5478580007,"Braxton County (part), Sutton town, West Virginia",311,194,37,5,8,24,157,117,20,7,0,4,3,13,97,58,20,18,20,39
ACSSF,2010e5,wv,000,0034,0005392,155,54,045,15500US5478796045,"Logan County (part), Switzer CDP, West Virginia",276,194,42,13,15,14,152,82,0,0,0,0,0,0,82,23,23,0,0,59
ACSSF,2010e5,wv,000,0034,0005393,155,54,005,15500US5478964005,"Boone County (part), Sylvester town, West Virginia",42,42,14,8,0,6,28,0,0,0,0,0,0,0,0,0,0,0,0,0
ACSSF,2010e5,wv,000,0034,0005394,155,54,079,15500US5479545079,"Putnam County (part), Teays Valley CDP, West Virginia",3917,3408,1454,371,336,747,1954,509,179,49,0,0,49,130,330,236,33,67,136,94
ACSSF,2010e5,wv,000,0034,0005395,155,54,077,15500US5479708077,"Preston County (part), Terra Alta town, West Virginia",498,340,160,28,34,98,180,158,53,27,22,0,5,26,105,74,19,9,46,31
ACSSF,2010e5,wv,000,0034,0005396,155,54,093,15500US5480020093,"Tucker County (part), Thomas city, West Virginia",132,99,21,3,0,18,78,33,10,0,0,0,0,10,23,18,7,6,5,5
ACSSF,2010e5,wv,000,0034,0005397,155,54,019,15500US5480284019,"Fayette County (part), Thurmond town, West Virginia",2,2,0,0,0,0,2,0,0,0,0,0,0,0,0,0,0,0,0,0
ACSSF,2010e5,wv,000,0034,0005398,155,54,067,15500US5480476067,"Nicholas County (part), Tioga CDP, West Virginia",26,8,0,0,0,0,8,18,0,0,0,0,0,0,18,0,0,0,0,18
ACSSF,2010e5,wv,000,0034,0005399,155,54,069,15500US5480932069,"Ohio County (part), Triadelphia town, West Virginia",249,202,49,19,9,21,153,47,29,19,19,0,0,10,18,18,18,0,0,0
ACSSF,2010e5,wv,000,0034,0005400,155,54,077,15500US5481268077,"Preston County (part), Tunnelton town, West Virginia",95,80,39,11,5,23,41,15,0,0,0,0,0,0,15,10,5,0,5,5
ACSSF,2010e5,wv,000,0034,0005401,155,54,005,15500US5481484005,"Boone County (part), Twilight CDP, West Virginia",0,0,0,0,0,0,0,0,0,0,0,0,0,0,0,0,0,0,0,0
ACSSF,2010e5,wv,000,0034,0005402,155,54,063,15500US5481940063,"Monroe County (part), Union town, West Virginia",125,78,36,5,0,31,42,47,30,17,0,0,17,13,17,8,0,8,0,9
ACSSF,2010e5,wv,000,0034,0005403,155,54,039,15500US5482180039,"Kanawha County (part), Upper Falls CDP, West Virginia",1067,884,313,54,48,211,571,183,23,0,0,0,0,23,160,108,20,35,53,52
ACSSF,2010e5,wv,000,0034,0005404,155,54,083,15500US5482564083,"Randolph County (part), Valley Bend CDP, West Virginia",141,126,86,0,44,42,40,15,0,0,0,0,0,0,15,15,0,15,0,0
ACSSF,2010e5,wv,000,0034,0005405,155,54,069,15500US5482732069,"Ohio County (part), Valley Grove village, West Virginia",115,94,35,5,8,22,59,21,2,0,0,0,0,2,19,19,3,0,16,0
ACSSF,2010e5,wv,000,0034,0005406,155,54,083,15500US5482756083,"Randolph County (part), Valley Head CDP, West Virginia",87,52,34,18,0,16,18,35,0,0,0,0,0,0,35,0,0,0,0,35
ACSSF,2010e5,wv,000,0034,0005407,155,54,005,15500US5482852005,"Boone County (part), Van CDP, West Virginia",62,47,0,0,0,0,47,15,15,0,0,0,0,15,0,0,0,0,0,0
ACSSF,2010e5,wv,000,0034,0005408,155,54,045,15500US5483332045,"Logan County (part), Verdunville CDP, West Virginia",127,127,57,0,0,57,70,0,0,0,0,0,0,0,0,0,0,0,0,0
ACSSF,2010e5,wv,000,0034,0005409,155,54,107,15500US5483500107,"Wood County (part), Vienna city, West Virginia",3016,2548,892,218,178,496,1656,468,150,63,35,0,28,87,318,145,23,10,112,173
ACSSF,2010e5,wv,000,0034,0005410,155,54,047,15500US5483764047,"McDowell County (part), Vivian CDP, West Virginia",17,17,0,0,0,0,17,0,0,0,0,0,0,0,0,0,0,0,0,0
ACSSF,2010e5,wv,000,0034,0005411,155,54,047,15500US5484484047,"McDowell County (part), War city, West Virginia",212,146,47,19,3,25,99,66,19,19,0,0,19,0,47,20,0,4,16,27
ACSSF,2010e5,wv,000,0034,0005412,155,54,031,15500US5484580031,"Hardy County (part), Wardensville town, West Virginia",93,74,22,4,0,18,52,19,6,6,4,0,2,0,13,13,0,4,9,0
ACSSF,2010e5,wv,000,0034,0005413,155,54,107,15500US5484724107,"Wood County (part), Washington CDP, West Virginia",475,440,214,69,38,107,226,35,0,0,0,0,0,0,35,9,0,0,9,26
ACSSF,2010e5,wv,000,0034,0005414,155,54,107,15500US5484916107,"Wood County (part), Waverly CDP, West Virginia",156,141,38,0,0,38,103,15,0,0,0,0,0,0,15,15,0,0,15,0
ACSSF,2010e5,wv,000,0034,0005415,155,54,099,15500US5484940099,"Wayne County (part), Wayne town, West Virginia",484,357,162,62,8,92,195,127,25,0,0,0,0,25,102,67,19,0,48,35
ACSSF,2010e5,wv,000,0034,0005416,155,54,009,15500US5485156009,"Brooke County (part), Weirton city, West Virginia",1059,622,173,11,38,124,449,437,100,11,0,0,11,89,337,238,28,70,140,99
ACSSF,2010e5,wv,000,0034,0005417,155,54,029,15500US5485156029,"Hancock County (part), Weirton city, West Virginia",4471,3161,1028,259,228,541,2133,1310,344,169,83,0,86,175,966,521,67,144,310,445
ACSSF,2010e5,wv,000,0034,0005418,155,54,047,15500US5485228047,"McDowell County (part), Welch city, West Virginia",482,329,109,0,39,70,220,153,33,7,0,0,7,26,120,28,0,0,28,92
ACSSF,2010e5,wv,000,0034,0005419,155,54,009,15500US5485324009,"Brooke County (part), Wellsburg city, West Virginia",693,474,164,7,44,113,310,219,99,92,17,20,55,7,120,102,20,1,81,18
ACSSF,2010e5,wv,000,0034,0005420,155,54,043,15500US5485804043,"Lincoln County (part), West Hamlin town, West Virginia",207,131,41,9,0,32,90,76,10,5,0,0,5,5,66,29,6,0,23,37
ACSSF,2010e5,wv,000,0034,0005421,155,54,069,15500US5485876069,"Ohio County (part), West Liberty town, West Virginia",71,57,8,0,3,5,49,14,4,0,0,0,0,4,10,0,0,0,0,10
ACSSF,2010e5,wv,000,0034,0005422,155,54,045,15500US5485900045,"Logan County (part), West Logan town, West Virginia",124,89,34,12,5,17,55,35,6,3,0,0,3,3,29,15,0,0,15,14
ACSSF,2010e5,wv,000,0034,0005423,155,54,033,15500US5485924033,"Harrison County (part), West Milford town, West Virginia",323,229,87,7,6,74,142,94,16,5,0,0,5,11,78,49,15,0,34,29
ACSSF,2010e5,wv,000,0034,0005424,155,54,041,15500US5485972041,"Lewis County (part), Weston city, West Virginia",1164,841,288,57,30,201,553,323,51,42,13,10,19,9,272,203,33,31,139,69
ACSSF,2010e5,wv,000,0034,0005425,155,54,061,15500US5485996061,"Monongalia County (part), Westover city, West Virginia",981,703,216,45,65,106,487,278,59,19,11,0,8,40,219,146,44,10,92,73
ACSSF,2010e5,wv,000,0034,0005426,155,54,017,15500US5486116017,"Doddridge County (part), West Union town, West Virginia",180,134,42,8,9,25,92,46,16,8,5,3,0,8,30,11,0,0,11,19
ACSSF,2010e5,wv,000,0034,0005427,155,54,051,15500US5486452051,"Marshall County (part), Wheeling city, West Virginia",91,91,66,0,0,66,25,0,0,0,0,0,0,0,0,0,0,0,0,0
ACSSF,2010e5,wv,000,0034,0005428,155,54,069,15500US5486452069,"Ohio County (part), Wheeling city, West Virginia",7116,4994,1617,306,218,1093,3377,2122,364,175,67,0,108,189,1758,929,227,233,469,829
ACSSF,2010e5,wv,000,0034,0005429,155,54,049,15500US5486620049,"Marion County (part), White Hall town, West Virginia",151,128,46,26,6,14,82,23,3,0,0,0,0,3,20,6,3,0,3,14
ACSSF,2010e5,wv,000,0034,0005430,155,54,025,15500US5486812025,"Greenbrier County (part), White Sulphur Springs city, West Virginia",747,455,127,22,46,59,328,292,107,83,0,21,62,24,185,117,38,36,43,68
ACSSF,2010e5,wv,000,0034,0005431,155,54,005,15500US5486836005,"Boone County (part), Whitesville town, West Virginia",141,116,59,8,4,47,57,25,0,0,0,0,0,0,25,11,5,0,6,14
ACSSF,2010e5,wv,000,0034,0005432,155,54,083,15500US5486932083,"Randolph County (part), Whitmer CDP, West Virginia",67,67,50,27,0,23,17,0,0,0,0,0,0,0,0,0,0,0,0,0
ACSSF,2010e5,wv,000,0034,0005433,155,54,057,15500US5487316057,"Mineral County (part), Wiley Ford CDP, West Virginia",246,190,93,9,65,19,97,56,19,0,0,0,0,19,37,5,0,0,5,32
ACSSF,2010e5,wv,000,0034,0005434,155,54,059,15500US5487508059,"Mingo County (part), Williamson city, West Virginia",741,462,135,35,34,66,327,279,7,0,0,0,0,7,272,101,57,15,29,171
ACSSF,2010e5,wv,000,0034,0005435,155,54,107,15500US5487556107,"Wood County (part), Williamstown city, West Virginia",815,649,257,27,24,206,392,166,61,51,0,0,51,10,105,79,0,26,53,26
ACSSF,2010e5,wv,000,0034,0005436,155,54,009,15500US5487892009,"Brooke County (part), Windsor Heights village, West Virginia",109,94,36,16,12,8,58,15,9,3,0,0,3,6,6,2,0,2,0,4
ACSSF,2010e5,wv,000,0034,0005437,155,54,079,15500US5487988079,"Putnam County (part), Winfield town, West Virginia",719,632,327,64,59,204,305,87,15,15,6,0,9,0,72,29,6,0,23,43
ACSSF,2010e5,wv,000,0034,0005438,155,54,033,15500US5488276033,"Harrison County (part), Wolf Summit CDP, West Virginia",67,67,16,0,16,0,51,0,0,0,0,0,0,0,0,0,0,0,0,0
ACSSF,2010e5,wv,000,0034,0005439,155,54,083,15500US5488324083,"Randolph County (part), Womelsdorf (Coalton) town, West Virginia",59,38,12,0,6,6,26,21,11,4,4,0,0,7,10,4,0,0,4,6
ACSSF,2010e5,wv,000,0034,0005440,155,54,049,15500US5488708049,"Marion County (part), Worthington town, West Virginia",61,46,12,8,4,0,34,15,4,0,0,0,0,4,11,6,0,0,6,5
ACSSF,2010e5,wv,000,0034,0005441,160,54,   ,16000US5400196,"Accoville CDP, West Virginia",174,149,65,17,0,48,84,25,0,0,0,0,0,0,25,0,0,0,0,25
ACSSF,2010e5,wv,000,0034,0005442,160,54,   ,16000US5400364,"Addison (Webster Springs) town, West Virginia",319,184,62,7,13,42,122,135,0,0,0,0,0,0,135,62,46,3,13,73
ACSSF,2010e5,wv,000,0034,0005443,160,54,   ,16000US5400748,"Albright town, West Virginia",81,76,37,8,2,27,39,5,0,0,0,0,0,0,5,0,0,0,0,5
ACSSF,2010e5,wv,000,0034,0005444,160,54,   ,16000US5400772,"Alderson town, West Virginia",352,188,64,33,16,15,124,164,51,45,41,0,4,6,113,59,25,5,29,54
ACSSF,2010e5,wv,000,0034,0005445,160,54,   ,16000US5401396,"Alum Creek CDP, West Virginia",345,263,122,37,0,85,141,82,12,12,0,12,0,0,70,13,0,13,0,57
ACSSF,2010e5,wv,000,0034,0005446,160,54,   ,16000US5401660,"Amherstdale CDP, West Virginia",101,40,15,0,0,15,25,61,37,0,0,0,0,37,24,24,24,0,0,0
ACSSF,2010e5,wv,000,0034,0005447,160,54,   ,16000US5401780,"Anawalt town, West Virginia",77,60,12,0,0,12,48,17,6,4,0,0,4,2,11,5,0,5,0,6
ACSSF,2010e5,wv,000,0034,0005448,160,54,   ,16000US5401900,"Anmoore town, West Virginia",302,157,88,55,6,27,69,145,29,19,0,0,19,10,116,87,0,0,87,29
ACSSF,2010e5,wv,000,0034,0005449,160,54,   ,16000US5401996,"Ansted town, West Virginia",445,364,128,42,20,66,236,81,17,3,0,0,3,14,64,40,14,4,22,24
ACSSF,2010e5,wv,000,0034,0005450,160,54,   ,16000US5402188,"Apple Grove CDP, West Virginia",45,22,0,0,0,0,22,23,23,0,0,0,0,23,0,0,0,0,0,0
ACSSF,2010e5,wv,000,0034,0005451,160,54,   ,16000US5403292,"Athens town, West Virginia",180,149,29,7,11,11,120,31,0,0,0,0,0,0,31,22,19,0,3,9
ACSSF,2010e5,wv,000,0034,0005452,160,54,   ,16000US5403364,"Auburn town, West Virginia",21,13,0,0,0,0,13,8,2,0,0,0,0,2,6,5,0,0,5,1
ACSSF,2010e5,wv,000,0034,0005453,160,54,   ,16000US5403460,"Aurora CDP, West Virginia",40,40,30,0,0,30,10,0,0,0,0,0,0,0,0,0,0,0,0,0
ACSSF,2010e5,wv,000,0034,0005454,160,54,   ,16000US5404204,"Bancroft town, West Virginia",50,39,14,0,0,14,25,11,0,0,0,0,0,0,11,0,0,0,0,11
ACSSF,2010e5,wv,000,0034,0005455,160,54,   ,16000US5404276,"Barboursville village, West Virginia",1179,1002,229,63,74,92,773,177,29,13,0,0,13,16,148,102,0,0,102,46
ACSSF,2010e5,wv,000,0034,0005456,160,54,   ,16000US5404612,"Barrackville town, West Virginia",404,315,105,17,20,68,210,89,36,3,0,0,3,33,53,23,11,11,1,30
ACSSF,2010e5,wv,000,0034,0005457,160,54,   ,16000US5404732,"Bartley CDP, West Virginia",21,21,0,0,0,0,21,0,0,0,0,0,0,0,0,0,0,0,0,0
ACSSF,2010e5,wv,000,0034,0005458,160,54,   ,16000US5404780,"Bartow CDP, West Virginia",30,30,0,0,0,0,30,0,0,0,0,0,0,0,0,0,0,0,0,0
ACSSF,2010e5,wv,000,0034,0005459,160,54,   ,16000US5404876,"Bath (Berkeley Springs) town, West Virginia",155,115,44,4,18,22,71,40,2,0,0,0,0,2,38,20,0,6,14,18
ACSSF,2010e5,wv,000,0034,0005460,160,54,   ,16000US5404924,"Bayard town, West Virginia",110,90,43,10,0,33,47,20,4,4,0,0,4,0,16,8,8,0,0,8
ACSSF,2010e5,wv,000,0034,0005461,160,54,   ,16000US5405068,"Beards Fork CDP, West Virginia",52,36,0,0,0,0,36,16,0,0,0,0,0,0,16,0,0,0,0,16
ACSSF,2010e5,wv,000,0034,0005462,160,54,   ,16000US5405260,"Beaver CDP, West Virginia",415,287,89,12,32,45,198,128,65,21,21,0,0,44,63,53,11,0,42,10
ACSSF,2010e5,wv,000,0034,0005463,160,54,   ,16000US5405332,"Beckley city, West Virginia",4451,3043,1033,259,214,560,2010,1408,324,116,30,63,23,208,1084,486,89,53,344,598
ACSSF,2010e5,wv,000,0034,0005464,160,54,   ,16000US5405452,"Beech Bottom village, West Virginia",111,76,22,6,5,11,54,35,7,0,0,0,0,7,28,16,4,0,12,12
ACSSF,2010e5,wv,000,0034,0005465,160,54,   ,16000US5405788,"Belington town, West Virginia",570,409,129,26,22,81,280,161,45,28,9,3,16,17,116,59,3,5,51,57
ACSSF,2010e5,wv,000,0034,0005466,160,54,   ,16000US5405836,"Belle town, West Virginia",326,200,47,5,18,24,153,126,21,19,3,0,16,2,105,52,0,6,46,53
ACSSF,2010e5,wv,000,0034,0005467,160,54,   ,16000US5406004,"Belmont city, West Virginia",213,168,57,3,19,35,111,45,10,0,0,0,0,10,35,15,0,0,15,20
ACSSF,2010e5,wv,000,0034,0005468,160,54,   ,16000US5406052,"Belva CDP, West Virginia",8,0,0,0,0,0,0,8,0,0,0,0,0,0,8,8,0,0,8,0
ACSSF,2010e5,wv,000,0034,0005469,160,54,   ,16000US5406340,"Benwood city, West Virginia",363,230,77,5,28,44,153,133,44,27,0,0,27,17,89,57,8,13,36,32
ACSSF,2010e5,wv,000,0034,0005470,160,54,   ,16000US5406436,"Bergoo CDP, West Virginia",15,0,0,0,0,0,0,15,0,0,0,0,0,0,15,15,0,0,15,0
ACSSF,2010e5,wv,000,0034,0005471,160,54,   ,16000US5406748,"Berwind CDP, West Virginia",54,25,0,0,0,0,25,29,12,0,0,0,0,12,17,17,0,0,17,0
ACSSF,2010e5,wv,000,0034,0005472,160,54,   ,16000US5406844,"Bethany town, West Virginia",115,92,21,4,0,17,71,23,7,7,0,0,7,0,16,0,0,0,0,16
ACSSF,2010e5,wv,000,0034,0005473,160,54,   ,16000US5406940,"Bethlehem village, West Virginia",775,701,243,31,27,185,458,74,15,10,10,0,0,5,59,21,0,15,6,38
ACSSF,2010e5,wv,000,0034,0005474,160,54,   ,16000US5406988,"Beverly town, West Virginia",163,116,44,4,0,40,72,47,10,10,0,0,10,0,37,29,25,0,4,8
ACSSF,2010e5,wv,000,0034,0005475,160,54,   ,16000US5407204,"Big Chimney CDP, West Virginia",179,179,14,0,0,14,165,0,0,0,0,0,0,0,0,0,0,0,0,0
ACSSF,2010e5,wv,000,0034,0005476,160,54,   ,16000US5407228,"Big Creek CDP, West Virginia",58,25,0,0,0,0,25,33,0,0,0,0,0,0,33,0,0,0,0,33
ACSSF,2010e5,wv,000,0034,0005477,160,54,   ,16000US5407516,"Big Sandy CDP, West Virginia",63,63,33,19,0,14,30,0,0,0,0,0,0,0,0,0,0,0,0,0
ACSSF,2010e5,wv,000,0034,0005478,160,54,   ,16000US5407756,"Birch River CDP, West Virginia",72,62,0,0,0,0,62,10,0,0,0,0,0,0,10,0,0,0,0,10
ACSSF,2010e5,wv,000,0034,0005479,160,54,   ,16000US5408092,"Blacksville town, West Virginia",33,21,7,0,3,4,14,12,4,0,0,0,0,4,8,2,0,0,2,6
ACSSF,2010e5,wv,000,0034,0005480,160,54,   ,16000US5408308,"Blennerhassett CDP, West Virginia",941,685,135,19,8,108,550,256,97,19,4,0,15,78,159,57,0,19,38,102
ACSSF,2010e5,wv,000,0034,0005481,160,54,   ,16000US5408524,"Bluefield city, West Virginia",2538,1858,552,83,119,350,1306,680,54,14,0,0,14,40,626,403,107,54,242,223
ACSSF,2010e5,wv,000,0034,0005482,160,54,   ,16000US5408764,"Bluewell CDP, West Virginia",542,414,166,40,17,109,248,128,43,0,0,0,0,43,85,55,17,0,38,30
ACSSF,2010e5,wv,000,0034,0005483,160,54,   ,16000US5408836,"Boaz CDP, West Virginia",504,426,188,44,53,91,238,78,24,24,0,0,24,0,54,54,18,8,28,0
ACSSF,2010e5,wv,000,0034,0005484,160,54,   ,16000US5408932,"Bolivar town, West Virginia",197,162,59,5,9,45,103,35,3,0,0,0,0,3,32,11,3,0,8,21
ACSSF,2010e5,wv,000,0034,0005485,160,54,   ,16000US5408956,"Bolt CDP, West Virginia",156,156,62,20,0,42,94,0,0,0,0,0,0,0,0,0,0,0,0,0
ACSSF,2010e5,wv,000,0034,0005486,160,54,   ,16000US5409100,"Boomer CDP, West Virginia",235,138,36,0,9,27,102,97,66,34,17,0,17,32,31,0,0,0,0,31
ACSSF,2010e5,wv,000,0034,0005487,160,54,   ,16000US5409364,"Bowden CDP, West Virginia",0,0,0,0,0,0,0,0,0,0,0,0,0,0,0,0,0,0,0,0
ACSSF,2010e5,wv,000,0034,0005488,160,54,   ,16000US5409676,"Bradley CDP, West Virginia",555,468,155,73,42,40,313,87,24,12,12,0,0,12,63,63,21,0,42,0
ACSSF,2010e5,wv,000,0034,0005489,160,54,   ,16000US5409700,"Bradshaw town, West Virginia",70,50,15,2,3,10,35,20,8,0,0,0,0,8,12,9,6,0,3,3
ACSSF,2010e5,wv,000,0034,0005490,160,54,   ,16000US5409796,"Bramwell town, West Virginia",113,59,13,2,4,7,46,54,6,4,4,0,0,2,48,10,2,0,8,38
ACSSF,2010e5,wv,000,0034,0005491,160,54,   ,16000US5409844,"Brandonville town, West Virginia",24,15,2,2,0,0,13,9,0,0,0,0,0,0,9,2,0,0,2,7
ACSSF,2010e5,wv,000,0034,0005492,160,54,   ,16000US5409868,"Brandywine CDP, West Virginia",113,99,42,0,31,11,57,14,0,0,0,0,0,0,14,0,0,0,0,14
ACSSF,2010e5,wv,000,0034,0005493,160,54,   ,16000US5409964,"Brenton CDP, West Virginia",53,53,40,0,13,27,13,0,0,0,0,0,0,0,0,0,0,0,0,0
ACSSF,2010e5,wv,000,0034,0005494,160,54,   ,16000US5410180,"Bridgeport city, West Virginia",2306,1900,662,95,161,406,1238,406,137,91,17,0,74,46,269,111,0,22,89,158
ACSSF,2010e5,wv,000,0034,0005495,160,54,   ,16000US5410420,"Brookhaven CDP, West Virginia",1358,949,476,92,118,266,473,409,193,95,58,0,37,98,216,141,81,0,60,75
ACSSF,2010e5,wv,000,0034,0005496,160,54,   ,16000US5410852,"Bruceton Mills town, West Virginia",39,18,11,0,8,3,7,21,9,9,0,0,9,0,12,9,5,0,4,3
ACSSF,2010e5,wv,000,0034,0005497,160,54,   ,16000US5410876,"Bruno CDP, West Virginia",145,126,19,19,0,0,107,19,0,0,0,0,0,0,19,0,0,0,0,19
ACSSF,2010e5,wv,000,0034,0005498,160,54,   ,16000US5410948,"Brush Fork CDP, West Virginia",219,123,39,0,14,25,84,96,9,0,0,0,0,9,87,32,32,0,0,55
ACSSF,2010e5,wv,000,0034,0005499,160,54,   ,16000US5411188,"Buckhannon city, West Virginia",1053,757,312,73,61,178,445,296,14,6,6,0,0,8,282,142,0,58,84,140
ACSSF,2010e5,wv,000,0034,0005500,160,54,   ,16000US5411212,"Bud CDP, West Virginia",64,43,0,0,0,0,43,21,0,0,0,0,0,0,21,21,21,0,0,0
ACSSF,2010e5,wv,000,0034,0005501,160,54,   ,16000US5411284,"Buffalo town, West Virginia",361,276,108,0,3,105,168,85,43,25,6,6,13,18,42,30,9,6,15,12
ACSSF,2010e5,wv,000,0034,0005502,160,54,   ,16000US5411620,"Burlington CDP, West Virginia",0,0,0,0,0,0,0,0,0,0,0,0,0,0,0,0,0,0,0,0
ACSSF,2010e5,wv,000,0034,0005503,160,54,   ,16000US5411716,"Burnsville town, West Virginia",150,101,32,10,0,22,69,49,14,8,0,0,8,6,35,10,0,4,6,25
ACSSF,2010e5,wv,000,0034,0005504,160,54,   ,16000US5412124,"Cairo town, West Virginia",100,71,3,0,0,3,68,29,14,5,0,0,5,9,15,15,0,5,10,0
ACSSF,2010e5,wv,000,0034,0005505,160,54,   ,16000US5412436,"Camden-on-Gauley town, West Virginia",30,16,0,0,0,0,16,14,0,0,0,0,0,0,14,5,1,0,4,9
ACSSF,2010e5,wv,000,0034,0005506,160,54,   ,16000US5412484,"Cameron city, West Virginia",256,197,101,27,27,47,96,59,30,23,23,0,0,7,29,13,5,0,8,16
ACSSF,2010e5,wv,000,0034,0005507,160,54,   ,16000US5413108,"Capon Bridge town, West Virginia",103,55,22,11,6,5,33,48,0,0,0,0,0,0,48,32,0,0,32,16
ACSSF,2010e5,wv,000,0034,0005508,160,54,   ,16000US5413468,"Carolina CDP, West Virginia",110,93,70,9,17,44,23,17,17,0,0,0,0,17,0,0,0,0,0,0
ACSSF,2010e5,wv,000,0034,0005509,160,54,   ,16000US5413525,"Carpendale town, West Virginia",293,254,43,4,4,35,211,39,3,3,0,0,3,0,36,2,0,0,2,34
ACSSF,2010e5,wv,000,0034,0005510,160,54,   ,16000US5413684,"Cass CDP, West Virginia",0,0,0,0,0,0,0,0,0,0,0,0,0,0,0,0,0,0,0,0
ACSSF,2010e5,wv,000,0034,0005511,160,54,   ,16000US5413756,"Cassville CDP, West Virginia",248,248,97,28,53,16,151,0,0,0,0,0,0,0,0,0,0,0,0,0
ACSSF,2010e5,wv,000,0034,0005512,160,54,   ,16000US5413924,"Cedar Grove town, West Virginia",253,155,38,7,12,19,117,98,23,15,0,0,15,8,75,41,7,20,14,34
ACSSF,2010e5,wv,000,0034,0005513,160,54,   ,16000US5414212,"Century CDP, West Virginia",21,21,13,0,0,13,8,0,0,0,0,0,0,0,0,0,0,0,0,0
ACSSF,2010e5,wv,000,0034,0005514,160,54,   ,16000US5414308,"Ceredo city, West Virginia",482,358,69,34,9,26,289,124,56,28,28,0,0,28,68,31,0,0,31,37
ACSSF,2010e5,wv,000,0034,0005515,160,54,   ,16000US5414524,"Chapmanville town, West Virginia",411,323,137,27,32,78,186,88,0,0,0,0,0,0,88,43,13,0,30,45
ACSSF,2010e5,wv,000,0034,0005516,160,54,   ,16000US5414600,"Charleston city, West Virginia",12327,8817,3194,755,521,1918,5623,3510,764,435,102,76,257,329,2746,1577,546,233,798,1169
ACSSF,2010e5,wv,000,0034,0005517,160,54,   ,16000US5414610,"Charles Town city, West Virginia",1142,931,551,189,115,247,380,211,84,40,0,0,40,44,127,0,0,0,0,127
ACSSF,2010e5,wv,000,0034,0005518,160,54,   ,16000US5414630,"Charlton Heights CDP, West Virginia",75,59,19,0,19,0,40,16,0,0,0,0,0,0,16,0,0,0,0,16
ACSSF,2010e5,wv,000,0034,0005519,160,54,   ,16000US5414692,"Chattaroy CDP, West Virginia",256,207,45,28,0,17,162,49,0,0,0,0,0,0,49,32,0,0,32,17
ACSSF,2010e5,wv,000,0034,0005520,160,54,   ,16000US5414716,"Chauncey CDP, West Virginia",177,157,59,20,20,19,98,20,0,0,0,0,0,0,20,0,0,0,0,20
ACSSF,2010e5,wv,000,0034,0005521,160,54,   ,16000US5414775,"Cheat Lake CDP, West Virginia",2042,1792,719,172,161,386,1073,250,78,52,38,0,14,26,172,69,0,5,64,103
ACSSF,2010e5,wv,000,0034,0005522,160,54,   ,16000US5414812,"Chelyan CDP, West Virginia",112,77,0,0,0,0,77,35,0,0,0,0,0,0,35,18,0,0,18,17
ACSSF,2010e5,wv,000,0034,0005523,160,54,   ,16000US5415028,"Chesapeake town, West Virginia",448,305,124,56,11,57,181,143,43,18,9,0,9,25,100,45,0,4,41,55
ACSSF,2010e5,wv,000,0034,0005524,160,54,   ,16000US5415076,"Chester city, West Virginia",666,539,213,40,41,132,326,127,54,54,9,0,45,0,73,37,5,16,16,36
ACSSF,2010e5,wv,000,0034,0005525,160,54,   ,16000US5415628,"Clarksburg city, West Virginia",4157,2786,1056,267,159,630,1730,1371,283,158,12,15,131,125,1088,566,198,97,271,522
ACSSF,2010e5,wv,000,0034,0005526,160,54,   ,16000US5415676,"Clay town, West Virginia",100,84,35,0,0,35,49,16,0,0,0,0,0,0,16,7,0,0,7,9
ACSSF,2010e5,wv,000,0034,0005527,160,54,   ,16000US5415916,"Clearview village, West Virginia",204,178,47,3,6,38,131,26,0,0,0,0,0,0,26,13,9,4,0,13
ACSSF,2010e5,wv,000,0034,0005528,160,54,   ,16000US5416012,"Clendenin town, West Virginia",340,246,89,29,11,49,157,94,7,0,0,0,0,7,87,48,7,14,27,39
ACSSF,2010e5,wv,000,0034,0005529,160,54,   ,16000US5416516,"Coal City CDP, West Virginia",463,348,208,38,35,135,140,115,41,0,0,0,0,41,74,12,0,12,0,62
ACSSF,2010e5,wv,000,0034,0005530,160,54,   ,16000US5416612,"Coal Fork CDP, West Virginia",343,299,62,8,0,54,237,44,0,0,0,0,0,0,44,25,25,0,0,19
ACSSF,2010e5,wv,000,0034,0005531,160,54,   ,16000US5417380,"Comfort CDP, West Virginia",133,122,85,0,0,85,37,11,0,0,0,0,0,0,11,0,0,0,0,11
ACSSF,2010e5,wv,000,0034,0005532,160,54,   ,16000US5417836,"Corinne CDP, West Virginia",98,63,21,0,0,21,42,35,17,17,0,0,17,0,18,18,0,0,18,0
ACSSF,2010e5,wv,000,0034,0005533,160,54,   ,16000US5418388,"Covel CDP, West Virginia",19,19,0,0,0,0,19,0,0,0,0,0,0,0,0,0,0,0,0,0
ACSSF,2010e5,wv,000,0034,0005534,160,54,   ,16000US5418412,"Cowen town, West Virginia",191,129,64,53,7,4,65,62,28,10,0,0,10,18,34,9,0,7,2,25
ACSSF,2010e5,wv,000,0034,0005535,160,54,   ,16000US5418508,"Crab Orchard CDP, West Virginia",825,693,240,45,63,132,453,132,72,25,0,25,0,47,60,0,0,0,0,60
ACSSF,2010e5,wv,000,0034,0005536,160,54,   ,16000US5418604,"Craigsville CDP, West Virginia",836,703,298,91,105,102,405,133,51,21,0,0,21,30,82,44,19,0,25,38
ACSSF,2010e5,wv,000,0034,0005537,160,54,   ,16000US5419108,"Cross Lanes CDP, West Virginia",2496,2024,675,178,98,399,1349,472,111,59,48,0,11,52,361,202,82,11,109,159
ACSSF,2010e5,wv,000,0034,0005538,160,54,   ,16000US5419300,"Crum CDP, West Virginia",37,24,8,0,0,8,16,13,0,0,0,0,0,0,13,0,0,0,0,13
ACSSF,2010e5,wv,000,0034,0005539,160,54,   ,16000US5419324,"Crumpler CDP, West Virginia",61,57,25,0,0,25,32,4,4,4,0,0,4,0,0,0,0,0,0,0
ACSSF,2010e5,wv,000,0034,0005540,160,54,   ,16000US5419492,"Cucumber CDP, West Virginia",35,19,6,6,0,0,13,16,0,0,0,0,0,0,16,16,0,0,16,0
ACSSF,2010e5,wv,000,0034,0005541,160,54,   ,16000US5419516,"Culloden CDP, West Virginia",766,625,278,68,47,163,347,141,58,0,0,0,0,58,83,29,0,0,29,54
ACSSF,2010e5,wv,000,0034,0005542,160,54,   ,16000US5419948,"Dailey CDP, West Virginia",15,15,0,0,0,0,15,0,0,0,0,0,0,0,0,0,0,0,0,0
ACSSF,2010e5,wv,000,0034,0005543,160,54,   ,16000US5420164,"Daniels CDP, West Virginia",442,392,83,7,34,42,309,50,0,0,0,0,0,0,50,38,38,0,0,12
ACSSF,2010e5,wv,000,0034,0005544,160,54,   ,16000US5420212,"Danville town, West Virginia",245,197,73,6,13,54,124,48,6,6,0,0,6,0,42,28,0,9,19,14
ACSSF,2010e5,wv,000,0034,0005545,160,54,   ,16000US5420428,"Davis town, West Virginia",146,116,35,14,4,17,81,30,10,5,0,0,5,5,20,0,0,0,0,20
ACSSF,2010e5,wv,000,0034,0005546,160,54,   ,16000US5420500,"Davy town, West Virginia",94,84,7,7,0,0,77,10,0,0,0,0,0,0,10,0,0,0,0,10
ACSSF,2010e5,wv,000,0034,0005547,160,54,   ,16000US5420764,"Deep Water CDP, West Virginia",35,13,13,0,0,13,0,22,12,0,0,0,0,12,10,10,0,0,10,0
ACSSF,2010e5,wv,000,0034,0005548,160,54,   ,16000US5420980,"Delbarton town, West Virginia",263,210,96,8,26,62,114,53,14,0,0,0,0,14,39,12,0,5,7,27
ACSSF,2010e5,wv,000,0034,0005549,160,54,   ,16000US5421316,"Despard CDP, West Virginia",216,120,39,0,27,12,81,96,0,0,0,0,0,0,96,46,0,0,46,50
ACSSF,2010e5,wv,000,0034,0005550,160,54,   ,16000US5421628,"Dixie CDP, West Virginia",108,108,53,0,0,53,55,0,0,0,0,0,0,0,0,0,0,0,0,0
ACSSF,2010e5,wv,000,0034,0005551,160,54,   ,16000US5422564,"Dunbar city, West Virginia",2139,1435,418,94,61,263,1017,704,100,18,9,0,9,82,604,309,73,41,195,295
ACSSF,2010e5,wv,000,0034,0005552,160,54,   ,16000US5422852,"Durbin town, West Virginia",88,63,5,0,0,5,58,25,8,6,0,0,6,2,17,11,11,0,0,6
ACSSF,2010e5,wv,000,0034,0005553,160,54,   ,16000US5423092,"East Bank town, West Virginia",303,176,40,16,0,24,136,127,33,20,15,0,5,13,94,65,9,33,23,29
ACSSF,2010e5,wv,000,0034,0005554,160,54,   ,16000US5423140,"East Dailey CDP, West Virginia",150,138,56,22,34,0,82,12,12,0,0,0,0,12,0,0,0,0,0,0
ACSSF,2010e5,wv,000,0034,0005555,160,54,   ,16000US5423644,"Eccles CDP, West Virginia",118,64,64,14,0,50,0,54,23,23,0,0,23,0,31,0,0,0,0,31
ACSSF,2010e5,wv,000,0034,0005556,160,54,   ,16000US5424292,"Eleanor town, West Virginia",501,402,154,27,36,91,248,99,6,0,0,0,0,6,93,45,4,0,41,48
ACSSF,2010e5,wv,000,0034,0005557,160,54,   ,16000US5424364,"Elizabeth town, West Virginia",341,215,79,0,30,49,136,126,39,31,14,0,17,8,87,79,17,12,50,8
ACSSF,2010e5,wv,000,0034,0005558,160,54,   ,16000US5424484,"Elk Garden town, West Virginia",80,50,18,3,8,7,32,30,11,3,0,0,3,8,19,14,0,0,14,5
ACSSF,2010e5,wv,000,0034,0005559,160,54,   ,16000US5424580,"Elkins city, West Virginia",1699,1238,487,63,48,376,751,461,103,79,47,5,27,24,358,238,39,82,117,120
ACSSF,2010e5,wv,000,0034,0005560,160,54,   ,16000US5424748,"Elkview CDP, West Virginia",408,346,100,22,20,58,246,62,12,0,0,0,0,12,50,0,0,0,0,50
ACSSF,2010e5,wv,000,0034,0005561,160,54,   ,16000US5424844,"Ellenboro town, West Virginia",164,138,23,0,2,21,115,26,2,0,0,0,0,2,24,18,0,0,18,6
ACSSF,2010e5,wv,000,0034,0005562,160,54,   ,16000US5425516,"Enterprise CDP, West Virginia",343,222,54,0,20,34,168,121,24,0,0,0,0,24,97,19,19,0,0,78
ACSSF,2010e5,wv,000,0034,0005563,160,54,   ,16000US5426428,"Fairlea CDP, West Virginia",614,460,200,96,66,38,260,154,43,0,0,0,0,43,111,42,0,42,0,69
ACSSF,2010e5,wv,000,0034,0005564,160,54,   ,16000US5426452,"Fairmont city, West Virginia",4310,2906,900,220,162,518,2006,1404,332,233,18,0,215,99,1072,578,187,92,299,494
ACSSF,2010e5,wv,000,0034,0005565,160,54,   ,16000US5426524,"Fairview town, West Virginia",110,85,41,5,6,30,44,25,9,5,5,0,0,4,16,10,2,0,8,6
ACSSF,2010e5,wv,000,0034,0005566,160,54,   ,16000US5426692,"Falling Spring town, West Virginia",51,45,11,0,4,7,34,6,3,3,0,3,0,0,3,0,0,0,0,3
ACSSF,2010e5,wv,000,0034,0005567,160,54,   ,16000US5426716,"Falling Waters CDP, West Virginia",233,216,84,0,64,20,132,17,2,0,0,0,0,2,15,8,0,0,8,7
ACSSF,2010e5,wv,000,0034,0005568,160,54,   ,16000US5426812,"Falls View CDP, West Virginia",42,25,0,0,0,0,25,17,17,0,0,0,0,17,0,0,0,0,0,0
ACSSF,2010e5,wv,000,0034,0005569,160,54,   ,16000US5426932,"Farmington town, West Virginia",92,64,18,8,2,8,46,28,2,0,0,0,0,2,26,10,0,0,10,16
ACSSF,2010e5,wv,000,0034,0005570,160,54,   ,16000US5427028,"Fayetteville town, West Virginia",755,579,243,37,47,159,336,176,80,35,0,5,30,45,96,48,0,13,35,48
ACSSF,2010e5,wv,000,0034,0005571,160,54,   ,16000US5427196,"Fenwick CDP, West Virginia",50,28,14,0,0,14,14,22,0,0,0,0,0,0,22,0,0,0,0,22
ACSSF,2010e5,wv,000,0034,0005572,160,54,   ,16000US5427868,"Flatwoods town, West Virginia",38,34,9,0,3,6,25,4,0,0,0,0,0,0,4,0,0,0,0,4
ACSSF,2010e5,wv,000,0034,0005573,160,54,   ,16000US5427940,"Flemington town, West Virginia",91,68,27,0,12,15,41,23,7,4,0,0,4,3,16,6,0,0,6,10
ACSSF,2010e5,wv,000,0034,0005574,160,54,   ,16000US5428204,"Follansbee city, West Virginia",822,643,155,12,45,98,488,179,73,39,29,0,10,34,106,57,0,0,57,49
ACSSF,2010e5,wv,000,0034,0005575,160,54,   ,16000US5428444,"Fort Ashby CDP, West Virginia",539,492,194,25,78,91,298,47,0,0,0,0,0,0,47,47,17,0,30,0
ACSSF,2010e5,wv,000,0034,0005576,160,54,   ,16000US5428516,"Fort Gay town, West Virginia",206,140,47,4,23,20,93,66,23,8,0,0,8,15,43,14,0,0,14,29
ACSSF,2010e5,wv,000,0034,0005577,160,54,   ,16000US5428948,"Frank CDP, West Virginia",56,56,56,0,0,56,0,0,0,0,0,0,0,0,0,0,0,0,0,0
ACSSF,2010e5,wv,000,0034,0005578,160,54,   ,16000US5429044,"Franklin town, West Virginia",212,133,57,16,9,32,76,79,3,0,0,0,0,3,76,25,9,0,16,51
ACSSF,2010e5,wv,000,0034,0005579,160,54,   ,16000US5429404,"Friendly town, West Virginia",33,30,15,6,4,5,15,3,0,0,0,0,0,0,3,0,0,0,0,3
ACSSF,2010e5,wv,000,0034,0005580,160,54,   ,16000US5429716,"Gallipolis Ferry CDP, West Virginia",307,242,39,6,0,33,203,65,7,0,0,0,0,7,58,46,0,34,12,12
ACSSF,2010e5,wv,000,0034,0005581,160,54,   ,16000US5429740,"Galloway CDP, West Virginia",51,28,0,0,0,0,28,23,0,0,0,0,0,0,23,23,0,0,23,0
ACSSF,2010e5,wv,000,0034,0005582,160,54,   ,16000US5430196,"Gary city, West Virginia",233,148,30,20,0,10,118,85,0,0,0,0,0,0,85,35,0,15,20,50
ACSSF,2010e5,wv,000,0034,0005583,160,54,   ,16000US5430220,"Gassaway town, West Virginia",217,169,52,15,8,29,117,48,0,0,0,0,0,0,48,39,18,3,18,9
ACSSF,2010e5,wv,000,0034,0005584,160,54,   ,16000US5430364,"Gauley Bridge town, West Virginia",175,102,27,0,3,24,75,73,9,0,0,0,0,9,64,42,11,6,25,22
ACSSF,2010e5,wv,000,0034,0005585,160,54,   ,16000US5430724,"Ghent CDP, West Virginia",166,134,21,0,21,0,113,32,0,0,0,0,0,0,32,0,0,0,0,32
ACSSF,2010e5,wv,000,0034,0005586,160,54,   ,16000US5430772,"Gilbert town, West Virginia",104,88,28,12,0,16,60,16,5,0,0,0,0,5,11,3,0,0,3,8
ACSSF,2010e5,wv,000,0034,0005587,160,54,   ,16000US5430777,"Gilbert Creek CDP, West Virginia",535,476,123,78,0,45,353,59,26,26,0,0,26,0,33,33,19,0,14,0
ACSSF,2010e5,wv,000,0034,0005588,160,54,   ,16000US5431324,"Glasgow town, West Virginia",180,150,55,13,18,24,95,30,10,0,0,0,0,10,20,13,4,9,0,7
ACSSF,2010e5,wv,000,0034,0005589,160,54,   ,16000US5431492,"Glen Dale city, West Virginia",487,391,134,45,13,76,257,96,49,29,3,0,26,20,47,15,0,0,15,32
ACSSF,2010e5,wv,000,0034,0005590,160,54,   ,16000US5431732,"Glen Ferris CDP, West Virginia",15,15,15,0,0,15,0,0,0,0,0,0,0,0,0,0,0,0,0,0
ACSSF,2010e5,wv,000,0034,0005591,160,54,   ,16000US5431756,"Glen Fork CDP, West Virginia",39,39,0,0,0,0,39,0,0,0,0,0,0,0,0,0,0,0,0,0
ACSSF,2010e5,wv,000,0034,0005592,160,54,   ,16000US5431876,"Glen Jean CDP, West Virginia",89,55,0,0,0,0,55,34,0,0,0,0,0,0,34,0,0,0,0,34
ACSSF,2010e5,wv,000,0034,0005593,160,54,   ,16000US5432044,"Glenville town, West Virginia",325,189,104,13,17,74,85,136,25,8,0,0,8,17,111,41,3,23,15,70
ACSSF,2010e5,wv,000,0034,0005594,160,54,   ,16000US5432068,"Glen White CDP, West Virginia",0,0,0,0,0,0,0,0,0,0,0,0,0,0,0,0,0,0,0,0
ACSSF,2010e5,wv,000,0034,0005595,160,54,   ,16000US5432716,"Grafton city, West Virginia",1355,808,277,45,50,182,531,547,95,19,0,0,19,76,452,282,11,88,183,170
ACSSF,2010e5,wv,000,0034,0005596,160,54,   ,16000US5432884,"Grantsville town, West Virginia",198,144,58,8,25,25,86,54,31,0,0,0,0,31,23,3,3,0,0,20
ACSSF,2010e5,wv,000,0034,0005597,160,54,   ,16000US5432908,"Grant Town town, West Virginia",135,88,38,14,3,21,50,47,19,0,0,0,0,19,28,12,0,0,12,16
ACSSF,2010e5,wv,000,0034,0005598,160,54,   ,16000US5432932,"Granville town, West Virginia",146,114,30,4,0,26,84,32,15,5,0,5,0,10,17,5,0,0,5,12
ACSSF,2010e5,wv,000,0034,0005599,160,54,   ,16000US5433100,"Great Cacapon CDP, West Virginia",107,92,33,0,13,20,59,15,0,0,0,0,0,0,15,0,0,0,0,15
ACSSF,2010e5,wv,000,0034,0005600,160,54,   ,16000US5433124,"Green Bank CDP, West Virginia",32,32,24,24,0,0,8,0,0,0,0,0,0,0,0,0,0,0,0,0
ACSSF,2010e5,wv,000,0034,0005601,160,54,   ,16000US5433436,"Green Spring CDP, West Virginia",43,43,13,0,0,13,30,0,0,0,0,0,0,0,0,0,0,0,0,0
ACSSF,2010e5,wv,000,0034,0005602,160,54,   ,16000US5433580,"Greenview CDP, West Virginia",117,81,32,0,32,0,49,36,0,0,0,0,0,0,36,36,0,0,36,0
ACSSF,2010e5,wv,000,0034,0005603,160,54,   ,16000US5434180,"Gypsy CDP, West Virginia",18,0,0,0,0,0,0,18,0,0,0,0,0,0,18,0,0,0,0,18
ACSSF,2010e5,wv,000,0034,0005604,160,54,   ,16000US5434492,"Hambleton town, West Virginia",70,63,20,3,8,9,43,7,7,3,0,0,3,4,0,0,0,0,0,0
ACSSF,2010e5,wv,000,0034,0005605,160,54,   ,16000US5434516,"Hamlin town, West Virginia",312,178,70,25,13,32,108,134,29,19,8,0,11,10,105,62,22,3,37,43
ACSSF,2010e5,wv,000,0034,0005606,160,54,   ,16000US5434756,"Handley town, West Virginia",47,34,12,2,4,6,22,13,2,0,0,0,0,2,11,3,3,0,0,8
ACSSF,2010e5,wv,000,0034,0005607,160,54,   ,16000US5435092,"Harman town, West Virginia",43,22,3,3,0,0,19,21,4,4,0,0,4,0,17,14,5,0,9,3
ACSSF,2010e5,wv,000,0034,0005608,160,54,   ,16000US5435284,"Harpers Ferry town, West Virginia",60,60,14,9,0,5,46,0,0,0,0,0,0,0,0,0,0,0,0,0
ACSSF,2010e5,wv,000,0034,0005609,160,54,   ,16000US5435428,"Harrisville town, West Virginia",606,433,179,21,47,111,254,173,32,14,6,0,8,18,141,96,29,11,56,45
ACSSF,2010e5,wv,000,0034,0005610,160,54,   ,16000US5435500,"Hartford City town, West Virginia",206,146,69,25,13,31,77,60,22,4,0,0,4,18,38,21,0,0,21,17
ACSSF,2010e5,wv,000,0034,0005611,160,54,   ,16000US5435596,"Harts CDP, West Virginia",309,186,59,13,17,29,127,123,16,0,0,0,0,16,107,74,9,0,65,33
ACSSF,2010e5,wv,000,0034,0005612,160,54,   ,16000US5436220,"Hedgesville town, West Virginia",63,47,26,2,3,21,21,16,3,0,0,0,0,3,13,10,4,2,4,3
ACSSF,2010e5,wv,000,0034,0005613,160,54,   ,16000US5436292,"Helen CDP, West Virginia",18,18,0,0,0,0,18,0,0,0,0,0,0,0,0,0,0,0,0,0
ACSSF,2010e5,wv,000,0034,0005614,160,54,   ,16000US5436340,"Helvetia CDP, West Virginia",4,4,0,0,0,0,4,0,0,0,0,0,0,0,0,0,0,0,0,0
ACSSF,2010e5,wv,000,0034,0005615,160,54,   ,16000US5436436,"Henderson town, West Virginia",51,26,9,4,0,5,17,25,5,3,0,3,0,2,20,19,6,4,9,1
ACSSF,2010e5,wv,000,0034,0005616,160,54,   ,16000US5436460,"Hendricks town, West Virginia",101,88,35,7,8,20,53,13,2,2,2,0,0,0,11,0,0,0,0,11
ACSSF,2010e5,wv,000,0034,0005617,160,54,   ,16000US5436484,"Henlawson CDP, West Virginia",154,114,0,0,0,0,114,40,19,0,0,0,0,19,21,0,0,0,0,21
ACSSF,2010e5,wv,000,0034,0005618,160,54,   ,16000US5436628,"Hepzibah CDP, West Virginia",192,179,49,0,21,28,130,13,13,13,13,0,0,0,0,0,0,0,0,0
ACSSF,2010e5,wv,000,0034,0005619,160,54,   ,16000US5437036,"Hico CDP, West Virginia",60,50,16,0,0,16,34,10,0,0,0,0,0,0,10,0,0,0,0,10
ACSSF,2010e5,wv,000,0034,0005620,160,54,   ,16000US5437372,"Hillsboro town, West Virginia",67,56,36,23,4,9,20,11,0,0,0,0,0,0,11,8,0,0,8,3
ACSSF,2010e5,wv,000,0034,0005621,160,54,   ,16000US5437444,"Hilltop CDP, West Virginia",132,54,17,0,0,17,37,78,0,0,0,0,0,0,78,69,0,0,69,9
ACSSF,2010e5,wv,000,0034,0005622,160,54,   ,16000US5437636,"Hinton city, West Virginia",560,346,149,25,14,110,197,214,69,49,19,0,30,20,145,45,0,0,45,100
ACSSF,2010e5,wv,000,0034,0005623,160,54,   ,16000US5437948,"Holden CDP, West Virginia",185,121,97,47,21,29,24,64,0,0,0,0,0,0,64,27,0,0,27,37
ACSSF,2010e5,wv,000,0034,0005624,160,54,   ,16000US5438260,"Hometown CDP, West Virginia",238,172,18,0,0,18,154,66,0,0,0,0,0,0,66,36,36,0,0,30
ACSSF,2010e5,wv,000,0034,0005625,160,54,   ,16000US5438476,"Hooverson Heights CDP, West Virginia",821,657,244,37,61,146,413,164,61,27,0,0,27,34,103,48,23,9,16,55
ACSSF,2010e5,wv,000,0034,0005626,160,54,   ,16000US5439340,"Hundred town, West Virginia",78,73,27,5,3,19,46,5,2,0,0,0,0,2,3,3,0,0,3,0
ACSSF,2010e5,wv,000,0034,0005627,160,54,   ,16000US5439412,"Huntersville CDP, West Virginia",43,43,8,0,0,8,35,0,0,0,0,0,0,0,0,0,0,0,0,0
ACSSF,2010e5,wv,000,0034,0005628,160,54,   ,16000US5439460,"Huntington city, West Virginia",11456,7533,2404,719,452,1233,5129,3923,880,499,140,0,359,381,3043,1641,350,338,953,1402
ACSSF,2010e5,wv,000,0034,0005629,160,54,   ,16000US5439532,"Hurricane city, West Virginia",1761,1530,652,156,146,350,878,231,40,15,0,0,15,25,191,146,18,68,60,45
ACSSF,2010e5,wv,000,0034,0005630,160,54,   ,16000US5439628,"Huttonsville town, West Virginia",31,28,13,3,4,6,15,3,0,0,0,0,0,0,3,3,0,0,3,0
ACSSF,2010e5,wv,000,0034,0005631,160,54,   ,16000US5439652,"Iaeger town, West Virginia",77,74,22,2,2,18,52,3,0,0,0,0,0,0,3,3,0,0,3,0
ACSSF,2010e5,wv,000,0034,0005632,160,54,   ,16000US5439676,"Idamay CDP, West Virginia",165,151,35,35,0,0,116,14,0,0,0,0,0,0,14,0,0,0,0,14
ACSSF,2010e5,wv,000,0034,0005633,160,54,   ,16000US5440204,"Inwood CDP, West Virginia",819,668,217,36,75,106,451,151,87,38,19,19,0,49,64,11,0,0,11,53
ACSSF,2010e5,wv,000,0034,0005634,160,54,   ,16000US5440444,"Itmann CDP, West Virginia",107,107,0,0,0,0,107,0,0,0,0,0,0,0,0,0,0,0,0,0
ACSSF,2010e5,wv,000,0034,0005635,160,54,   ,16000US5440636,"Jacksonburg CDP, West Virginia",15,15,0,0,0,0,15,0,0,0,0,0,0,0,0,0,0,0,0,0
ACSSF,2010e5,wv,000,0034,0005636,160,54,   ,16000US5440828,"Jane Lew town, West Virginia",122,97,19,8,0,11,78,25,0,0,0,0,0,0,25,6,0,0,6,19
ACSSF,2010e5,wv,000,0034,0005637,160,54,   ,16000US5441010,"Jefferson CDP, West Virginia",104,51,12,9,3,0,39,53,0,0,0,0,0,0,53,41,3,15,23,12
ACSSF,2010e5,wv,000,0034,0005638,160,54,   ,16000US5442244,"Junior town, West Virginia",93,63,22,0,6,16,41,30,16,9,3,0,6,7,14,4,0,0,4,10
ACSSF,2010e5,wv,000,0034,0005639,160,54,   ,16000US5442292,"Justice CDP, West Virginia",151,151,71,0,0,71,80,0,0,0,0,0,0,0,0,0,0,0,0,0
ACSSF,2010e5,wv,000,0034,0005640,160,54,   ,16000US5443180,"Kenova city, West Virginia",781,522,165,44,26,95,357,259,95,85,0,0,85,10,164,103,53,0,50,61
ACSSF,2010e5,wv,000,0034,0005641,160,54,   ,16000US5443300,"Kermit town, West Virginia",199,144,37,16,0,21,107,55,5,0,0,0,0,5,50,12,0,4,8,38
ACSSF,2010e5,wv,000,0034,0005642,160,54,   ,16000US5443492,"Keyser city, West Virginia",1284,900,317,72,103,142,583,384,81,58,14,0,44,23,303,163,26,23,114,140
ACSSF,2010e5,wv,000,0034,0005643,160,54,   ,16000US5443516,"Keystone city, West Virginia",61,38,16,4,9,3,22,23,6,0,0,0,0,6,17,0,0,0,0,17
ACSSF,2010e5,wv,000,0034,0005644,160,54,   ,16000US5443780,"Kimball town, West Virginia",72,50,9,0,0,9,41,22,2,2,2,0,0,0,20,4,0,4,0,16
ACSSF,2010e5,wv,000,0034,0005645,160,54,   ,16000US5443828,"Kimberly CDP, West Virginia",90,68,15,0,0,15,53,22,22,0,0,0,0,22,0,0,0,0,0,0
ACSSF,2010e5,wv,000,0034,0005646,160,54,   ,16000US5443852,"Kincaid CDP, West Virginia",93,65,15,0,0,15,50,28,0,0,0,0,0,0,28,0,0,0,0,28
ACSSF,2010e5,wv,000,0034,0005647,160,54,   ,16000US5444044,"Kingwood city, West Virginia",861,680,216,88,39,89,464,181,27,27,0,0,27,0,154,75,0,12,63,79
ACSSF,2010e5,wv,000,0034,0005648,160,54,   ,16000US5444188,"Kistler CDP, West Virginia",116,45,0,0,0,0,45,71,0,0,0,0,0,0,71,40,0,0,40,31
ACSSF,2010e5,wv,000,0034,0005649,160,54,   ,16000US5444548,"Kopperston CDP, West Virginia",188,174,127,15,29,83,47,14,0,0,0,0,0,0,14,14,0,0,14,0
ACSSF,2010e5,wv,000,0034,0005650,160,54,   ,16000US5445292,"Lashmeet CDP, West Virginia",107,107,10,0,0,10,97,0,0,0,0,0,0,0,0,0,0,0,0,0
ACSSF,2010e5,wv,000,0034,0005651,160,54,   ,16000US5445580,"Lavalette CDP, West Virginia",196,161,75,12,30,33,86,35,0,0,0,0,0,0,35,0,0,0,0,35
ACSSF,2010e5,wv,000,0034,0005652,160,54,   ,16000US5446300,"Leon town, West Virginia",46,39,12,0,4,8,27,7,5,5,0,0,5,0,2,0,0,0,0,2
ACSSF,2010e5,wv,000,0034,0005653,160,54,   ,16000US5446420,"Lesage CDP, West Virginia",398,316,122,57,0,65,194,82,0,0,0,0,0,0,82,37,26,0,11,45
ACSSF,2010e5,wv,000,0034,0005654,160,54,   ,16000US5446468,"Lester town, West Virginia",84,51,20,0,0,20,31,33,0,0,0,0,0,0,33,15,3,0,12,18
ACSSF,2010e5,wv,000,0034,0005655,160,54,   ,16000US5446636,"Lewisburg city, West Virginia",996,891,274,97,48,129,617,105,38,0,0,0,0,38,67,28,0,0,28,39
ACSSF,2010e5,wv,000,0034,0005656,160,54,   ,16000US5447788,"Littleton CDP, West Virginia",69,7,3,0,0,3,4,62,21,21,8,13,0,0,41,41,0,0,41,0
ACSSF,2010e5,wv,000,0034,0005657,160,54,   ,16000US5448148,"Logan city, West Virginia",376,244,102,26,32,44,142,132,24,18,8,0,10,6,108,43,8,10,25,65
ACSSF,2010e5,wv,000,0034,0005658,160,54,   ,16000US5448748,"Lost Creek town, West Virginia",133,76,27,0,6,21,49,57,4,4,4,0,0,0,53,29,4,7,18,24
ACSSF,2010e5,wv,000,0034,0005659,160,54,   ,16000US5449156,"Lubeck CDP, West Virginia",375,274,130,20,11,99,144,101,83,83,31,0,52,0,18,18,0,0,18,0
ACSSF,2010e5,wv,000,0034,0005660,160,54,   ,16000US5449252,"Lumberport town, West Virginia",318,200,65,19,0,46,135,118,29,25,15,5,5,4,89,53,4,4,45,36
ACSSF,2010e5,wv,000,0034,0005661,160,54,   ,16000US5449492,"Mabscott town, West Virginia",453,366,148,26,40,82,218,87,28,0,0,0,0,28,59,32,8,6,18,27
ACSSF,2010e5,wv,000,0034,0005662,160,54,   ,16000US5449564,"MacArthur CDP, West Virginia",393,274,58,0,0,58,216,119,52,52,0,0,52,0,67,58,48,10,0,9
ACSSF,2010e5,wv,000,0034,0005663,160,54,   ,16000US5449732,"McConnell CDP, West Virginia",207,159,45,0,45,0,114,48,0,0,0,0,0,0,48,12,0,0,12,36
ACSSF,2010e5,wv,000,0034,0005664,160,54,   ,16000US5450260,"McMechen city, West Virginia",429,329,86,41,19,26,243,100,26,26,6,0,20,0,74,57,28,0,29,17
ACSSF,2010e5,wv,000,0034,0005665,160,54,   ,16000US5450524,"Madison city, West Virginia",910,681,236,48,64,124,445,229,70,14,0,0,14,56,159,47,7,0,40,112
ACSSF,2010e5,wv,000,0034,0005666,160,54,   ,16000US5450860,"Mallory CDP, West Virginia",482,446,102,17,0,85,344,36,20,0,0,0,0,20,16,0,0,0,0,16
ACSSF,2010e5,wv,000,0034,0005667,160,54,   ,16000US5450932,"Man town, West Virginia",340,266,83,20,15,48,183,74,32,24,5,0,19,8,42,3,0,0,3,39
ACSSF,2010e5,wv,000,0034,0005668,160,54,   ,16000US5451100,"Mannington city, West Virginia",624,455,214,29,48,137,241,169,60,29,0,29,0,31,109,64,21,12,31,45
ACSSF,2010e5,wv,000,0034,0005669,160,54,   ,16000US5451676,"Marlinton town, West Virginia",365,176,23,4,0,19,153,189,79,36,0,0,36,43,110,78,56,3,19,32
ACSSF,2010e5,wv,000,0034,0005670,160,54,   ,16000US5451724,"Marmet city, West Virginia",454,328,118,16,8,94,210,126,36,4,0,0,4,32,90,54,13,11,30,36
ACSSF,2010e5,wv,000,0034,0005671,160,54,   ,16000US5452060,"Martinsburg city, West Virginia",4206,2739,979,279,226,474,1760,1467,417,327,87,109,131,90,1050,681,337,58,286,369
ACSSF,2010e5,wv,000,0034,0005672,160,54,   ,16000US5452180,"Mason town, West Virginia",280,188,62,3,5,54,126,92,3,3,3,0,0,0,89,49,19,5,25,40
ACSSF,2010e5,wv,000,0034,0005673,160,54,   ,16000US5452228,"Masontown town, West Virginia",234,179,80,6,18,56,99,55,14,7,0,7,0,7,41,32,12,14,6,9
ACSSF,2010e5,wv,000,0034,0005674,160,54,   ,16000US5452324,"Matewan town, West Virginia",150,90,38,0,0,38,52,60,21,5,0,0,5,16,39,15,5,0,10,24
ACSSF,2010e5,wv,000,0034,0005675,160,54,   ,16000US5452372,"Matheny CDP, West Virginia",172,118,16,16,0,0,102,54,0,0,0,0,0,0,54,12,0,0,12,42
ACSSF,2010e5,wv,000,0034,0005676,160,54,   ,16000US5452420,"Matoaka town, West Virginia",55,24,2,0,0,2,22,31,19,16,6,0,10,3,12,0,0,0,0,12
ACSSF,2010e5,wv,000,0034,0005677,160,54,   ,16000US5452588,"Maybeury CDP, West Virginia",66,55,29,0,14,15,26,11,0,0,0,0,0,0,11,0,0,0,0,11
ACSSF,2010e5,wv,000,0034,0005678,160,54,   ,16000US5452780,"Meadow Bridge town, West Virginia",93,69,11,3,5,3,58,24,0,0,0,0,0,0,24,15,0,7,8,9
ACSSF,2010e5,wv,000,0034,0005679,160,54,   ,16000US5453572,"Middlebourne town, West Virginia",220,157,64,10,7,47,93,63,17,8,8,0,0,9,46,15,5,0,10,31
ACSSF,2010e5,wv,000,0034,0005680,160,54,   ,16000US5453692,"Middleway CDP, West Virginia",51,40,9,0,0,9,31,11,0,0,0,0,0,0,11,0,0,0,0,11
ACSSF,2010e5,wv,000,0034,0005681,160,54,   ,16000US5454100,"Mill Creek town, West Virginia",176,143,50,0,14,36,93,33,3,3,0,0,3,0,30,13,0,0,13,17
ACSSF,2010e5,wv,000,0034,0005682,160,54,   ,16000US5454484,"Milton town, West Virginia",675,497,189,44,70,75,308,178,35,6,6,0,0,29,143,74,19,0,55,69
ACSSF,2010e5,wv,000,0034,0005683,160,54,   ,16000US5454508,"Minden CDP, West Virginia",36,18,0,0,0,0,18,18,0,0,0,0,0,0,18,0,0,0,0,18
ACSSF,2010e5,wv,000,0034,0005684,160,54,   ,16000US5454580,"Mineralwells CDP, West Virginia",495,415,179,0,33,146,236,80,26,0,0,0,0,26,54,41,0,19,22,13
ACSSF,2010e5,wv,000,0034,0005685,160,54,   ,16000US5454892,"Mitchell Heights town, West Virginia",116,102,32,4,13,15,70,14,2,2,0,0,2,0,12,4,0,0,4,8
ACSSF,2010e5,wv,000,0034,0005686,160,54,   ,16000US5455132,"Monaville CDP, West Virginia",104,104,39,9,0,30,65,0,0,0,0,0,0,0,0,0,0,0,0,0
ACSSF,2010e5,wv,000,0034,0005687,160,54,   ,16000US5455276,"Monongah town, West Virginia",373,245,118,16,4,98,127,128,20,0,0,0,0,20,108,82,26,13,43,26
ACSSF,2010e5,wv,000,0034,0005688,160,54,   ,16000US5455372,"Montcalm CDP, West Virginia",143,136,33,0,18,15,103,7,0,0,0,0,0,0,7,0,0,0,0,7
ACSSF,2010e5,wv,000,0034,0005689,160,54,   ,16000US5455468,"Montgomery city, West Virginia",348,175,84,3,10,71,91,173,18,7,5,0,2,11,155,81,36,17,28,74
ACSSF,2010e5,wv,000,0034,0005690,160,54,   ,16000US5455540,"Montrose town, West Virginia",39,20,6,0,0,6,14,19,4,0,0,0,0,4,15,4,0,0,4,11
ACSSF,2010e5,wv,000,0034,0005691,160,54,   ,16000US5455588,"Moorefield town, West Virginia",514,357,66,7,7,52,291,157,18,0,0,0,0,18,139,103,6,38,59,36
ACSSF,2010e5,wv,000,0034,0005692,160,54,   ,16000US5455756,"Morgantown city, West Virginia",3653,2723,897,219,197,481,1826,930,251,119,35,67,17,132,679,347,92,45,210,332
ACSSF,2010e5,wv,000,0034,0005693,160,54,   ,16000US5456020,"Moundsville city, West Virginia",2457,1720,473,41,109,323,1247,737,181,103,38,0,65,78,556,287,96,27,164,269
ACSSF,2010e5,wv,000,0034,0005694,160,54,   ,16000US5456212,"Mount Carbon CDP, West Virginia",110,110,13,0,0,13,97,0,0,0,0,0,0,0,0,0,0,0,0,0
ACSSF,2010e5,wv,000,0034,0005695,160,54,   ,16000US5456342,"Mount Gay-Shamrock CDP, West Virginia",459,344,96,15,18,63,248,115,46,12,0,0,12,34,69,15,15,0,0,54
ACSSF,2010e5,wv,000,0034,0005696,160,54,   ,16000US5456404,"Mount Hope city, West Virginia",361,232,78,14,21,43,154,129,29,12,0,0,12,17,100,58,33,0,25,42
ACSSF,2010e5,wv,000,0034,0005697,160,54,   ,16000US5457148,"Mullens city, West Virginia",436,321,134,56,24,54,187,115,20,3,0,0,3,17,95,60,34,0,26,35
ACSSF,2010e5,wv,000,0034,0005698,160,54,   ,16000US5457916,"Neibert CDP, West Virginia",47,47,12,0,0,12,35,0,0,0,0,0,0,0,0,0,0,0,0,0
ACSSF,2010e5,wv,000,0034,0005699,160,54,   ,16000US5458180,"Nettie CDP, West Virginia",266,266,54,0,0,54,212,0,0,0,0,0,0,0,0,0,0,0,0,0
ACSSF,2010e5,wv,000,0034,0005700,160,54,   ,16000US5458300,"Newburg town, West Virginia",161,135,47,5,20,22,88,26,10,10,6,0,4,0,16,16,11,0,5,0
ACSSF,2010e5,wv,000,0034,0005701,160,54,   ,16000US5458372,"New Cumberland city, West Virginia",346,227,78,24,12,42,149,119,53,47,0,16,31,6,66,24,3,0,21,42
ACSSF,2010e5,wv,000,0034,0005702,160,54,   ,16000US5458420,"Newell CDP, West Virginia",312,218,53,27,0,26,165,94,29,29,0,0,29,0,65,48,0,0,48,17
ACSSF,2010e5,wv,000,0034,0005703,160,54,   ,16000US5458564,"New Haven town, West Virginia",516,352,153,55,24,74,199,164,23,18,12,6,0,5,141,88,12,0,76,53
ACSSF,2010e5,wv,000,0034,0005704,160,54,   ,16000US5458684,"New Martinsville city, West Virginia",1367,1122,319,57,62,200,803,245,16,0,0,0,0,16,229,74,17,0,57,155
ACSSF,2010e5,wv,000,0034,0005705,160,54,   ,16000US5458756,"New Richmond CDP, West Virginia",38,38,18,0,18,0,20,0,0,0,0,0,0,0,0,0,0,0,0,0
ACSSF,2010e5,wv,000,0034,0005706,160,54,   ,16000US5459068,"Nitro city, West Virginia",1874,1291,484,151,197,136,807,583,231,163,48,0,115,68,352,221,76,11,134,131
ACSSF,2010e5,wv,000,0034,0005707,160,54,   ,16000US5459428,"Northfork town, West Virginia",125,46,10,4,0,6,36,79,5,5,0,0,5,0,74,44,8,8,28,30
ACSSF,2010e5,wv,000,0034,0005708,160,54,   ,16000US5459458,"North Hills town, West Virginia",247,209,91,1,29,61,118,38,30,27,10,0,17,3,8,8,0,0,8,0
ACSSF,2010e5,wv,000,0034,0005709,160,54,   ,16000US5459836,"Nutter Fort town, West Virginia",455,357,93,17,0,76,264,98,26,19,0,0,19,7,72,26,0,0,26,46
ACSSF,2010e5,wv,000,0034,0005710,160,54,   ,16000US5460028,"Oak Hill city, West Virginia",2304,1674,522,100,124,298,1152,630,202,94,83,0,11,108,428,211,25,33,153,217
ACSSF,2010e5,wv,000,0034,0005711,160,54,   ,16000US5460196,"Oakvale town, West Virginia",27,27,3,0,3,0,24,0,0,0,0,0,0,0,0,0,0,0,0,0
ACSSF,2010e5,wv,000,0034,0005712,160,54,   ,16000US5460364,"Oceana town, West Virginia",435,315,115,16,32,67,200,120,28,17,0,0,17,11,92,54,11,18,25,38
ACSSF,2010e5,wv,000,0034,0005713,160,54,   ,16000US5460628,"Omar CDP, West Virginia",224,163,54,0,20,34,109,61,0,0,0,0,0,0,61,0,0,0,0,61
ACSSF,2010e5,wv,000,0034,0005714,160,54,   ,16000US5461636,"Paden City city, West Virginia",717,546,199,29,67,103,347,171,44,30,23,0,7,14,127,91,34,0,57,36
ACSSF,2010e5,wv,000,0034,0005715,160,54,   ,16000US5461660,"Page CDP, West Virginia",42,26,0,0,0,0,26,16,0,0,0,0,0,0,16,16,0,0,16,0
ACSSF,2010e5,wv,000,0034,0005716,160,54,   ,16000US5461684,"Pageton CDP, West Virginia",40,40,0,0,0,0,40,0,0,0,0,0,0,0,0,0,0,0,0,0
ACSSF,2010e5,wv,000,0034,0005717,160,54,   ,16000US5462140,"Parkersburg city, West Virginia",8211,5545,1876,368,333,1175,3669,2666,514,333,76,107,150,181,2152,1089,358,123,608,1063
ACSSF,2010e5,wv,000,0034,0005718,160,54,   ,16000US5462284,"Parsons city, West Virginia",489,362,149,41,20,88,213,127,30,6,6,0,0,24,97,53,24,21,8,44
ACSSF,2010e5,wv,000,0034,0005719,160,54,   ,16000US5462332,"Paw Paw town, West Virginia",92,51,5,0,0,5,46,41,0,0,0,0,0,0,41,23,6,0,17,18
ACSSF,2010e5,wv,000,0034,0005720,160,54,   ,16000US5462356,"Pax town, West Virginia",37,29,12,2,0,10,17,8,0,0,0,0,0,0,8,6,2,0,4,2
ACSSF,2010e5,wv,000,0034,0005721,160,54,   ,16000US5462488,"Pea Ridge CDP, West Virginia",1672,1447,446,57,153,236,1001,225,53,17,0,0,17,36,172,31,0,0,31,141
ACSSF,2010e5,wv,000,0034,0005722,160,54,   ,16000US5462764,"Pennsboro city, West Virginia",342,213,59,8,14,37,154,129,24,11,0,0,11,13,105,59,10,3,46,46
ACSSF,2010e5,wv,000,0034,0005723,160,54,   ,16000US5462788,"Pentress CDP, West Virginia",58,58,32,19,0,13,26,0,0,0,0,0,0,0,0,0,0,0,0,0
ACSSF,2010e5,wv,000,0034,0005724,160,54,   ,16000US5462956,"Petersburg city, West Virginia",731,512,163,41,30,92,349,219,65,50,50,0,0,15,154,96,10,0,86,58
ACSSF,2010e5,wv,000,0034,0005725,160,54,   ,16000US5463052,"Peterstown town, West Virginia",130,87,48,6,7,35,39,43,7,0,0,0,0,7,36,8,0,3,5,28
ACSSF,2010e5,wv,000,0034,0005726,160,54,   ,16000US5463292,"Philippi city, West Virginia",694,483,77,28,20,29,406,211,43,18,0,0,18,25,168,127,31,0,96,41
ACSSF,2010e5,wv,000,0034,0005727,160,54,   ,16000US5463484,"Pickens CDP, West Virginia",29,14,0,0,0,0,14,15,0,0,0,0,0,0,15,15,0,0,15,0
ACSSF,2010e5,wv,000,0034,0005728,160,54,   ,16000US5463604,"Piedmont town, West Virginia",269,137,54,3,4,47,83,132,22,16,0,12,4,6,110,83,11,19,53,27
ACSSF,2010e5,wv,000,0034,0005729,160,54,   ,16000US5463772,"Pinch CDP, West Virginia",884,769,240,77,74,89,529,115,10,10,10,0,0,0,105,38,0,0,38,67
ACSSF,2010e5,wv,000,0034,0005730,160,54,   ,16000US5463892,"Pine Grove town, West Virginia",136,102,41,6,4,31,61,34,10,7,7,0,0,3,24,13,3,0,10,11
ACSSF,2010e5,wv,000,0034,0005731,160,54,   ,16000US5463940,"Pineville town, West Virginia",241,196,43,12,6,25,153,45,8,0,0,0,0,8,37,19,6,0,13,18
ACSSF,2010e5,wv,000,0034,0005732,160,54,   ,16000US5463988,"Piney View CDP, West Virginia",244,187,40,0,0,40,147,57,41,0,0,0,0,41,16,16,0,0,16,0
ACSSF,2010e5,wv,000,0034,0005733,160,54,   ,16000US5464228,"Pleasant Valley city, West Virginia",846,648,298,59,98,141,350,198,71,33,8,0,25,38,127,84,14,0,70,43
ACSSF,2010e5,wv,000,0034,0005734,160,54,   ,16000US5464516,"Poca town, West Virginia",369,283,84,24,10,50,199,86,18,0,0,0,0,18,68,50,5,12,33,18
ACSSF,2010e5,wv,000,0034,0005735,160,54,   ,16000US5464708,"Point Pleasant city, West Virginia",1140,797,320,8,118,194,477,343,95,82,9,0,73,13,248,125,57,0,68,123
ACSSF,2010e5,wv,000,0034,0005736,160,54,   ,16000US5465284,"Powellton CDP, West Virginia",144,130,29,15,0,14,101,14,0,0,0,0,0,0,14,0,0,0,0,14
ACSSF,2010e5,wv,000,0034,0005737,160,54,   ,16000US5465356,"Pratt town, West Virginia",145,101,42,9,5,28,59,44,10,5,0,0,5,5,34,8,0,0,8,26
ACSSF,2010e5,wv,000,0034,0005738,160,54,   ,16000US5465596,"Prichard CDP, West Virginia",116,95,63,0,11,52,32,21,8,0,0,0,0,8,13,13,0,0,13,0
ACSSF,2010e5,wv,000,0034,0005739,160,54,   ,16000US5465668,"Prince CDP, West Virginia",74,26,0,0,0,0,26,48,0,0,0,0,0,0,48,34,0,0,34,14
ACSSF,2010e5,wv,000,0034,0005740,160,54,   ,16000US5465692,"Princeton city, West Virginia",1721,1237,369,154,28,187,868,484,268,166,0,44,122,102,216,67,23,0,44,149
ACSSF,2010e5,wv,000,0034,0005741,160,54,   ,16000US5465836,"Prosperity CDP, West Virginia",367,183,83,25,0,58,100,184,19,0,0,0,0,19,165,66,39,0,27,99
ACSSF,2010e5,wv,000,0034,0005742,160,54,   ,16000US5465956,"Pullman town, West Virginia",63,55,33,11,3,19,22,8,2,2,0,2,0,0,6,0,0,0,0,6
ACSSF,2010e5,wv,000,0034,0005743,160,54,   ,16000US5466412,"Quinwood town, West Virginia",93,65,13,0,0,13,52,28,14,10,6,0,4,4,14,10,0,0,10,4
ACSSF,2010e5,wv,000,0034,0005744,160,54,   ,16000US5466460,"Rachel CDP, West Virginia",47,32,23,0,0,23,9,15,15,15,0,0,15,0,0,0,0,0,0,0
ACSSF,2010e5,wv,000,0034,0005745,160,54,   ,16000US5466484,"Racine CDP, West Virginia",86,86,32,32,0,0,54,0,0,0,0,0,0,0,0,0,0,0,0,0
ACSSF,2010e5,wv,000,0034,0005746,160,54,   ,16000US5466652,"Rainelle town, West Virginia",431,310,119,69,0,50,191,121,30,0,0,0,0,30,91,48,18,23,7,43
ACSSF,2010e5,wv,000,0034,0005747,160,54,   ,16000US5466892,"Rand CDP, West Virginia",394,218,22,0,12,10,196,176,35,16,16,0,0,19,141,92,10,49,33,49
ACSSF,2010e5,wv,000,0034,0005748,160,54,   ,16000US5466988,"Ranson corporation, West Virginia",1120,645,278,84,90,104,367,475,126,30,16,0,14,96,349,226,65,51,110,123
ACSSF,2010e5,wv,000,0034,0005749,160,54,   ,16000US5467108,"Ravenswood city, West Virginia",1033,769,251,47,65,139,518,264,59,34,17,0,17,25,205,157,22,0,135,48
ACSSF,2010e5,wv,000,0034,0005750,160,54,   ,16000US5467228,"Raysal CDP, West Virginia",69,69,0,0,0,0,69,0,0,0,0,0,0,0,0,0,0,0,0,0
ACSSF,2010e5,wv,000,0034,0005751,160,54,   ,16000US5467252,"Reader CDP, West Virginia",202,152,86,36,0,50,66,50,22,22,0,0,22,0,28,28,11,0,17,0
ACSSF,2010e5,wv,000,0034,0005752,160,54,   ,16000US5467396,"Red Jacket CDP, West Virginia",205,141,57,11,0,46,84,64,30,30,30,0,0,0,34,34,14,0,20,0
ACSSF,2010e5,wv,000,0034,0005753,160,54,   ,16000US5467636,"Reedsville town, West Virginia",145,122,52,31,5,16,70,23,0,0,0,0,0,0,23,13,0,0,13,10
ACSSF,2010e5,wv,000,0034,0005754,160,54,   ,16000US5467660,"Reedy town, West Virginia",31,28,10,0,4,6,18,3,3,0,0,0,0,3,0,0,0,0,0,0
ACSSF,2010e5,wv,000,0034,0005755,160,54,   ,16000US5467996,"Rhodell town, West Virginia",33,21,10,3,0,7,11,12,0,0,0,0,0,0,12,12,0,0,12,0
ACSSF,2010e5,wv,000,0034,0005756,160,54,   ,16000US5468116,"Richwood city, West Virginia",616,426,87,34,34,19,339,190,55,37,8,0,29,18,135,71,18,51,2,64
ACSSF,2010e5,wv,000,0034,0005757,160,54,   ,16000US5468260,"Ridgeley town, West Virginia",191,136,39,4,0,35,97,55,20,5,0,4,1,15,35,31,0,0,31,4
ACSSF,2010e5,wv,000,0034,0005758,160,54,   ,16000US5468596,"Ripley city, West Virginia",833,691,260,118,34,108,431,142,59,59,17,0,42,0,83,37,11,0,26,46
ACSSF,2010e5,wv,000,0034,0005759,160,54,   ,16000US5468908,"Rivesville town, West Virginia",328,224,82,14,20,48,142,104,27,10,0,0,10,17,77,43,5,5,33,34
ACSSF,2010e5,wv,000,0034,0005760,160,54,   ,16000US5469100,"Robinette CDP, West Virginia",118,90,12,0,0,12,78,28,16,0,0,0,0,16,12,12,0,0,12,0
ACSSF,2010e5,wv,000,0034,0005761,160,54,   ,16000US5469844,"Roderfield CDP, West Virginia",16,16,0,0,0,0,16,0,0,0,0,0,0,0,0,0,0,0,0,0
ACSSF,2010e5,wv,000,0034,0005762,160,54,   ,16000US5470084,"Romney city, West Virginia",388,287,88,26,16,46,199,101,18,8,0,0,8,10,83,30,0,0,30,53
ACSSF,2010e5,wv,000,0034,0005763,160,54,   ,16000US5470156,"Ronceverte city, West Virginia",458,348,109,30,30,49,239,110,21,6,0,0,6,15,89,34,12,3,19,55
ACSSF,2010e5,wv,000,0034,0005764,160,54,   ,16000US5470468,"Rossmore CDP, West Virginia",68,9,0,0,0,0,9,59,17,0,0,0,0,17,42,16,0,16,0,26
ACSSF,2010e5,wv,000,0034,0005765,160,54,   ,16000US5470588,"Rowlesburg town, West Virginia",185,163,72,18,5,49,91,22,0,0,0,0,0,0,22,18,0,0,18,4
ACSSF,2010e5,wv,000,0034,0005766,160,54,   ,16000US5470828,"Rupert town, West Virginia",281,167,50,16,3,31,117,114,25,15,0,0,15,10,89,67,8,0,59,22
ACSSF,2010e5,wv,000,0034,0005767,160,54,   ,16000US5471212,"St. Albans city, West Virginia",2937,2200,675,124,93,458,1525,737,254,173,9,0,164,81,483,257,44,21,192,226
ACSSF,2010e5,wv,000,0034,0005768,160,54,   ,16000US5471356,"St. Marys city, West Virginia",510,373,118,18,8,92,255,137,23,7,0,7,0,16,114,64,19,7,38,50
ACSSF,2010e5,wv,000,0034,0005769,160,54,   ,16000US5471380,"Salem city, West Virginia",389,269,77,22,7,48,192,120,27,11,7,0,4,16,93,72,18,5,49,21
ACSSF,2010e5,wv,000,0034,0005770,160,54,   ,16000US5471476,"Salt Rock CDP, West Virginia",72,72,22,22,0,0,50,0,0,0,0,0,0,0,0,0,0,0,0,0
ACSSF,2010e5,wv,000,0034,0005771,160,54,   ,16000US5471620,"Sand Fork town, West Virginia",85,46,26,5,14,7,20,39,5,5,0,5,0,0,34,13,8,5,0,21
ACSSF,2010e5,wv,000,0034,0005772,160,54,   ,16000US5472004,"Sarah Ann CDP, West Virginia",32,19,19,0,0,19,0,13,0,0,0,0,0,0,13,0,0,0,0,13
ACSSF,2010e5,wv,000,0034,0005773,160,54,   ,16000US5472292,"Scarbro CDP, West Virginia",155,117,18,18,0,0,99,38,0,0,0,0,0,0,38,0,0,0,0,38
ACSSF,2010e5,wv,000,0034,0005774,160,54,   ,16000US5473108,"Shady Spring CDP, West Virginia",889,668,212,89,0,123,456,221,78,64,0,0,64,14,143,96,29,0,67,47
ACSSF,2010e5,wv,000,0034,0005775,160,54,   ,16000US5473252,"Shannondale CDP, West Virginia",697,646,311,77,33,201,335,51,17,17,0,17,0,0,34,34,0,0,34,0
ACSSF,2010e5,wv,000,0034,0005776,160,54,   ,16000US5473444,"Shenandoah Junction CDP, West Virginia",170,114,37,26,0,11,77,56,16,0,0,0,0,16,40,40,0,10,30,0
ACSSF,2010e5,wv,000,0034,0005777,160,54,   ,16000US5473468,"Shepherdstown town, West Virginia",157,109,43,3,6,34,66,48,14,3,0,0,3,11,34,11,4,0,7,23
ACSSF,2010e5,wv,000,0034,0005778,160,54,   ,16000US5473636,"Shinnston city, West Virginia",682,523,172,9,56,107,351,159,24,11,0,0,11,13,135,27,17,10,0,108
ACSSF,2010e5,wv,000,0034,0005779,160,54,   ,16000US5473876,"Shrewsbury CDP, West Virginia",229,200,76,0,55,21,124,29,0,0,0,0,0,0,29,0,0,0,0,29
ACSSF,2010e5,wv,000,0034,0005780,160,54,   ,16000US5474356,"Sissonville CDP, West Virginia",1459,1192,401,84,62,255,791,267,37,25,0,8,17,12,230,116,10,34,72,114
ACSSF,2010e5,wv,000,0034,0005781,160,54,   ,16000US5474380,"Sistersville city, West Virginia",394,303,94,10,19,65,209,91,11,8,0,3,5,3,80,58,7,0,51,22
ACSSF,2010e5,wv,000,0034,0005782,160,54,   ,16000US5474740,"Smithers city, West Virginia",209,75,15,3,0,12,60,134,44,27,22,0,5,17,90,38,5,8,25,52
ACSSF,2010e5,wv,000,0034,0005783,160,54,   ,16000US5474788,"Smithfield town, West Virginia",16,10,4,0,0,4,6,6,0,0,0,0,0,0,6,6,4,2,0,0
ACSSF,2010e5,wv,000,0034,0005784,160,54,   ,16000US5475172,"Sophia town, West Virginia",343,279,105,26,20,59,174,64,0,0,0,0,0,0,64,34,4,13,17,30
ACSSF,2010e5,wv,000,0034,0005785,160,54,   ,16000US5475292,"South Charleston city, West Virginia",3678,2563,782,222,125,435,1781,1115,187,64,7,0,57,123,928,502,155,63,284,426
ACSSF,2010e5,wv,000,0034,0005786,160,54,   ,16000US5475796,"Spelter CDP, West Virginia",88,61,30,21,0,9,31,27,0,0,0,0,0,0,27,0,0,0,0,27
ACSSF,2010e5,wv,000,0034,0005787,160,54,   ,16000US5475820,"Spencer city, West Virginia",608,448,204,23,77,104,244,160,45,20,0,0,20,25,115,23,7,0,16,92
ACSSF,2010e5,wv,000,0034,0005788,160,54,   ,16000US5476084,"Springfield CDP, West Virginia",172,140,50,38,12,0,90,32,0,0,0,0,0,0,32,0,0,0,0,32
ACSSF,2010e5,wv,000,0034,0005789,160,54,   ,16000US5476444,"Stanaford CDP, West Virginia",460,403,215,64,41,110,188,57,40,30,0,0,30,10,17,7,0,0,7,10
ACSSF,2010e5,wv,000,0034,0005790,160,54,   ,16000US5476516,"Star City town, West Virginia",365,249,81,26,26,29,168,116,52,39,21,0,18,13,64,9,0,0,9,55
ACSSF,2010e5,wv,000,0034,0005791,160,54,   ,16000US5476996,"Stollings CDP, West Virginia",157,123,15,0,15,0,108,34,18,0,0,0,0,18,16,0,0,0,0,16
ACSSF,2010e5,wv,000,0034,0005792,160,54,   ,16000US5477188,"Stonewood city, West Virginia",596,432,121,24,37,60,311,164,13,0,0,0,0,13,151,66,8,0,58,85
ACSSF,2010e5,wv,000,0034,0005793,160,54,   ,16000US5477980,"Summersville town, West Virginia",1093,942,319,29,0,290,623,151,39,0,0,0,0,39,112,16,0,0,16,96
ACSSF,2010e5,wv,000,0034,0005794,160,54,   ,16000US5478580,"Sutton town, West Virginia",311,194,37,5,8,24,157,117,20,7,0,4,3,13,97,58,20,18,20,39
ACSSF,2010e5,wv,000,0034,0005795,160,54,   ,16000US5478796,"Switzer CDP, West Virginia",276,194,42,13,15,14,152,82,0,0,0,0,0,0,82,23,23,0,0,59
ACSSF,2010e5,wv,000,0034,0005796,160,54,   ,16000US5478964,"Sylvester town, West Virginia",42,42,14,8,0,6,28,0,0,0,0,0,0,0,0,0,0,0,0,0
ACSSF,2010e5,wv,000,0034,0005797,160,54,   ,16000US5479545,"Teays Valley CDP, West Virginia",3917,3408,1454,371,336,747,1954,509,179,49,0,0,49,130,330,236,33,67,136,94
ACSSF,2010e5,wv,000,0034,0005798,160,54,   ,16000US5479708,"Terra Alta town, West Virginia",498,340,160,28,34,98,180,158,53,27,22,0,5,26,105,74,19,9,46,31
ACSSF,2010e5,wv,000,0034,0005799,160,54,   ,16000US5480020,"Thomas city, West Virginia",132,99,21,3,0,18,78,33,10,0,0,0,0,10,23,18,7,6,5,5
ACSSF,2010e5,wv,000,0034,0005800,160,54,   ,16000US5480284,"Thurmond town, West Virginia",2,2,0,0,0,0,2,0,0,0,0,0,0,0,0,0,0,0,0,0
ACSSF,2010e5,wv,000,0034,0005801,160,54,   ,16000US5480476,"Tioga CDP, West Virginia",26,8,0,0,0,0,8,18,0,0,0,0,0,0,18,0,0,0,0,18
ACSSF,2010e5,wv,000,0034,0005802,160,54,   ,16000US5480932,"Triadelphia town, West Virginia",249,202,49,19,9,21,153,47,29,19,19,0,0,10,18,18,18,0,0,0
ACSSF,2010e5,wv,000,0034,0005803,160,54,   ,16000US5481268,"Tunnelton town, West Virginia",95,80,39,11,5,23,41,15,0,0,0,0,0,0,15,10,5,0,5,5
ACSSF,2010e5,wv,000,0034,0005804,160,54,   ,16000US5481484,"Twilight CDP, West Virginia",0,0,0,0,0,0,0,0,0,0,0,0,0,0,0,0,0,0,0,0
ACSSF,2010e5,wv,000,0034,0005805,160,54,   ,16000US5481940,"Union town, West Virginia",125,78,36,5,0,31,42,47,30,17,0,0,17,13,17,8,0,8,0,9
ACSSF,2010e5,wv,000,0034,0005806,160,54,   ,16000US5482180,"Upper Falls CDP, West Virginia",1067,884,313,54,48,211,571,183,23,0,0,0,0,23,160,108,20,35,53,52
ACSSF,2010e5,wv,000,0034,0005807,160,54,   ,16000US5482564,"Valley Bend CDP, West Virginia",141,126,86,0,44,42,40,15,0,0,0,0,0,0,15,15,0,15,0,0
ACSSF,2010e5,wv,000,0034,0005808,160,54,   ,16000US5482732,"Valley Grove village, West Virginia",115,94,35,5,8,22,59,21,2,0,0,0,0,2,19,19,3,0,16,0
ACSSF,2010e5,wv,000,0034,0005809,160,54,   ,16000US5482756,"Valley Head CDP, West Virginia",87,52,34,18,0,16,18,35,0,0,0,0,0,0,35,0,0,0,0,35
ACSSF,2010e5,wv,000,0034,0005810,160,54,   ,16000US5482852,"Van CDP, West Virginia",62,47,0,0,0,0,47,15,15,0,0,0,0,15,0,0,0,0,0,0
ACSSF,2010e5,wv,000,0034,0005811,160,54,   ,16000US5483332,"Verdunville CDP, West Virginia",127,127,57,0,0,57,70,0,0,0,0,0,0,0,0,0,0,0,0,0
ACSSF,2010e5,wv,000,0034,0005812,160,54,   ,16000US5483500,"Vienna city, West Virginia",3016,2548,892,218,178,496,1656,468,150,63,35,0,28,87,318,145,23,10,112,173
ACSSF,2010e5,wv,000,0034,0005813,160,54,   ,16000US5483764,"Vivian CDP, West Virginia",17,17,0,0,0,0,17,0,0,0,0,0,0,0,0,0,0,0,0,0
ACSSF,2010e5,wv,000,0034,0005814,160,54,   ,16000US5484484,"War city, West Virginia",212,146,47,19,3,25,99,66,19,19,0,0,19,0,47,20,0,4,16,27
ACSSF,2010e5,wv,000,0034,0005815,160,54,   ,16000US5484580,"Wardensville town, West Virginia",93,74,22,4,0,18,52,19,6,6,4,0,2,0,13,13,0,4,9,0
ACSSF,2010e5,wv,000,0034,0005816,160,54,   ,16000US5484724,"Washington CDP, West Virginia",475,440,214,69,38,107,226,35,0,0,0,0,0,0,35,9,0,0,9,26
ACSSF,2010e5,wv,000,0034,0005817,160,54,   ,16000US5484916,"Waverly CDP, West Virginia",156,141,38,0,0,38,103,15,0,0,0,0,0,0,15,15,0,0,15,0
ACSSF,2010e5,wv,000,0034,0005818,160,54,   ,16000US5484940,"Wayne town, West Virginia",484,357,162,62,8,92,195,127,25,0,0,0,0,25,102,67,19,0,48,35
ACSSF,2010e5,wv,000,0034,0005819,160,54,   ,16000US5485156,"Weirton city, West Virginia",5530,3783,1201,270,266,665,2582,1747,444,180,83,0,97,264,1303,759,95,214,450,544
ACSSF,2010e5,wv,000,0034,0005820,160,54,   ,16000US5485228,"Welch city, West Virginia",482,329,109,0,39,70,220,153,33,7,0,0,7,26,120,28,0,0,28,92
ACSSF,2010e5,wv,000,0034,0005821,160,54,   ,16000US5485324,"Wellsburg city, West Virginia",693,474,164,7,44,113,310,219,99,92,17,20,55,7,120,102,20,1,81,18
ACSSF,2010e5,wv,000,0034,0005822,160,54,   ,16000US5485804,"West Hamlin town, West Virginia",207,131,41,9,0,32,90,76,10,5,0,0,5,5,66,29,6,0,23,37
ACSSF,2010e5,wv,000,0034,0005823,160,54,   ,16000US5485876,"West Liberty town, West Virginia",71,57,8,0,3,5,49,14,4,0,0,0,0,4,10,0,0,0,0,10
ACSSF,2010e5,wv,000,0034,0005824,160,54,   ,16000US5485900,"West Logan town, West Virginia",124,89,34,12,5,17,55,35,6,3,0,0,3,3,29,15,0,0,15,14
ACSSF,2010e5,wv,000,0034,0005825,160,54,   ,16000US5485924,"West Milford town, West Virginia",323,229,87,7,6,74,142,94,16,5,0,0,5,11,78,49,15,0,34,29
ACSSF,2010e5,wv,000,0034,0005826,160,54,   ,16000US5485972,"Weston city, West Virginia",1164,841,288,57,30,201,553,323,51,42,13,10,19,9,272,203,33,31,139,69
ACSSF,2010e5,wv,000,0034,0005827,160,54,   ,16000US5485996,"Westover city, West Virginia",981,703,216,45,65,106,487,278,59,19,11,0,8,40,219,146,44,10,92,73
ACSSF,2010e5,wv,000,0034,0005828,160,54,   ,16000US5486116,"West Union town, West Virginia",180,134,42,8,9,25,92,46,16,8,5,3,0,8,30,11,0,0,11,19
ACSSF,2010e5,wv,000,0034,0005829,160,54,   ,16000US5486452,"Wheeling city, West Virginia",7207,5085,1683,306,218,1159,3402,2122,364,175,67,0,108,189,1758,929,227,233,469,829
ACSSF,2010e5,wv,000,0034,0005830,160,54,   ,16000US5486620,"White Hall town, West Virginia",151,128,46,26,6,14,82,23,3,0,0,0,0,3,20,6,3,0,3,14
ACSSF,2010e5,wv,000,0034,0005831,160,54,   ,16000US5486812,"White Sulphur Springs city, West Virginia",747,455,127,22,46,59,328,292,107,83,0,21,62,24,185,117,38,36,43,68
ACSSF,2010e5,wv,000,0034,0005832,160,54,   ,16000US5486836,"Whitesville town, West Virginia",141,116,59,8,4,47,57,25,0,0,0,0,0,0,25,11,5,0,6,14
ACSSF,2010e5,wv,000,0034,0005833,160,54,   ,16000US5486932,"Whitmer CDP, West Virginia",67,67,50,27,0,23,17,0,0,0,0,0,0,0,0,0,0,0,0,0
ACSSF,2010e5,wv,000,0034,0005834,160,54,   ,16000US5487316,"Wiley Ford CDP, West Virginia",246,190,93,9,65,19,97,56,19,0,0,0,0,19,37,5,0,0,5,32
ACSSF,2010e5,wv,000,0034,0005835,160,54,   ,16000US5487508,"Williamson city, West Virginia",741,462,135,35,34,66,327,279,7,0,0,0,0,7,272,101,57,15,29,171
ACSSF,2010e5,wv,000,0034,0005836,160,54,   ,16000US5487556,"Williamstown city, West Virginia",815,649,257,27,24,206,392,166,61,51,0,0,51,10,105,79,0,26,53,26
ACSSF,2010e5,wv,000,0034,0005837,160,54,   ,16000US5487892,"Windsor Heights village, West Virginia",109,94,36,16,12,8,58,15,9,3,0,0,3,6,6,2,0,2,0,4
ACSSF,2010e5,wv,000,0034,0005838,160,54,   ,16000US5487988,"Winfield town, West Virginia",719,632,327,64,59,204,305,87,15,15,6,0,9,0,72,29,6,0,23,43
ACSSF,2010e5,wv,000,0034,0005839,160,54,   ,16000US5488276,"Wolf Summit CDP, West Virginia",67,67,16,0,16,0,51,0,0,0,0,0,0,0,0,0,0,0,0,0
ACSSF,2010e5,wv,000,0034,0005840,160,54,   ,16000US5488324,"Womelsdorf (Coalton) town, West Virginia",59,38,12,0,6,6,26,21,11,4,4,0,0,7,10,4,0,0,4,6
ACSSF,2010e5,wv,000,0034,0005841,160,54,   ,16000US5488708,"Worthington town, West Virginia",61,46,12,8,4,0,34,15,4,0,0,0,0,4,11,6,0,0,6,5
ACSSF,2010e5,wv,000,0034,0005842,311,54,   ,31100US1322054,"West Virginia (part); Beckley, WV Micro Area",21014,16081,5693,1226,1011,3456,10388,4933,1305,530,103,88,339,775,3628,1746,437,294,1015,1882
ACSSF,2010e5,wv,000,0034,0005843,311,54,   ,31100US1414054,"West Virginia (part); Bluefield, WV-VA Micro Area",16011,12278,3779,815,667,2297,8499,3733,1014,478,163,74,241,536,2719,1449,448,127,874,1270
ACSSF,2010e5,wv,000,0034,0005844,311,54,   ,31100US1662054,"West Virginia (part); Charleston, WV Metro Area",83153,64207,23091,4880,4233,13978,41116,18946,4856,2247,486,198,1563,2609,14090,7614,1861,1364,4389,6476
ACSSF,2010e5,wv,000,0034,0005845,311,54,   ,31100US1722054,"West Virginia (part); Clarksburg, WV Micro Area",25555,19285,6826,1298,1260,4268,12459,6270,1434,628,162,38,428,806,4836,2544,525,338,1681,2292
ACSSF,2010e5,wv,000,0034,0005846,311,54,   ,31100US1906054,"West Virginia (part); Cumberland, MD-WV Metro Area",7710,6020,1847,396,375,1076,4173,1690,446,296,104,74,118,150,1244,861,116,83,662,383
ACSSF,2010e5,wv,000,0034,0005847,311,54,   ,31100US2190054,"West Virginia (part); Fairmont, WV Micro Area",15027,11349,4111,919,657,2535,7238,3678,990,473,44,29,400,517,2688,1453,321,155,977,1235
ACSSF,2010e5,wv,000,0034,0005848,311,54,   ,31100US2518054,"West Virginia (part); Hagerstown-Martinsburg, MD-WV Metro Area",30557,23442,8945,2104,1862,4979,14497,7115,2288,1389,397,283,709,899,4827,2698,829,337,1532,2129
ACSSF,2010e5,wv,000,0034,0005849,311,54,   ,31100US2658054,"West Virginia (part); Huntington-Ashland, WV-KY-OH Metro Area",36451,27579,9492,2285,1838,5369,18087,8872,2032,1021,258,57,706,1011,6840,3777,811,589,2377,3063
ACSSF,2010e5,wv,000,0034,0005850,311,54,   ,31100US3406054,"West Virginia (part); Morgantown, WV Metro Area",27788,22420,8388,2257,1504,4627,14032,5368,1624,732,283,92,357,892,3744,1996,532,299,1165,1748
ACSSF,2010e5,wv,000,0034,0005851,311,54,   ,31100US3606054,"West Virginia (part); Oak Hill, WV Micro Area",12344,9215,2911,521,574,1816,6304,3129,911,407,189,20,198,504,2218,977,126,159,692,1241
ACSSF,2010e5,wv,000,0034,0005852,311,54,   ,31100US3762054,"West Virginia (part); Parkersburg-Marietta-Vienna, WV-OH Metro Area",27305,21482,7595,1421,1371,4803,13887,5823,1545,864,267,114,483,681,4278,2406,686,297,1423,1872
ACSSF,2010e5,wv,000,0034,0005853,311,54,   ,31100US3858054,"West Virginia (part); Point Pleasant, WV-OH Micro Area",7594,5757,1950,291,481,1178,3807,1837,442,255,36,9,210,187,1395,814,297,71,446,581
ACSSF,2010e5,wv,000,0034,0005854,311,54,   ,31100US4460054,"West Virginia (part); Steubenville-Weirton, OH-WV Metro Area",15460,11745,3688,706,924,2058,8057,3715,1137,595,182,36,377,542,2578,1454,241,318,895,1124
ACSSF,2010e5,wv,000,0034,0005855,311,54,   ,31100US4790054,"West Virginia (part); Washington-Arlington-Alexandria, DC-VA-MD-WV Metro Area",13590,11147,4733,1175,1033,2525,6414,2443,850,354,147,17,190,496,1593,840,182,137,521,753
ACSSF,2010e5,wv,000,0034,0005856,311,54,   ,31100US4854054,"West Virginia (part); Wheeling, WV-OH Metro Area",20871,16202,5519,929,1065,3525,10683,4669,1064,524,230,0,294,540,3605,1910,522,323,1065,1695
ACSSF,2010e5,wv,000,0034,0005857,311,54,   ,31100US4902054,"West Virginia (part); Winchester, VA-WV Metro Area",5804,4350,1441,218,310,913,2909,1454,379,191,16,0,175,188,1075,630,57,94,479,445
ACSSF,2010e5,wv,000,0034,0005858,312,54,   ,31200US132205405332,"Beckley city, WV; Beckley, WV Micro Area",4451,3043,1033,259,214,560,2010,1408,324,116,30,63,23,208,1084,486,89,53,344,598
ACSSF,2010e5,wv,000,0034,0005859,312,54,   ,31200US141405408524,"Bluefield city, WV; Bluefield, WV-VA Micro Area",2538,1858,552,83,119,350,1306,680,54,14,0,0,14,40,626,403,107,54,242,223
ACSSF,2010e5,wv,000,0034,0005860,312,54,   ,31200US166205414600,"Charleston city, WV; Charleston, WV Metro Area",12327,8817,3194,755,521,1918,5623,3510,764,435,102,76,257,329,2746,1577,546,233,798,1169
ACSSF,2010e5,wv,000,0034,0005861,312,54,   ,31200US172205415628,"Clarksburg city, WV; Clarksburg, WV Micro Area",4157,2786,1056,267,159,630,1730,1371,283,158,12,15,131,125,1088,566,198,97,271,522
ACSSF,2010e5,wv,000,0034,0005862,312,54,   ,31200US219005426452,"Fairmont city, WV; Fairmont, WV Micro Area",4310,2906,900,220,162,518,2006,1404,332,233,18,0,215,99,1072,578,187,92,299,494
ACSSF,2010e5,wv,000,0034,0005863,312,54,   ,31200US251805452060,"Martinsburg city, WV; Hagerstown-Martinsburg, MD-WV Metro Area",4206,2739,979,279,226,474,1760,1467,417,327,87,109,131,90,1050,681,337,58,286,369
ACSSF,2010e5,wv,000,0034,0005864,312,54,   ,31200US265805439460,"Huntington city, WV; Huntington-Ashland, WV-KY-OH Metro Area",11456,7533,2404,719,452,1233,5129,3923,880,499,140,0,359,381,3043,1641,350,338,953,1402
ACSSF,2010e5,wv,000,0034,0005865,312,54,   ,31200US340605455756,"Morgantown city, WV; Morgantown, WV Metro Area",3653,2723,897,219,197,481,1826,930,251,119,35,67,17,132,679,347,92,45,210,332
ACSSF,2010e5,wv,000,0034,0005866,312,54,   ,31200US360605460028,"Oak Hill city, WV; Oak Hill, WV Micro Area",2304,1674,522,100,124,298,1152,630,202,94,83,0,11,108,428,211,25,33,153,217
ACSSF,2010e5,wv,000,0034,0005867,312,54,   ,31200US376205462140,"Parkersburg city, WV; Parkersburg-Marietta-Vienna, WV-OH Metro Area",8211,5545,1876,368,333,1175,3669,2666,514,333,76,107,150,181,2152,1089,358,123,608,1063
ACSSF,2010e5,wv,000,0034,0005868,312,54,   ,31200US376205483500,"Vienna city, WV; Parkersburg-Marietta-Vienna, WV-OH Metro Area",3016,2548,892,218,178,496,1656,468,150,63,35,0,28,87,318,145,23,10,112,173
ACSSF,2010e5,wv,000,0034,0005869,312,54,   ,31200US385805464708,"Point Pleasant city, WV; Point Pleasant, WV-OH Micro Area",1140,797,320,8,118,194,477,343,95,82,9,0,73,13,248,125,57,0,68,123
ACSSF,2010e5,wv,000,0034,0005870,312,54,   ,31200US446005485156,"Weirton city, WV; Steubenville-Weirton, OH-WV Metro Area",5530,3783,1201,270,266,665,2582,1747,444,180,83,0,97,264,1303,759,95,214,450,544
ACSSF,2010e5,wv,000,0034,0005871,312,54,   ,31200US485405486452,"Wheeling city, WV; Wheeling, WV-OH Metro Area",7207,5085,1683,306,218,1159,3402,2122,364,175,67,0,108,189,1758,929,227,233,469,829
ACSSF,2010e5,wv,000,0034,0005872,313,54,081,31300US1322054081,"Raleigh County; West Virginia (part); Beckley, WV Micro Area",21014,16081,5693,1226,1011,3456,10388,4933,1305,530,103,88,339,775,3628,1746,437,294,1015,1882
ACSSF,2010e5,wv,000,0034,0005873,313,54,055,31300US1414054055,"Mercer County; West Virginia (part); Bluefield, WV-VA Micro Area",16011,12278,3779,815,667,2297,8499,3733,1014,478,163,74,241,536,2719,1449,448,127,874,1270
ACSSF,2010e5,wv,000,0034,0005874,313,54,005,31300US1662054005,"Boone County; West Virginia (part); Charleston, WV Metro Area",7180,5697,2137,367,433,1337,3560,1483,491,156,44,0,112,335,992,416,72,58,286,576
ACSSF,2010e5,wv,000,0034,0005875,313,54,015,31300US1662054015,"Clay County; West Virginia (part); Charleston, WV Metro Area",2428,1930,771,99,154,518,1159,498,174,52,14,0,38,122,324,148,10,43,95,176
ACSSF,2010e5,wv,000,0034,0005876,313,54,039,31300US1662054039,"Kanawha County; West Virginia (part); Charleston, WV Metro Area",51064,38518,12743,2751,2413,7579,25775,12546,2944,1488,359,123,1006,1456,9602,5244,1366,827,3051,4358
ACSSF,2010e5,wv,000,0034,0005877,313,54,043,31300US1662054043,"Lincoln County; West Virginia (part); Charleston, WV Metro Area",6552,4941,2022,571,233,1218,2919,1611,464,201,49,38,114,263,1147,628,165,138,325,519
ACSSF,2010e5,wv,000,0034,0005878,313,54,079,31300US1662054079,"Putnam County; West Virginia (part); Charleston, WV Metro Area",15929,13121,5418,1092,1000,3326,7703,2808,783,350,20,37,293,433,2025,1178,248,298,632,847
ACSSF,2010e5,wv,000,0034,0005879,313,54,017,31300US1722054017,"Doddridge County; West Virginia (part); Clarksburg, WV Micro Area",1999,1482,441,34,69,338,1041,517,178,126,94,3,29,52,339,158,0,37,121,181
ACSSF,2010e5,wv,000,0034,0005880,313,54,033,31300US1722054033,"Harrison County; West Virginia (part); Clarksburg, WV Micro Area",18968,14266,5062,963,930,3169,9204,4702,1006,453,68,20,365,553,3696,1911,482,213,1216,1785
ACSSF,2010e5,wv,000,0034,0005881,313,54,091,31300US1722054091,"Taylor County; West Virginia (part); Clarksburg, WV Micro Area",4588,3537,1323,301,261,761,2214,1051,250,49,0,15,34,201,801,475,43,88,344,326
ACSSF,2010e5,wv,000,0034,0005882,313,54,057,31300US1906054057,"Mineral County; West Virginia (part); Cumberland, MD-WV Metro Area",7710,6020,1847,396,375,1076,4173,1690,446,296,104,74,118,150,1244,861,116,83,662,383
ACSSF,2010e5,wv,000,0034,0005883,313,54,049,31300US2190054049,"Marion County; West Virginia (part); Fairmont, WV Micro Area",15027,11349,4111,919,657,2535,7238,3678,990,473,44,29,400,517,2688,1453,321,155,977,1235
ACSSF,2010e5,wv,000,0034,0005884,313,54,003,31300US2518054003,"Berkeley County; West Virginia (part); Hagerstown-Martinsburg, MD-WV Metro Area",26475,20223,7980,1978,1632,4370,12243,6252,2018,1239,338,273,628,779,4234,2363,823,303,1237,1871
ACSSF,2010e5,wv,000,0034,0005885,313,54,065,31300US2518054065,"Morgan County; West Virginia (part); Hagerstown-Martinsburg, MD-WV Metro Area",4082,3219,965,126,230,609,2254,863,270,150,59,10,81,120,593,335,6,34,295,258
ACSSF,2010e5,wv,000,0034,0005886,313,54,011,31300US2658054011,"Cabell County; West Virginia (part); Huntington-Ashland, WV-KY-OH Metro Area",24695,18320,6152,1507,1177,3468,12168,6375,1395,719,192,10,517,676,4980,2856,612,498,1746,2124
ACSSF,2010e5,wv,000,0034,0005887,313,54,099,31300US2658054099,"Wayne County; West Virginia (part); Huntington-Ashland, WV-KY-OH Metro Area",11756,9259,3340,778,661,1901,5919,2497,637,302,66,47,189,335,1860,921,199,91,631,939
ACSSF,2010e5,wv,000,0034,0005888,313,54,061,31300US3406054061,"Monongalia County; West Virginia (part); Morgantown, WV Metro Area",18785,15061,5783,1566,1168,3049,9278,3724,1190,518,194,72,252,672,2534,1356,375,153,828,1178
ACSSF,2010e5,wv,000,0034,0005889,313,54,077,31300US3406054077,"Preston County; West Virginia (part); Morgantown, WV Metro Area",9003,7359,2605,691,336,1578,4754,1644,434,214,89,20,105,220,1210,640,157,146,337,570
ACSSF,2010e5,wv,000,0034,0005890,313,54,019,31300US3606054019,"Fayette County; West Virginia (part); Oak Hill, WV Micro Area",12344,9215,2911,521,574,1816,6304,3129,911,407,189,20,198,504,2218,977,126,159,692,1241
ACSSF,2010e5,wv,000,0034,0005891,313,54,073,31300US3762054073,"Pleasants County; West Virginia (part); Parkersburg-Marietta-Vienna, WV-OH Metro Area",1674,1394,488,71,52,365,906,280,81,45,0,7,38,36,199,109,19,7,83,90
ACSSF,2010e5,wv,000,0034,0005892,313,54,105,31300US3762054105,"Wirt County; West Virginia (part); Parkersburg-Marietta-Vienna, WV-OH Metro Area",1697,1447,441,112,102,227,1006,250,64,31,14,0,17,33,186,129,17,12,100,57
ACSSF,2010e5,wv,000,0034,0005893,313,54,107,31300US3762054107,"Wood County; West Virginia (part); Parkersburg-Marietta-Vienna, WV-OH Metro Area",23934,18641,6666,1238,1217,4211,11975,5293,1400,788,253,107,428,612,3893,2168,650,278,1240,1725
ACSSF,2010e5,wv,000,0034,0005894,313,54,053,31300US3858054053,"Mason County; West Virginia (part); Point Pleasant, WV-OH Micro Area",7594,5757,1950,291,481,1178,3807,1837,442,255,36,9,210,187,1395,814,297,71,446,581
ACSSF,2010e5,wv,000,0034,0005895,313,54,009,31300US4460054009,"Brooke County; West Virginia (part); Steubenville-Weirton, OH-WV Metro Area",6578,4979,1442,182,426,834,3537,1599,497,241,56,20,165,256,1102,724,166,138,420,378
ACSSF,2010e5,wv,000,0034,0005896,313,54,029,31300US4460054029,"Hancock County; West Virginia (part); Steubenville-Weirton, OH-WV Metro Area",8882,6766,2246,524,498,1224,4520,2116,640,354,126,16,212,286,1476,730,75,180,475,746
ACSSF,2010e5,wv,000,0034,0005897,313,54,037,31300US4790054037,"Jefferson County; West Virginia (part); Washington-Arlington-Alexandria, DC-VA-MD-WV Metro Area",13590,11147,4733,1175,1033,2525,6414,2443,850,354,147,17,190,496,1593,840,182,137,521,753
ACSSF,2010e5,wv,000,0034,0005898,313,54,051,31300US4854054051,"Marshall County; West Virginia (part); Wheeling, WV-OH Metro Area",9385,7314,2474,441,497,1536,4840,2071,614,307,134,0,173,307,1457,764,223,71,470,693
ACSSF,2010e5,wv,000,0034,0005899,313,54,069,31300US4854054069,"Ohio County; West Virginia (part); Wheeling, WV-OH Metro Area",11486,8888,3045,488,568,1989,5843,2598,450,217,96,0,121,233,2148,1146,299,252,595,1002
ACSSF,2010e5,wv,000,0034,0005900,313,54,027,31300US4902054027,"Hampshire County; West Virginia (part); Winchester, VA-WV Metro Area",5804,4350,1441,218,310,913,2909,1454,379,191,16,0,175,188,1075,630,57,94,479,445
ACSSF,2010e5,wv,000,0034,0005901,315,54,   ,31500US479004789454,"West Virginia (part); Washington-Arlington-Alexandria, DC-VA-MD-WV Metro Division; Washington-Arlington-Alexandria, DC-VA-MD-WV Metro Area",13590,11147,4733,1175,1033,2525,6414,2443,850,354,147,17,190,496,1593,840,182,137,521,753
ACSSF,2010e5,wv,000,0034,0005902,316,54,037,31600US479004789454037,"Jefferson County; West Virginia (part); Washington-Arlington-Alexandria, DC-VA-MD-WV Metro Division; Washington-Arlington-Alexandria, DC-VA-MD-WV Metro Area",13590,11147,4733,1175,1033,2525,6414,2443,850,354,147,17,190,496,1593,840,182,137,521,753
ACSSF,2010e5,wv,000,0034,0005903,320,54,   ,32000US5413220,"Beckley, WV Micro Area; West Virginia",21014,16081,5693,1226,1011,3456,10388,4933,1305,530,103,88,339,775,3628,1746,437,294,1015,1882
ACSSF,2010e5,wv,000,0034,0005904,320,54,   ,32000US5414140,"Bluefield, WV-VA Micro Area (part); West Virginia",16011,12278,3779,815,667,2297,8499,3733,1014,478,163,74,241,536,2719,1449,448,127,874,1270
ACSSF,2010e5,wv,000,0034,0005905,320,54,   ,32000US5416620,"Charleston, WV Metro Area; West Virginia",83153,64207,23091,4880,4233,13978,41116,18946,4856,2247,486,198,1563,2609,14090,7614,1861,1364,4389,6476
ACSSF,2010e5,wv,000,0034,0005906,320,54,   ,32000US5417220,"Clarksburg, WV Micro Area; West Virginia",25555,19285,6826,1298,1260,4268,12459,6270,1434,628,162,38,428,806,4836,2544,525,338,1681,2292
ACSSF,2010e5,wv,000,0034,0005907,320,54,   ,32000US5419060,"Cumberland, MD-WV Metro Area (part); West Virginia",7710,6020,1847,396,375,1076,4173,1690,446,296,104,74,118,150,1244,861,116,83,662,383
ACSSF,2010e5,wv,000,0034,0005908,320,54,   ,32000US5421900,"Fairmont, WV Micro Area; West Virginia",15027,11349,4111,919,657,2535,7238,3678,990,473,44,29,400,517,2688,1453,321,155,977,1235
ACSSF,2010e5,wv,000,0034,0005909,320,54,   ,32000US5425180,"Hagerstown-Martinsburg, MD-WV Metro Area (part); West Virginia",30557,23442,8945,2104,1862,4979,14497,7115,2288,1389,397,283,709,899,4827,2698,829,337,1532,2129
ACSSF,2010e5,wv,000,0034,0005910,320,54,   ,32000US5426580,"Huntington-Ashland, WV-KY-OH Metro Area (part); West Virginia",36451,27579,9492,2285,1838,5369,18087,8872,2032,1021,258,57,706,1011,6840,3777,811,589,2377,3063
ACSSF,2010e5,wv,000,0034,0005911,320,54,   ,32000US5434060,"Morgantown, WV Metro Area; West Virginia",27788,22420,8388,2257,1504,4627,14032,5368,1624,732,283,92,357,892,3744,1996,532,299,1165,1748
ACSSF,2010e5,wv,000,0034,0005912,320,54,   ,32000US5436060,"Oak Hill, WV Micro Area; West Virginia",12344,9215,2911,521,574,1816,6304,3129,911,407,189,20,198,504,2218,977,126,159,692,1241
ACSSF,2010e5,wv,000,0034,0005913,320,54,   ,32000US5437620,"Parkersburg-Marietta-Vienna, WV-OH Metro Area (part); West Virginia",27305,21482,7595,1421,1371,4803,13887,5823,1545,864,267,114,483,681,4278,2406,686,297,1423,1872
ACSSF,2010e5,wv,000,0034,0005914,320,54,   ,32000US5438580,"Point Pleasant, WV-OH Micro Area (part); West Virginia",7594,5757,1950,291,481,1178,3807,1837,442,255,36,9,210,187,1395,814,297,71,446,581
ACSSF,2010e5,wv,000,0034,0005915,320,54,   ,32000US5444600,"Steubenville-Weirton, OH-WV Metro Area (part); West Virginia",15460,11745,3688,706,924,2058,8057,3715,1137,595,182,36,377,542,2578,1454,241,318,895,1124
ACSSF,2010e5,wv,000,0034,0005916,320,54,   ,32000US5447900,"Washington-Arlington-Alexandria, DC-VA-MD-WV Metro Area (part); West Virginia",13590,11147,4733,1175,1033,2525,6414,2443,850,354,147,17,190,496,1593,840,182,137,521,753
ACSSF,2010e5,wv,000,0034,0005917,320,54,   ,32000US5448540,"Wheeling, WV-OH Metro Area (part); West Virginia",20871,16202,5519,929,1065,3525,10683,4669,1064,524,230,0,294,540,3605,1910,522,323,1065,1695
ACSSF,2010e5,wv,000,0034,0005918,320,54,   ,32000US5449020,"Winchester, VA-WV Metro Area (part); West Virginia",5804,4350,1441,218,310,913,2909,1454,379,191,16,0,175,188,1075,630,57,94,479,445
ACSSF,2010e5,wv,000,0034,0005919,321,54,   ,32100US541322005332,"Beckley city; Beckley, WV Micro Area; West Virginia",4451,3043,1033,259,214,560,2010,1408,324,116,30,63,23,208,1084,486,89,53,344,598
ACSSF,2010e5,wv,000,0034,0005920,321,54,   ,32100US541414008524,"Bluefield city; Bluefield, WV-VA Micro Area (part); West Virginia",2538,1858,552,83,119,350,1306,680,54,14,0,0,14,40,626,403,107,54,242,223
ACSSF,2010e5,wv,000,0034,0005921,321,54,   ,32100US541662014600,"Charleston city; Charleston, WV Metro Area; West Virginia",12327,8817,3194,755,521,1918,5623,3510,764,435,102,76,257,329,2746,1577,546,233,798,1169
ACSSF,2010e5,wv,000,0034,0005922,321,54,   ,32100US541722015628,"Clarksburg city; Clarksburg, WV Micro Area; West Virginia",4157,2786,1056,267,159,630,1730,1371,283,158,12,15,131,125,1088,566,198,97,271,522
ACSSF,2010e5,wv,000,0034,0005923,321,54,   ,32100US542190026452,"Fairmont city; Fairmont, WV Micro Area; West Virginia",4310,2906,900,220,162,518,2006,1404,332,233,18,0,215,99,1072,578,187,92,299,494
ACSSF,2010e5,wv,000,0034,0005924,321,54,   ,32100US542518052060,"Martinsburg city; Hagerstown-Martinsburg, MD-WV Metro Area (part); West Virginia",4206,2739,979,279,226,474,1760,1467,417,327,87,109,131,90,1050,681,337,58,286,369
ACSSF,2010e5,wv,000,0034,0005925,321,54,   ,32100US542658039460,"Huntington city; Huntington-Ashland, WV-KY-OH Metro Area (part); West Virginia",11456,7533,2404,719,452,1233,5129,3923,880,499,140,0,359,381,3043,1641,350,338,953,1402
ACSSF,2010e5,wv,000,0034,0005926,321,54,   ,32100US543406055756,"Morgantown city; Morgantown, WV Metro Area; West Virginia",3653,2723,897,219,197,481,1826,930,251,119,35,67,17,132,679,347,92,45,210,332
ACSSF,2010e5,wv,000,0034,0005927,321,54,   ,32100US543606060028,"Oak Hill city; Oak Hill, WV Micro Area; West Virginia",2304,1674,522,100,124,298,1152,630,202,94,83,0,11,108,428,211,25,33,153,217
ACSSF,2010e5,wv,000,0034,0005928,321,54,   ,32100US543762062140,"Parkersburg city; Parkersburg-Marietta-Vienna, WV-OH Metro Area (part); West Virginia",8211,5545,1876,368,333,1175,3669,2666,514,333,76,107,150,181,2152,1089,358,123,608,1063
ACSSF,2010e5,wv,000,0034,0005929,321,54,   ,32100US543762083500,"Vienna city; Parkersburg-Marietta-Vienna, WV-OH Metro Area (part); West Virginia",3016,2548,892,218,178,496,1656,468,150,63,35,0,28,87,318,145,23,10,112,173
ACSSF,2010e5,wv,000,0034,0005930,321,54,   ,32100US543858064708,"Point Pleasant city; Point Pleasant, WV-OH Micro Area (part); West Virginia",1140,797,320,8,118,194,477,343,95,82,9,0,73,13,248,125,57,0,68,123
ACSSF,2010e5,wv,000,0034,0005931,321,54,   ,32100US544460085156,"Weirton city; Steubenville-Weirton, OH-WV Metro Area (part); West Virginia",5530,3783,1201,270,266,665,2582,1747,444,180,83,0,97,264,1303,759,95,214,450,544
ACSSF,2010e5,wv,000,0034,0005932,321,54,   ,32100US544854086452,"Wheeling city; Wheeling, WV-OH Metro Area (part); West Virginia",7207,5085,1683,306,218,1159,3402,2122,364,175,67,0,108,189,1758,929,227,233,469,829
ACSSF,2010e5,wv,000,0034,0005933,322,54,081,32200US5413220081,"Raleigh County; Beckley, WV Micro Area; West Virginia",21014,16081,5693,1226,1011,3456,10388,4933,1305,530,103,88,339,775,3628,1746,437,294,1015,1882
ACSSF,2010e5,wv,000,0034,0005934,322,54,055,32200US5414140055,"Mercer County; Bluefield, WV-VA Micro Area (part); West Virginia",16011,12278,3779,815,667,2297,8499,3733,1014,478,163,74,241,536,2719,1449,448,127,874,1270
ACSSF,2010e5,wv,000,0034,0005935,322,54,005,32200US5416620005,"Boone County; Charleston, WV Metro Area; West Virginia",7180,5697,2137,367,433,1337,3560,1483,491,156,44,0,112,335,992,416,72,58,286,576
ACSSF,2010e5,wv,000,0034,0005936,322,54,015,32200US5416620015,"Clay County; Charleston, WV Metro Area; West Virginia",2428,1930,771,99,154,518,1159,498,174,52,14,0,38,122,324,148,10,43,95,176
ACSSF,2010e5,wv,000,0034,0005937,322,54,039,32200US5416620039,"Kanawha County; Charleston, WV Metro Area; West Virginia",51064,38518,12743,2751,2413,7579,25775,12546,2944,1488,359,123,1006,1456,9602,5244,1366,827,3051,4358
ACSSF,2010e5,wv,000,0034,0005938,322,54,043,32200US5416620043,"Lincoln County; Charleston, WV Metro Area; West Virginia",6552,4941,2022,571,233,1218,2919,1611,464,201,49,38,114,263,1147,628,165,138,325,519
ACSSF,2010e5,wv,000,0034,0005939,322,54,079,32200US5416620079,"Putnam County; Charleston, WV Metro Area; West Virginia",15929,13121,5418,1092,1000,3326,7703,2808,783,350,20,37,293,433,2025,1178,248,298,632,847
ACSSF,2010e5,wv,000,0034,0005940,322,54,017,32200US5417220017,"Doddridge County; Clarksburg, WV Micro Area; West Virginia",1999,1482,441,34,69,338,1041,517,178,126,94,3,29,52,339,158,0,37,121,181
ACSSF,2010e5,wv,000,0034,0005941,322,54,033,32200US5417220033,"Harrison County; Clarksburg, WV Micro Area; West Virginia",18968,14266,5062,963,930,3169,9204,4702,1006,453,68,20,365,553,3696,1911,482,213,1216,1785
ACSSF,2010e5,wv,000,0034,0005942,322,54,091,32200US5417220091,"Taylor County; Clarksburg, WV Micro Area; West Virginia",4588,3537,1323,301,261,761,2214,1051,250,49,0,15,34,201,801,475,43,88,344,326
ACSSF,2010e5,wv,000,0034,0005943,322,54,057,32200US5419060057,"Mineral County; Cumberland, MD-WV Metro Area (part); West Virginia",7710,6020,1847,396,375,1076,4173,1690,446,296,104,74,118,150,1244,861,116,83,662,383
ACSSF,2010e5,wv,000,0034,0005944,322,54,049,32200US5421900049,"Marion County; Fairmont, WV Micro Area; West Virginia",15027,11349,4111,919,657,2535,7238,3678,990,473,44,29,400,517,2688,1453,321,155,977,1235
ACSSF,2010e5,wv,000,0034,0005945,322,54,003,32200US5425180003,"Berkeley County; Hagerstown-Martinsburg, MD-WV Metro Area (part); West Virginia",26475,20223,7980,1978,1632,4370,12243,6252,2018,1239,338,273,628,779,4234,2363,823,303,1237,1871
ACSSF,2010e5,wv,000,0034,0005946,322,54,065,32200US5425180065,"Morgan County; Hagerstown-Martinsburg, MD-WV Metro Area (part); West Virginia",4082,3219,965,126,230,609,2254,863,270,150,59,10,81,120,593,335,6,34,295,258
ACSSF,2010e5,wv,000,0034,0005947,322,54,011,32200US5426580011,"Cabell County; Huntington-Ashland, WV-KY-OH Metro Area (part); West Virginia",24695,18320,6152,1507,1177,3468,12168,6375,1395,719,192,10,517,676,4980,2856,612,498,1746,2124
ACSSF,2010e5,wv,000,0034,0005948,322,54,099,32200US5426580099,"Wayne County; Huntington-Ashland, WV-KY-OH Metro Area (part); West Virginia",11756,9259,3340,778,661,1901,5919,2497,637,302,66,47,189,335,1860,921,199,91,631,939
ACSSF,2010e5,wv,000,0034,0005949,322,54,061,32200US5434060061,"Monongalia County; Morgantown, WV Metro Area; West Virginia",18785,15061,5783,1566,1168,3049,9278,3724,1190,518,194,72,252,672,2534,1356,375,153,828,1178
ACSSF,2010e5,wv,000,0034,0005950,322,54,077,32200US5434060077,"Preston County; Morgantown, WV Metro Area; West Virginia",9003,7359,2605,691,336,1578,4754,1644,434,214,89,20,105,220,1210,640,157,146,337,570
ACSSF,2010e5,wv,000,0034,0005951,322,54,019,32200US5436060019,"Fayette County; Oak Hill, WV Micro Area; West Virginia",12344,9215,2911,521,574,1816,6304,3129,911,407,189,20,198,504,2218,977,126,159,692,1241
ACSSF,2010e5,wv,000,0034,0005952,322,54,073,32200US5437620073,"Pleasants County; Parkersburg-Marietta-Vienna, WV-OH Metro Area (part); West Virginia",1674,1394,488,71,52,365,906,280,81,45,0,7,38,36,199,109,19,7,83,90
ACSSF,2010e5,wv,000,0034,0005953,322,54,105,32200US5437620105,"Wirt County; Parkersburg-Marietta-Vienna, WV-OH Metro Area (part); West Virginia",1697,1447,441,112,102,227,1006,250,64,31,14,0,17,33,186,129,17,12,100,57
ACSSF,2010e5,wv,000,0034,0005954,322,54,107,32200US5437620107,"Wood County; Parkersburg-Marietta-Vienna, WV-OH Metro Area (part); West Virginia",23934,18641,6666,1238,1217,4211,11975,5293,1400,788,253,107,428,612,3893,2168,650,278,1240,1725
ACSSF,2010e5,wv,000,0034,0005955,322,54,053,32200US5438580053,"Mason County; Point Pleasant, WV-OH Micro Area (part); West Virginia",7594,5757,1950,291,481,1178,3807,1837,442,255,36,9,210,187,1395,814,297,71,446,581
ACSSF,2010e5,wv,000,0034,0005956,322,54,009,32200US5444600009,"Brooke County; Steubenville-Weirton, OH-WV Metro Area (part); West Virginia",6578,4979,1442,182,426,834,3537,1599,497,241,56,20,165,256,1102,724,166,138,420,378
ACSSF,2010e5,wv,000,0034,0005957,322,54,029,32200US5444600029,"Hancock County; Steubenville-Weirton, OH-WV Metro Area (part); West Virginia",8882,6766,2246,524,498,1224,4520,2116,640,354,126,16,212,286,1476,730,75,180,475,746
ACSSF,2010e5,wv,000,0034,0005958,322,54,037,32200US5447900037,"Jefferson County; Washington-Arlington-Alexandria, DC-VA-MD-WV Metro Area (part); West Virginia",13590,11147,4733,1175,1033,2525,6414,2443,850,354,147,17,190,496,1593,840,182,137,521,753
ACSSF,2010e5,wv,000,0034,0005959,322,54,051,32200US5448540051,"Marshall County; Wheeling, WV-OH Metro Area (part); West Virginia",9385,7314,2474,441,497,1536,4840,2071,614,307,134,0,173,307,1457,764,223,71,470,693
ACSSF,2010e5,wv,000,0034,0005960,322,54,069,32200US5448540069,"Ohio County; Wheeling, WV-OH Metro Area (part); West Virginia",11486,8888,3045,488,568,1989,5843,2598,450,217,96,0,121,233,2148,1146,299,252,595,1002
ACSSF,2010e5,wv,000,0034,0005961,322,54,027,32200US5449020027,"Hampshire County; Winchester, VA-WV Metro Area (part); West Virginia",5804,4350,1441,218,310,913,2909,1454,379,191,16,0,175,188,1075,630,57,94,479,445
ACSSF,2010e5,wv,000,0034,0005962,323,54,   ,32300US544790047894,"Washington-Arlington-Alexandria, DC-VA-MD-WV Metro Division (part); Washington-Arlington-Alexandria, DC-VA-MD-WV Metro Area (part); West Virginia",13590,11147,4733,1175,1033,2525,6414,2443,850,354,147,17,190,496,1593,840,182,137,521,753
ACSSF,2010e5,wv,000,0034,0005963,324,54,037,32400US544790047894037,"Jefferson County; Washington-Arlington-Alexandria, DC-VA-MD-WV Metro Division (part); Washington-Arlington-Alexandria, DC-VA-MD-WV Metro Area (part); West Virginia",13590,11147,4733,1175,1033,2525,6414,2443,850,354,147,17,190,496,1593,840,182,137,521,753
ACSSF,2010e5,wv,000,0034,0005964,331,54,   ,33100US13854,"West Virginia (part); Beckley-Oak Hill, WV CSA",33358,25296,8604,1747,1585,5272,16692,8062,2216,937,292,108,537,1279,5846,2723,563,453,1707,3123
ACSSF,2010e5,wv,000,0034,0005965,331,54,   ,33100US24254,"West Virginia (part); Fairmont-Clarksburg, WV CSA",40582,30634,10937,2217,1917,6803,19697,9948,2424,1101,206,67,828,1323,7524,3997,846,493,2658,3527
ACSSF,2010e5,wv,000,0034,0005966,331,54,   ,33100US54854,"West Virginia (part); Washington-Baltimore-Northern Virginia, DC-MD-VA-WV CSA",19394,15497,6174,1393,1343,3438,9323,3897,1229,545,163,17,365,684,2668,1470,239,231,1000,1198
ACSSF,2010e5,wv,000,0034,0005967,333,54,   ,33300US1381322054,"West Virginia (part); Beckley, WV Micro Area; Beckley-Oak Hill, WV CSA",21014,16081,5693,1226,1011,3456,10388,4933,1305,530,103,88,339,775,3628,1746,437,294,1015,1882
ACSSF,2010e5,wv,000,0034,0005968,333,54,   ,33300US1383606054,"West Virginia (part); Oak Hill, WV Micro Area; Beckley-Oak Hill, WV CSA",12344,9215,2911,521,574,1816,6304,3129,911,407,189,20,198,504,2218,977,126,159,692,1241
ACSSF,2010e5,wv,000,0034,0005969,333,54,   ,33300US2421722054,"West Virginia (part); Clarksburg, WV Micro Area; Fairmont-Clarksburg, WV CSA",25555,19285,6826,1298,1260,4268,12459,6270,1434,628,162,38,428,806,4836,2544,525,338,1681,2292
ACSSF,2010e5,wv,000,0034,0005970,333,54,   ,33300US2422190054,"West Virginia (part); Fairmont, WV Micro Area; Fairmont-Clarksburg, WV CSA",15027,11349,4111,919,657,2535,7238,3678,990,473,44,29,400,517,2688,1453,321,155,977,1235
ACSSF,2010e5,wv,000,0034,0005971,333,54,   ,33300US5484790054,"West Virginia (part); Washington-Arlington-Alexandria, DC-VA-MD-WV Metro Area; Washington-Baltimore-Northern Virginia, DC-MD-VA-WV CSA",13590,11147,4733,1175,1033,2525,6414,2443,850,354,147,17,190,496,1593,840,182,137,521,753
ACSSF,2010e5,wv,000,0034,0005972,333,54,   ,33300US5484902054,"West Virginia (part); Winchester, VA-WV Metro Area; Washington-Baltimore-Northern Virginia, DC-MD-VA-WV CSA",5804,4350,1441,218,310,913,2909,1454,379,191,16,0,175,188,1075,630,57,94,479,445
ACSSF,2010e5,wv,000,0034,0005973,340,54,   ,34000US54138,"Beckley-Oak Hill, WV CSA; West Virginia",33358,25296,8604,1747,1585,5272,16692,8062,2216,937,292,108,537,1279,5846,2723,563,453,1707,3123
ACSSF,2010e5,wv,000,0034,0005974,340,54,   ,34000US54242,"Fairmont-Clarksburg, WV CSA; West Virginia",40582,30634,10937,2217,1917,6803,19697,9948,2424,1101,206,67,828,1323,7524,3997,846,493,2658,3527
ACSSF,2010e5,wv,000,0034,0005975,340,54,   ,34000US54548,"Washington-Baltimore-Northern Virginia, DC-MD-VA-WV CSA (part); West Virginia",19394,15497,6174,1393,1343,3438,9323,3897,1229,545,163,17,365,684,2668,1470,239,231,1000,1198
ACSSF,2010e5,wv,000,0034,0005976,341,54,   ,34100US5413813220,"Beckley, WV Micro Area; Beckley-Oak Hill, WV CSA; West Virginia",21014,16081,5693,1226,1011,3456,10388,4933,1305,530,103,88,339,775,3628,1746,437,294,1015,1882
ACSSF,2010e5,wv,000,0034,0005977,341,54,   ,34100US5413836060,"Oak Hill, WV Micro Area; Beckley-Oak Hill, WV CSA; West Virginia",12344,9215,2911,521,574,1816,6304,3129,911,407,189,20,198,504,2218,977,126,159,692,1241
ACSSF,2010e5,wv,000,0034,0005978,341,54,   ,34100US5424217220,"Clarksburg, WV Micro Area; Fairmont-Clarksburg, WV CSA; West Virginia",25555,19285,6826,1298,1260,4268,12459,6270,1434,628,162,38,428,806,4836,2544,525,338,1681,2292
ACSSF,2010e5,wv,000,0034,0005979,341,54,   ,34100US5424221900,"Fairmont, WV Micro Area; Fairmont-Clarksburg, WV CSA; West Virginia",15027,11349,4111,919,657,2535,7238,3678,990,473,44,29,400,517,2688,1453,321,155,977,1235
ACSSF,2010e5,wv,000,0034,0005980,341,54,   ,34100US5454847900,"Washington-Arlington-Alexandria, DC-VA-MD-WV Metro Area (part); Washington-Baltimore-Northern Virginia, DC-MD-VA-WV CSA (part); West Virginia",13590,11147,4733,1175,1033,2525,6414,2443,850,354,147,17,190,496,1593,840,182,137,521,753
ACSSF,2010e5,wv,000,0034,0005981,341,54,   ,34100US5454849020,"Winchester, VA-WV Metro Area (part); Washington-Baltimore-Northern Virginia, DC-MD-VA-WV CSA (part); West Virginia",5804,4350,1441,218,310,913,2909,1454,379,191,16,0,175,188,1075,630,57,94,479,445
ACSSF,2010e5,wv,000,0034,0005982,500,54,   ,50000US5401,"Congressional District 1 (111th Congress), West Virginia",159570,124150,42922,8938,8039,25945,81228,35420,9529,4687,1485,441,2761,4842,25891,14125,3273,2083,8769,11766
ACSSF,2010e5,wv,000,0034,0005983,500,54,   ,50000US5402,"Congressional District 2 (111th Congress), West Virginia",170409,133568,47246,9670,9568,28008,86322,36841,10273,5258,1394,599,3265,5015,26568,14642,3600,2545,8497,11926
ACSSF,2010e5,wv,000,0034,0005984,500,54,   ,50000US5403,"Congressional District 3 (111th Congress), West Virginia",160004,122919,41749,9060,7546,25143,81170,37085,10153,4523,1258,355,2910,5630,26932,13116,3027,1929,8160,13816
ACSSF,2010e5,wv,000,0034,0005985,510,54,001,51000US5401001,"Barbour County, Congressional District 1 (111th Congress), West Virginia",4245,3304,904,174,163,567,2400,941,341,128,21,35,72,213,600,342,34,106,202,258
ACSSF,2010e5,wv,000,0034,0005986,510,54,009,51000US5401009,"Brooke County, Congressional District 1 (111th Congress), West Virginia",6578,4979,1442,182,426,834,3537,1599,497,241,56,20,165,256,1102,724,166,138,420,378
ACSSF,2010e5,wv,000,0034,0005987,510,54,017,51000US5401017,"Doddridge County, Congressional District 1 (111th Congress), West Virginia",1999,1482,441,34,69,338,1041,517,178,126,94,3,29,52,339,158,0,37,121,181
ACSSF,2010e5,wv,000,0034,0005988,510,54,021,51000US5401021,"Gilmer County, Congressional District 1 (111th Congress), West Virginia",1549,1155,395,70,50,275,760,394,88,19,0,5,14,69,306,141,21,28,92,165
ACSSF,2010e5,wv,000,0034,0005989,510,54,023,51000US5401023,"Grant County, Congressional District 1 (111th Congress), West Virginia",3451,2789,908,283,172,453,1881,662,184,108,50,0,58,76,478,321,111,14,196,157
ACSSF,2010e5,wv,000,0034,0005990,510,54,029,51000US5401029,"Hancock County, Congressional District 1 (111th Congress), West Virginia",8882,6766,2246,524,498,1224,4520,2116,640,354,126,16,212,286,1476,730,75,180,475,746
ACSSF,2010e5,wv,000,0034,0005991,510,54,033,51000US5401033,"Harrison County, Congressional District 1 (111th Congress), West Virginia",18968,14266,5062,963,930,3169,9204,4702,1006,453,68,20,365,553,3696,1911,482,213,1216,1785
ACSSF,2010e5,wv,000,0034,0005992,510,54,049,51000US5401049,"Marion County, Congressional District 1 (111th Congress), West Virginia",15027,11349,4111,919,657,2535,7238,3678,990,473,44,29,400,517,2688,1453,321,155,977,1235
ACSSF,2010e5,wv,000,0034,0005993,510,54,051,51000US5401051,"Marshall County, Congressional District 1 (111th Congress), West Virginia",9385,7314,2474,441,497,1536,4840,2071,614,307,134,0,173,307,1457,764,223,71,470,693
ACSSF,2010e5,wv,000,0034,0005994,510,54,057,51000US5401057,"Mineral County, Congressional District 1 (111th Congress), West Virginia",7710,6020,1847,396,375,1076,4173,1690,446,296,104,74,118,150,1244,861,116,83,662,383
ACSSF,2010e5,wv,000,0034,0005995,510,54,061,51000US5401061,"Monongalia County, Congressional District 1 (111th Congress), West Virginia",18785,15061,5783,1566,1168,3049,9278,3724,1190,518,194,72,252,672,2534,1356,375,153,828,1178
ACSSF,2010e5,wv,000,0034,0005996,510,54,069,51000US5401069,"Ohio County, Congressional District 1 (111th Congress), West Virginia",11486,8888,3045,488,568,1989,5843,2598,450,217,96,0,121,233,2148,1146,299,252,595,1002
ACSSF,2010e5,wv,000,0034,0005997,510,54,073,51000US5401073,"Pleasants County, Congressional District 1 (111th Congress), West Virginia",1674,1394,488,71,52,365,906,280,81,45,0,7,38,36,199,109,19,7,83,90
ACSSF,2010e5,wv,000,0034,0005998,510,54,077,51000US5401077,"Preston County, Congressional District 1 (111th Congress), West Virginia",9003,7359,2605,691,336,1578,4754,1644,434,214,89,20,105,220,1210,640,157,146,337,570
ACSSF,2010e5,wv,000,0034,0005999,510,54,085,51000US5401085,"Ritchie County, Congressional District 1 (111th Congress), West Virginia",2924,2254,693,123,183,387,1561,670,230,93,48,2,43,137,440,243,39,27,177,197
ACSSF,2010e5,wv,000,0034,0006000,510,54,091,51000US5401091,"Taylor County, Congressional District 1 (111th Congress), West Virginia",4588,3537,1323,301,261,761,2214,1051,250,49,0,15,34,201,801,475,43,88,344,326
ACSSF,2010e5,wv,000,0034,0006001,510,54,093,51000US5401093,"Tucker County, Congressional District 1 (111th Congress), West Virginia",2072,1673,550,99,71,380,1123,399,134,58,22,0,36,76,265,90,50,27,13,175
ACSSF,2010e5,wv,000,0034,0006002,510,54,095,51000US5401095,"Tyler County, Congressional District 1 (111th Congress), West Virginia",2585,2074,664,128,121,415,1410,511,178,96,55,3,38,82,333,144,12,6,126,189
ACSSF,2010e5,wv,000,0034,0006003,510,54,103,51000US5401103,"Wetzel County, Congressional District 1 (111th Congress), West Virginia",4725,3845,1275,247,225,803,2570,880,198,104,31,13,60,94,682,349,80,74,195,333
ACSSF,2010e5,wv,000,0034,0006004,510,54,107,51000US5401107,"Wood County, Congressional District 1 (111th Congress), West Virginia",23934,18641,6666,1238,1217,4211,11975,5293,1400,788,253,107,428,612,3893,2168,650,278,1240,1725
ACSSF,2010e5,wv,000,0034,0006005,510,54,003,51000US5402003,"Berkeley County, Congressional District 2 (111th Congress), West Virginia",26475,20223,7980,1978,1632,4370,12243,6252,2018,1239,338,273,628,779,4234,2363,823,303,1237,1871
ACSSF,2010e5,wv,000,0034,0006006,510,54,007,51000US5402007,"Braxton County, Congressional District 2 (111th Congress), West Virginia",3904,3198,881,120,172,589,2317,706,213,88,0,4,84,125,493,297,81,46,170,196
ACSSF,2010e5,wv,000,0034,0006007,510,54,013,51000US5402013,"Calhoun County, Congressional District 2 (111th Congress), West Virginia",2063,1537,464,8,106,350,1073,526,238,120,63,44,13,118,288,97,23,0,74,191
ACSSF,2010e5,wv,000,0034,0006008,510,54,015,51000US5402015,"Clay County, Congressional District 2 (111th Congress), West Virginia",2428,1930,771,99,154,518,1159,498,174,52,14,0,38,122,324,148,10,43,95,176
ACSSF,2010e5,wv,000,0034,0006009,510,54,027,51000US5402027,"Hampshire County, Congressional District 2 (111th Congress), West Virginia",5804,4350,1441,218,310,913,2909,1454,379,191,16,0,175,188,1075,630,57,94,479,445
ACSSF,2010e5,wv,000,0034,0006010,510,54,031,51000US5402031,"Hardy County, Congressional District 2 (111th Congress), West Virginia",3016,2437,495,68,115,312,1942,579,148,59,17,0,42,89,431,262,55,79,128,169
ACSSF,2010e5,wv,000,0034,0006011,510,54,035,51000US5402035,"Jackson County, Congressional District 2 (111th Congress), West Virginia",8414,6722,2446,542,535,1369,4276,1692,545,393,119,36,238,152,1147,613,110,50,453,534
ACSSF,2010e5,wv,000,0034,0006012,510,54,037,51000US5402037,"Jefferson County, Congressional District 2 (111th Congress), West Virginia",13590,11147,4733,1175,1033,2525,6414,2443,850,354,147,17,190,496,1593,840,182,137,521,753
ACSSF,2010e5,wv,000,0034,0006013,510,54,039,51000US5402039,"Kanawha County, Congressional District 2 (111th Congress), West Virginia",51064,38518,12743,2751,2413,7579,25775,12546,2944,1488,359,123,1006,1456,9602,5244,1366,827,3051,4358
ACSSF,2010e5,wv,000,0034,0006014,510,54,041,51000US5402041,"Lewis County, Congressional District 2 (111th Congress), West Virginia",4243,3446,1044,118,237,689,2402,797,225,106,49,10,47,119,572,409,103,60,246,163
ACSSF,2010e5,wv,000,0034,0006015,510,54,053,51000US5402053,"Mason County, Congressional District 2 (111th Congress), West Virginia",7594,5757,1950,291,481,1178,3807,1837,442,255,36,9,210,187,1395,814,297,71,446,581
ACSSF,2010e5,wv,000,0034,0006016,510,54,065,51000US5402065,"Morgan County, Congressional District 2 (111th Congress), West Virginia",4082,3219,965,126,230,609,2254,863,270,150,59,10,81,120,593,335,6,34,295,258
ACSSF,2010e5,wv,000,0034,0006017,510,54,071,51000US5402071,"Pendleton County, Congressional District 2 (111th Congress), West Virginia",2211,1841,528,70,155,303,1313,370,99,48,21,0,27,51,271,137,40,34,63,134
ACSSF,2010e5,wv,000,0034,0006018,510,54,079,51000US5402079,"Putnam County, Congressional District 2 (111th Congress), West Virginia",15929,13121,5418,1092,1000,3326,7703,2808,783,350,20,37,293,433,2025,1178,248,298,632,847
ACSSF,2010e5,wv,000,0034,0006019,510,54,083,51000US5402083,"Randolph County, Congressional District 2 (111th Congress), West Virginia",7691,6295,2034,278,390,1366,4261,1396,393,171,78,5,88,222,1003,575,84,164,327,428
ACSSF,2010e5,wv,000,0034,0006020,510,54,087,51000US5402087,"Roane County, Congressional District 2 (111th Congress), West Virginia",4008,3273,1056,256,150,650,2217,735,139,33,0,0,33,106,596,222,62,116,44,374
ACSSF,2010e5,wv,000,0034,0006021,510,54,097,51000US5402097,"Upshur County, Congressional District 2 (111th Congress), West Virginia",6196,5107,1856,368,353,1135,3251,1089,349,130,44,31,55,219,740,349,36,177,136,391
ACSSF,2010e5,wv,000,0034,0006022,510,54,105,51000US5402105,"Wirt County, Congressional District 2 (111th Congress), West Virginia",1697,1447,441,112,102,227,1006,250,64,31,14,0,17,33,186,129,17,12,100,57
ACSSF,2010e5,wv,000,0034,0006023,510,54,005,51000US5403005,"Boone County, Congressional District 3 (111th Congress), West Virginia",7180,5697,2137,367,433,1337,3560,1483,491,156,44,0,112,335,992,416,72,58,286,576
ACSSF,2010e5,wv,000,0034,0006024,510,54,011,51000US5403011,"Cabell County, Congressional District 3 (111th Congress), West Virginia",24695,18320,6152,1507,1177,3468,12168,6375,1395,719,192,10,517,676,4980,2856,612,498,1746,2124
ACSSF,2010e5,wv,000,0034,0006025,510,54,019,51000US5403019,"Fayette County, Congressional District 3 (111th Congress), West Virginia",12344,9215,2911,521,574,1816,6304,3129,911,407,189,20,198,504,2218,977,126,159,692,1241
ACSSF,2010e5,wv,000,0034,0006026,510,54,025,51000US5403025,"Greenbrier County, Congressional District 3 (111th Congress), West Virginia",9977,7505,2479,658,518,1303,5026,2472,717,310,93,24,193,407,1755,905,194,124,587,850
ACSSF,2010e5,wv,000,0034,0006027,510,54,043,51000US5403043,"Lincoln County, Congressional District 3 (111th Congress), West Virginia",6552,4941,2022,571,233,1218,2919,1611,464,201,49,38,114,263,1147,628,165,138,325,519
ACSSF,2010e5,wv,000,0034,0006028,510,54,045,51000US5403045,"Logan County, Congressional District 3 (111th Congress), West Virginia",10514,7853,2800,500,612,1688,5053,2661,618,307,127,0,180,311,2043,692,176,105,411,1351
ACSSF,2010e5,wv,000,0034,0006029,510,54,047,51000US5403047,"McDowell County, Congressional District 3 (111th Congress), West Virginia",5490,4142,1201,171,226,804,2941,1348,334,101,2,20,79,233,1014,521,30,90,401,493
ACSSF,2010e5,wv,000,0034,0006030,510,54,055,51000US5403055,"Mercer County, Congressional District 3 (111th Congress), West Virginia",16011,12278,3779,815,667,2297,8499,3733,1014,478,163,74,241,536,2719,1449,448,127,874,1270
ACSSF,2010e5,wv,000,0034,0006031,510,54,059,51000US5403059,"Mingo County, Congressional District 3 (111th Congress), West Virginia",7487,5598,1917,467,237,1213,3681,1889,574,196,61,34,101,378,1315,560,127,101,332,755
ACSSF,2010e5,wv,000,0034,0006032,510,54,063,51000US5403063,"Monroe County, Congressional District 3 (111th Congress), West Virginia",3922,3297,965,299,163,503,2332,625,198,71,0,0,71,127,427,151,61,11,79,276
ACSSF,2010e5,wv,000,0034,0006033,510,54,067,51000US5403067,"Nicholas County, Congressional District 3 (111th Congress), West Virginia",7671,6363,2153,392,325,1436,4210,1308,535,300,76,0,224,235,773,237,37,51,149,536
ACSSF,2010e5,wv,000,0034,0006034,510,54,075,51000US5403075,"Pocahontas County, Congressional District 3 (111th Congress), West Virginia",2703,2274,757,131,121,505,1517,429,159,73,17,0,56,86,270,193,67,18,108,77
ACSSF,2010e5,wv,000,0034,0006035,510,54,081,51000US5403081,"Raleigh County, Congressional District 3 (111th Congress), West Virginia",21014,16081,5693,1226,1011,3456,10388,4933,1305,530,103,88,339,775,3628,1746,437,294,1015,1882
ACSSF,2010e5,wv,000,0034,0006036,510,54,089,51000US5403089,"Summers County, Congressional District 3 (111th Congress), West Virginia",3196,2443,716,162,122,432,1727,753,266,116,19,0,97,150,487,183,0,14,169,304
ACSSF,2010e5,wv,000,0034,0006037,510,54,099,51000US5403099,"Wayne County, Congressional District 3 (111th Congress), West Virginia",11756,9259,3340,778,661,1901,5919,2497,637,302,66,47,189,335,1860,921,199,91,631,939
ACSSF,2010e5,wv,000,0034,0006038,510,54,101,51000US5403101,"Webster County, Congressional District 3 (111th Congress), West Virginia",2927,2365,884,149,178,557,1481,562,216,123,57,0,66,93,346,182,119,10,53,164
ACSSF,2010e5,wv,000,0034,0006039,510,54,109,51000US5403109,"Wyoming County, Congressional District 3 (111th Congress), West Virginia",6565,5288,1843,346,288,1209,3445,1277,319,133,0,0,133,186,958,499,157,40,302,459
ACSSF,2010e5,wv,000,0034,0006040,610,54,   ,61000US54001,"State Senate District 1 (2010), West Virginia",26120,20186,6619,1194,1471,3954,13567,5934,1521,787,267,36,484,734,4413,2406,465,505,1436,2007
ACSSF,2010e5,wv,000,0034,0006041,610,54,   ,61000US54002,"State Senate District 2 (2010), West Virginia",28113,22052,7178,1171,1426,4581,14874,6061,1854,959,457,94,408,895,4207,2128,512,292,1324,2079
ACSSF,2010e5,wv,000,0034,0006042,610,54,   ,61000US54003,"State Senate District 3 (2010), West Virginia",29859,23631,8251,1591,1411,5249,15380,6228,1619,877,267,114,496,742,4609,2564,710,413,1441,2045
ACSSF,2010e5,wv,000,0034,0006043,610,54,   ,61000US54004,"State Senate District 4 (2010), West Virginia",33391,26724,10214,2011,2126,6077,16510,6667,1835,1018,175,82,761,817,4832,2669,693,419,1557,2163
ACSSF,2010e5,wv,000,0034,0006044,610,54,   ,61000US54005,"State Senate District 5 (2010), West Virginia",26599,19724,6542,1613,1301,3628,13182,6875,1516,791,233,10,548,725,5359,3046,670,519,1857,2313
ACSSF,2010e5,wv,000,0034,0006045,610,54,   ,61000US54006,"State Senate District 6 (2010), West Virginia",24365,18695,6107,1278,1024,3805,12588,5670,1595,637,163,118,356,958,4075,1924,346,277,1301,2151
ACSSF,2010e5,wv,000,0034,0006046,610,54,   ,61000US54007,"State Senate District 7 (2010), West Virginia",29220,22529,8562,1807,1546,5209,13967,6691,1701,674,220,38,416,1027,4990,2119,489,333,1297,2871
ACSSF,2010e5,wv,000,0034,0006047,610,54,   ,61000US54009,"State Senate District 9 (2010), West Virginia",26813,20687,7266,1530,1278,4458,13421,6126,1624,663,103,88,472,961,4502,2228,594,334,1300,2274
ACSSF,2010e5,wv,000,0034,0006048,610,54,   ,61000US54010,"State Senate District 10 (2010), West Virginia",28321,21729,6785,1694,1230,3861,14944,6592,1959,855,200,81,574,1104,4633,2350,597,268,1485,2283
ACSSF,2010e5,wv,000,0034,0006049,610,54,   ,61000US54011,"State Senate District 11 (2010), West Virginia",29801,23566,8062,1380,1492,5190,15504,6235,2113,1012,380,51,581,1101,4122,1717,295,400,1022,2405
ACSSF,2010e5,wv,000,0034,0006050,610,54,   ,61000US54012,"State Senate District 12 (2010), West Virginia",28664,22065,7382,1271,1389,4722,14683,6599,1532,666,117,39,510,866,5067,2758,687,347,1724,2309
ACSSF,2010e5,wv,000,0034,0006051,610,54,   ,61000US54013,"State Senate District 13 (2010), West Virginia",26149,19917,7335,1950,1291,4094,12582,6232,1810,808,159,72,577,1002,4422,2374,535,256,1583,2048
ACSSF,2010e5,wv,000,0034,0006052,610,54,   ,61000US54014,"State Senate District 14 (2010), West Virginia",32445,25989,8995,2049,1617,5329,16994,6456,1827,844,294,144,406,983,4629,2694,522,490,1682,1935
ACSSF,2010e5,wv,000,0034,0006053,610,54,   ,61000US54015,"State Senate District 15 (2010), West Virginia",31403,25108,7915,1370,1669,4876,17193,6295,1942,979,313,45,621,963,4353,2549,449,437,1663,1804
ACSSF,2010e5,wv,000,0034,0006054,610,54,   ,61000US54016,"State Senate District 16 (2010), West Virginia",37656,29517,11961,3008,2469,6484,17556,8139,2563,1410,430,260,720,1153,5576,3113,970,440,1703,2463
ACSSF,2010e5,wv,000,0034,0006055,610,54,   ,61000US54817,"State Senate District 817 (2010), West Virginia",51064,38518,12743,2751,2413,7579,25775,12546,2944,1488,359,123,1006,1456,9602,5244,1366,827,3051,4358
ACSSF,2010e5,wv,000,0034,0006056,612,54,009,61200US54001009,"Brooke County, State Senate District 1 (2010), West Virginia",6578,4979,1442,182,426,834,3537,1599,497,241,56,20,165,256,1102,724,166,138,420,378
ACSSF,2010e5,wv,000,0034,0006057,612,54,029,61200US54001029,"Hancock County, State Senate District 1 (2010), West Virginia",8882,6766,2246,524,498,1224,4520,2116,640,354,126,16,212,286,1476,730,75,180,475,746
ACSSF,2010e5,wv,000,0034,0006058,612,54,069,61200US54001069,"Ohio County (part), State Senate District 1 (2010), West Virginia",10660,8441,2931,488,547,1896,5510,2219,384,192,85,0,107,192,1835,952,224,187,541,883
ACSSF,2010e5,wv,000,0034,0006059,612,54,013,61200US54002013,"Calhoun County, State Senate District 2 (2010), West Virginia",2063,1537,464,8,106,350,1073,526,238,120,63,44,13,118,288,97,23,0,74,191
ACSSF,2010e5,wv,000,0034,0006060,612,54,017,61200US54002017,"Doddridge County, State Senate District 2 (2010), West Virginia",1999,1482,441,34,69,338,1041,517,178,126,94,3,29,52,339,158,0,37,121,181
ACSSF,2010e5,wv,000,0034,0006061,612,54,049,61200US54002049,"Marion County (part), State Senate District 2 (2010), West Virginia",1379,1124,371,77,64,230,753,255,95,43,0,29,14,52,160,80,21,12,47,80
ACSSF,2010e5,wv,000,0034,0006062,612,54,051,61200US54002051,"Marshall County, State Senate District 2 (2010), West Virginia",9385,7314,2474,441,497,1536,4840,2071,614,307,134,0,173,307,1457,764,223,71,470,693
ACSSF,2010e5,wv,000,0034,0006063,612,54,061,61200US54002061,"Monongalia County (part), State Senate District 2 (2010), West Virginia",2227,1975,682,113,140,429,1293,252,57,45,21,0,24,12,195,99,39,0,60,96
ACSSF,2010e5,wv,000,0034,0006064,612,54,069,61200US54002069,"Ohio County (part), State Senate District 2 (2010), West Virginia",826,447,114,0,21,93,333,379,66,25,11,0,14,41,313,194,75,65,54,119
ACSSF,2010e5,wv,000,0034,0006065,612,54,085,61200US54002085,"Ritchie County, State Senate District 2 (2010), West Virginia",2924,2254,693,123,183,387,1561,670,230,93,48,2,43,137,440,243,39,27,177,197
ACSSF,2010e5,wv,000,0034,0006066,612,54,095,61200US54002095,"Tyler County, State Senate District 2 (2010), West Virginia",2585,2074,664,128,121,415,1410,511,178,96,55,3,38,82,333,144,12,6,126,189
ACSSF,2010e5,wv,000,0034,0006067,612,54,103,61200US54002103,"Wetzel County, State Senate District 2 (2010), West Virginia",4725,3845,1275,247,225,803,2570,880,198,104,31,13,60,94,682,349,80,74,195,333
ACSSF,2010e5,wv,000,0034,0006068,612,54,073,61200US54003073,"Pleasants County, State Senate District 3 (2010), West Virginia",1674,1394,488,71,52,365,906,280,81,45,0,7,38,36,199,109,19,7,83,90
ACSSF,2010e5,wv,000,0034,0006069,612,54,087,61200US54003087,"Roane County (part), State Senate District 3 (2010), West Virginia",2554,2149,656,170,40,446,1493,405,74,13,0,0,13,61,331,158,24,116,18,173
ACSSF,2010e5,wv,000,0034,0006070,612,54,105,61200US54003105,"Wirt County, State Senate District 3 (2010), West Virginia",1697,1447,441,112,102,227,1006,250,64,31,14,0,17,33,186,129,17,12,100,57
ACSSF,2010e5,wv,000,0034,0006071,612,54,107,61200US54003107,"Wood County, State Senate District 3 (2010), West Virginia",23934,18641,6666,1238,1217,4211,11975,5293,1400,788,253,107,428,612,3893,2168,650,278,1240,1725
ACSSF,2010e5,wv,000,0034,0006072,612,54,035,61200US54004035,"Jackson County, State Senate District 4 (2010), West Virginia",8414,6722,2446,542,535,1369,4276,1692,545,393,119,36,238,152,1147,613,110,50,453,534
ACSSF,2010e5,wv,000,0034,0006073,612,54,053,61200US54004053,"Mason County, State Senate District 4 (2010), West Virginia",7594,5757,1950,291,481,1178,3807,1837,442,255,36,9,210,187,1395,814,297,71,446,581
ACSSF,2010e5,wv,000,0034,0006074,612,54,079,61200US54004079,"Putnam County, State Senate District 4 (2010), West Virginia",15929,13121,5418,1092,1000,3326,7703,2808,783,350,20,37,293,433,2025,1178,248,298,632,847
ACSSF,2010e5,wv,000,0034,0006075,612,54,087,61200US54004087,"Roane County (part), State Senate District 4 (2010), West Virginia",1454,1124,400,86,110,204,724,330,65,20,0,0,20,45,265,64,38,0,26,201
ACSSF,2010e5,wv,000,0034,0006076,612,54,011,61200US54005011,"Cabell County, State Senate District 5 (2010), West Virginia",24695,18320,6152,1507,1177,3468,12168,6375,1395,719,192,10,517,676,4980,2856,612,498,1746,2124
ACSSF,2010e5,wv,000,0034,0006077,612,54,099,61200US54005099,"Wayne County (part), State Senate District 5 (2010), West Virginia",1904,1404,390,106,124,160,1014,500,121,72,41,0,31,49,379,190,58,21,111,189
ACSSF,2010e5,wv,000,0034,0006078,612,54,047,61200US54006047,"McDowell County, State Senate District 6 (2010), West Virginia",5490,4142,1201,171,226,804,2941,1348,334,101,2,20,79,233,1014,521,30,90,401,493
ACSSF,2010e5,wv,000,0034,0006079,612,54,055,61200US54006055,"Mercer County (part), State Senate District 6 (2010), West Virginia",5744,4456,1372,295,271,806,3084,1288,299,120,75,17,28,179,989,478,124,48,306,511
ACSSF,2010e5,wv,000,0034,0006080,612,54,059,61200US54006059,"Mingo County, State Senate District 6 (2010), West Virginia",7487,5598,1917,467,237,1213,3681,1889,574,196,61,34,101,378,1315,560,127,101,332,755
ACSSF,2010e5,wv,000,0034,0006081,612,54,099,61200US54006099,"Wayne County (part), State Senate District 6 (2010), West Virginia",4878,3817,1347,303,269,775,2470,1061,388,220,25,47,148,168,673,348,65,38,245,325
ACSSF,2010e5,wv,000,0034,0006082,612,54,109,61200US54006109,"Wyoming County (part), State Senate District 6 (2010), West Virginia",766,682,270,42,21,207,412,84,0,0,0,0,0,0,84,17,0,0,17,67
ACSSF,2010e5,wv,000,0034,0006083,612,54,005,61200US54007005,"Boone County, State Senate District 7 (2010), West Virginia",7180,5697,2137,367,433,1337,3560,1483,491,156,44,0,112,335,992,416,72,58,286,576
ACSSF,2010e5,wv,000,0034,0006084,612,54,043,61200US54007043,"Lincoln County, State Senate District 7 (2010), West Virginia",6552,4941,2022,571,233,1218,2919,1611,464,201,49,38,114,263,1147,628,165,138,325,519
ACSSF,2010e5,wv,000,0034,0006085,612,54,045,61200US54007045,"Logan County, State Senate District 7 (2010), West Virginia",10514,7853,2800,500,612,1688,5053,2661,618,307,127,0,180,311,2043,692,176,105,411,1351
ACSSF,2010e5,wv,000,0034,0006086,612,54,099,61200US54007099,"Wayne County (part), State Senate District 7 (2010), West Virginia",4974,4038,1603,369,268,966,2435,936,128,10,0,0,10,118,808,383,76,32,275,425
ACSSF,2010e5,wv,000,0034,0006087,612,54,081,61200US54009081,"Raleigh County, State Senate District 9 (2010), West Virginia",21014,16081,5693,1226,1011,3456,10388,4933,1305,530,103,88,339,775,3628,1746,437,294,1015,1882
ACSSF,2010e5,wv,000,0034,0006088,612,54,109,61200US54009109,"Wyoming County (part), State Senate District 9 (2010), West Virginia",5799,4606,1573,304,267,1002,3033,1193,319,133,0,0,133,186,874,482,157,40,285,392
ACSSF,2010e5,wv,000,0034,0006089,612,54,019,61200US54010019,"Fayette County (part), State Senate District 10 (2010), West Virginia",959,662,218,55,31,132,444,297,63,0,0,0,0,63,234,140,18,40,82,94
ACSSF,2010e5,wv,000,0034,0006090,612,54,025,61200US54010025,"Greenbrier County, State Senate District 10 (2010), West Virginia",9977,7505,2479,658,518,1303,5026,2472,717,310,93,24,193,407,1755,905,194,124,587,850
ACSSF,2010e5,wv,000,0034,0006091,612,54,055,61200US54010055,"Mercer County (part), State Senate District 10 (2010), West Virginia",10267,7822,2407,520,396,1491,5415,2445,715,358,88,57,213,357,1730,971,324,79,568,759
ACSSF,2010e5,wv,000,0034,0006092,612,54,063,61200US54010063,"Monroe County, State Senate District 10 (2010), West Virginia",3922,3297,965,299,163,503,2332,625,198,71,0,0,71,127,427,151,61,11,79,276
ACSSF,2010e5,wv,000,0034,0006093,612,54,089,61200US54010089,"Summers County, State Senate District 10 (2010), West Virginia",3196,2443,716,162,122,432,1727,753,266,116,19,0,97,150,487,183,0,14,169,304
ACSSF,2010e5,wv,000,0034,0006094,612,54,015,61200US54011015,"Clay County, State Senate District 11 (2010), West Virginia",2428,1930,771,99,154,518,1159,498,174,52,14,0,38,122,324,148,10,43,95,176
ACSSF,2010e5,wv,000,0034,0006095,612,54,019,61200US54011019,"Fayette County (part), State Senate District 11 (2010), West Virginia",11385,8553,2693,466,543,1684,5860,2832,848,407,189,20,198,441,1984,837,108,119,610,1147
ACSSF,2010e5,wv,000,0034,0006096,612,54,067,61200US54011067,"Nicholas County, State Senate District 11 (2010), West Virginia",7671,6363,2153,392,325,1436,4210,1308,535,300,76,0,224,235,773,237,37,51,149,536
ACSSF,2010e5,wv,000,0034,0006097,612,54,097,61200US54011097,"Upshur County (part), State Senate District 11 (2010), West Virginia",5390,4355,1561,274,292,995,2794,1035,340,130,44,31,55,210,695,313,21,177,115,382
ACSSF,2010e5,wv,000,0034,0006098,612,54,101,61200US54011101,"Webster County, State Senate District 11 (2010), West Virginia",2927,2365,884,149,178,557,1481,562,216,123,57,0,66,93,346,182,119,10,53,164
ACSSF,2010e5,wv,000,0034,0006099,612,54,007,61200US54012007,"Braxton County, State Senate District 12 (2010), West Virginia",3904,3198,881,120,172,589,2317,706,213,88,0,4,84,125,493,297,81,46,170,196
ACSSF,2010e5,wv,000,0034,0006100,612,54,021,61200US54012021,"Gilmer County, State Senate District 12 (2010), West Virginia",1549,1155,395,70,50,275,760,394,88,19,0,5,14,69,306,141,21,28,92,165
ACSSF,2010e5,wv,000,0034,0006101,612,54,033,61200US54012033,"Harrison County, State Senate District 12 (2010), West Virginia",18968,14266,5062,963,930,3169,9204,4702,1006,453,68,20,365,553,3696,1911,482,213,1216,1785
ACSSF,2010e5,wv,000,0034,0006102,612,54,041,61200US54012041,"Lewis County, State Senate District 12 (2010), West Virginia",4243,3446,1044,118,237,689,2402,797,225,106,49,10,47,119,572,409,103,60,246,163
ACSSF,2010e5,wv,000,0034,0006103,612,54,049,61200US54013049,"Marion County (part), State Senate District 13 (2010), West Virginia",13648,10225,3740,842,593,2305,6485,3423,895,430,44,0,386,465,2528,1373,300,143,930,1155
ACSSF,2010e5,wv,000,0034,0006104,612,54,061,61200US54013061,"Monongalia County (part), State Senate District 13 (2010), West Virginia",12501,9692,3595,1108,698,1789,6097,2809,915,378,115,72,191,537,1894,1001,235,113,653,893
ACSSF,2010e5,wv,000,0034,0006105,612,54,001,61200US54014001,"Barbour County, State Senate District 14 (2010), West Virginia",4245,3304,904,174,163,567,2400,941,341,128,21,35,72,213,600,342,34,106,202,258
ACSSF,2010e5,wv,000,0034,0006106,612,54,023,61200US54014023,"Grant County (part), State Senate District 14 (2010), West Virginia",770,702,260,43,81,136,442,68,4,4,0,0,4,0,64,30,21,0,9,34
ACSSF,2010e5,wv,000,0034,0006107,612,54,057,61200US54014057,"Mineral County, State Senate District 14 (2010), West Virginia",7710,6020,1847,396,375,1076,4173,1690,446,296,104,74,118,150,1244,861,116,83,662,383
ACSSF,2010e5,wv,000,0034,0006108,612,54,061,61200US54014061,"Monongalia County (part), State Senate District 14 (2010), West Virginia",4057,3394,1506,345,330,831,1888,663,218,95,58,0,37,123,445,256,101,40,115,189
ACSSF,2010e5,wv,000,0034,0006109,612,54,077,61200US54014077,"Preston County, State Senate District 14 (2010), West Virginia",9003,7359,2605,691,336,1578,4754,1644,434,214,89,20,105,220,1210,640,157,146,337,570
ACSSF,2010e5,wv,000,0034,0006110,612,54,091,61200US54014091,"Taylor County, State Senate District 14 (2010), West Virginia",4588,3537,1323,301,261,761,2214,1051,250,49,0,15,34,201,801,475,43,88,344,326
ACSSF,2010e5,wv,000,0034,0006111,612,54,093,61200US54014093,"Tucker County, State Senate District 14 (2010), West Virginia",2072,1673,550,99,71,380,1123,399,134,58,22,0,36,76,265,90,50,27,13,175
ACSSF,2010e5,wv,000,0034,0006112,612,54,003,61200US54015003,"Berkeley County (part), State Senate District 15 (2010), West Virginia",2409,1853,752,145,196,411,1101,556,305,183,55,30,98,122,251,90,35,0,55,161
ACSSF,2010e5,wv,000,0034,0006113,612,54,023,61200US54015023,"Grant County (part), State Senate District 15 (2010), West Virginia",2681,2087,648,240,91,317,1439,594,180,104,50,0,54,76,414,291,90,14,187,123
ACSSF,2010e5,wv,000,0034,0006114,612,54,027,61200US54015027,"Hampshire County, State Senate District 15 (2010), West Virginia",5804,4350,1441,218,310,913,2909,1454,379,191,16,0,175,188,1075,630,57,94,479,445
ACSSF,2010e5,wv,000,0034,0006115,612,54,031,61200US54015031,"Hardy County, State Senate District 15 (2010), West Virginia",3016,2437,495,68,115,312,1942,579,148,59,17,0,42,89,431,262,55,79,128,169
ACSSF,2010e5,wv,000,0034,0006116,612,54,065,61200US54015065,"Morgan County, State Senate District 15 (2010), West Virginia",4082,3219,965,126,230,609,2254,863,270,150,59,10,81,120,593,335,6,34,295,258
ACSSF,2010e5,wv,000,0034,0006117,612,54,071,61200US54015071,"Pendleton County, State Senate District 15 (2010), West Virginia",2211,1841,528,70,155,303,1313,370,99,48,21,0,27,51,271,137,40,34,63,134
ACSSF,2010e5,wv,000,0034,0006118,612,54,075,61200US54015075,"Pocahontas County, State Senate District 15 (2010), West Virginia",2703,2274,757,131,121,505,1517,429,159,73,17,0,56,86,270,193,67,18,108,77
ACSSF,2010e5,wv,000,0034,0006119,612,54,083,61200US54015083,"Randolph County, State Senate District 15 (2010), West Virginia",7691,6295,2034,278,390,1366,4261,1396,393,171,78,5,88,222,1003,575,84,164,327,428
ACSSF,2010e5,wv,000,0034,0006120,612,54,097,61200US54015097,"Upshur County (part), State Senate District 15 (2010), West Virginia",806,752,295,94,61,140,457,54,9,0,0,0,0,9,45,36,15,0,21,9
ACSSF,2010e5,wv,000,0034,0006121,612,54,003,61200US54016003,"Berkeley County (part), State Senate District 16 (2010), West Virginia",24066,18370,7228,1833,1436,3959,11142,5696,1713,1056,283,243,530,657,3983,2273,788,303,1182,1710
ACSSF,2010e5,wv,000,0034,0006122,612,54,037,61200US54016037,"Jefferson County, State Senate District 16 (2010), West Virginia",13590,11147,4733,1175,1033,2525,6414,2443,850,354,147,17,190,496,1593,840,182,137,521,753
ACSSF,2010e5,wv,000,0034,0006123,612,54,039,61200US54817039,"Kanawha County, State Senate District 817 (2010), West Virginia",51064,38518,12743,2751,2413,7579,25775,12546,2944,1488,359,123,1006,1456,9602,5244,1366,827,3051,4358
ACSSF,2010e5,wv,000,0034,0006124,620,54,   ,62000US54001,"State House District 1 (2010), West Virginia",9454,7144,2350,524,536,1290,4794,2310,673,365,126,16,223,308,1637,831,83,250,498,806
ACSSF,2010e5,wv,000,0034,0006125,620,54,   ,62000US54002,"State House District 2 (2010), West Virginia",9019,7157,2152,310,582,1260,5005,1862,564,277,75,20,182,287,1298,812,234,68,510,486
ACSSF,2010e5,wv,000,0034,0006126,620,54,   ,62000US54003,"State House District 3 (2010), West Virginia",8452,6318,2231,360,374,1497,4087,2134,350,170,77,0,93,180,1784,957,223,252,482,827
ACSSF,2010e5,wv,000,0034,0006127,620,54,   ,62000US54004,"State House District 4 (2010), West Virginia",9406,7328,2474,441,497,1536,4854,2078,614,307,134,0,173,307,1464,764,223,71,470,700
ACSSF,2010e5,wv,000,0034,0006128,620,54,   ,62000US54005,"State House District 5 (2010), West Virginia",4831,3993,1350,257,225,868,2643,838,205,111,45,13,53,94,633,323,54,74,195,310
ACSSF,2010e5,wv,000,0034,0006129,620,54,   ,62000US54006,"State House District 6 (2010), West Virginia",4802,3718,1139,167,200,772,2579,1084,363,229,149,6,74,134,721,328,38,43,247,393
ACSSF,2010e5,wv,000,0034,0006130,620,54,   ,62000US54007,"State House District 7 (2010), West Virginia",4598,3648,1181,194,235,752,2467,950,311,138,48,9,81,173,639,352,58,34,260,287
ACSSF,2010e5,wv,000,0034,0006131,620,54,   ,62000US54008,"State House District 8 (2010), West Virginia",5587,4528,1604,256,229,1119,2924,1059,323,178,63,0,115,145,736,451,124,75,252,285
ACSSF,2010e5,wv,000,0034,0006132,620,54,   ,62000US54009,"State House District 9 (2010), West Virginia",5425,4620,1765,298,378,1089,2855,805,193,75,19,0,56,118,612,421,95,76,250,191
ACSSF,2010e5,wv,000,0034,0006133,620,54,   ,62000US54010,"State House District 10 (2010), West Virginia",14619,10940,3738,796,712,2230,7202,3679,948,566,185,107,274,382,2731,1425,448,139,838,1306
ACSSF,2010e5,wv,000,0034,0006134,620,54,   ,62000US54011,"State House District 11 (2010), West Virginia",4808,3988,1409,326,169,914,2579,820,139,33,0,0,33,106,681,281,62,116,103,400
ACSSF,2010e5,wv,000,0034,0006135,620,54,   ,62000US54012,"State House District 12 (2010), West Virginia",5699,4571,1568,358,399,811,3003,1128,483,372,119,36,217,111,645,375,88,36,251,270
ACSSF,2010e5,wv,000,0034,0006136,620,54,   ,62000US54013,"State House District 13 (2010), West Virginia",11221,8612,3160,561,490,2109,5452,2609,612,288,33,28,227,324,1997,1221,332,178,711,776
ACSSF,2010e5,wv,000,0034,0006137,620,54,   ,62000US54014,"State House District 14 (2010), West Virginia",11523,9448,3815,703,844,2268,5633,2075,628,304,15,18,271,324,1447,717,208,105,404,730
ACSSF,2010e5,wv,000,0034,0006138,620,54,   ,62000US54015,"State House District 15 (2010), West Virginia",12791,8824,2950,706,567,1677,5874,3967,883,468,105,0,363,415,3084,1807,383,261,1163,1277
ACSSF,2010e5,wv,000,0034,0006139,620,54,   ,62000US54016,"State House District 16 (2010), West Virginia",14438,11371,3808,922,758,2128,7563,3067,662,348,108,10,230,314,2405,1363,316,286,761,1042
ACSSF,2010e5,wv,000,0034,0006140,620,54,   ,62000US54017,"State House District 17 (2010), West Virginia",9814,7790,2810,692,477,1641,4980,2024,513,245,53,34,158,268,1511,751,141,70,540,760
ACSSF,2010e5,wv,000,0034,0006141,620,54,   ,62000US54018,"State House District 18 (2010), West Virginia",5009,3874,1576,246,283,1047,2298,1135,376,120,37,0,83,256,759,284,40,58,186,475
ACSSF,2010e5,wv,000,0034,0006142,620,54,   ,62000US54019,"State House District 19 (2010), West Virginia",20839,16062,6026,1376,1226,3424,10036,4777,1159,525,183,38,304,634,3618,1530,371,315,844,2088
ACSSF,2010e5,wv,000,0034,0006143,620,54,   ,62000US54020,"State House District 20 (2010), West Virginia",4532,3403,1203,249,218,736,2200,1129,382,82,22,47,13,300,747,234,57,51,126,513
ACSSF,2010e5,wv,000,0034,0006144,620,54,   ,62000US54021,"State House District 21 (2010), West Virginia",4372,3373,1096,289,162,645,2277,999,309,152,39,0,113,157,690,363,70,50,243,327
ACSSF,2010e5,wv,000,0034,0006145,620,54,   ,62000US54022,"State House District 22 (2010), West Virginia",8979,7201,2402,394,409,1599,4799,1778,506,179,18,0,161,327,1272,717,203,74,440,555
ACSSF,2010e5,wv,000,0034,0006146,620,54,   ,62000US54023,"State House District 23 (2010), West Virginia",3646,2588,819,79,115,625,1769,1058,233,76,2,20,54,157,825,413,24,65,324,412
ACSSF,2010e5,wv,000,0034,0006147,620,54,   ,62000US54024,"State House District 24 (2010), West Virginia",4303,3122,908,162,157,589,2214,1181,124,65,42,9,14,59,1057,579,166,93,320,478
ACSSF,2010e5,wv,000,0034,0006148,620,54,   ,62000US54025,"State House District 25 (2010), West Virginia",10221,8022,2511,640,426,1445,5511,2199,746,367,103,65,199,379,1453,734,242,25,467,719
ACSSF,2010e5,wv,000,0034,0006149,620,54,   ,62000US54026,"State House District 26 (2010), West Virginia",4708,3963,1117,305,207,605,2846,745,235,71,0,0,71,164,510,181,61,25,95,329
ACSSF,2010e5,wv,000,0034,0006150,620,54,   ,62000US54027,"State House District 27 (2010), West Virginia",23424,17858,6257,1382,1089,3786,11601,5566,1534,646,122,88,436,888,4032,1899,437,294,1168,2133
ACSSF,2010e5,wv,000,0034,0006151,620,54,   ,62000US54028,"State House District 28 (2010), West Virginia",9977,7505,2479,658,518,1303,5026,2472,717,310,93,24,193,407,1755,905,194,124,587,850
ACSSF,2010e5,wv,000,0034,0006152,620,54,   ,62000US54029,"State House District 29 (2010), West Virginia",13595,10289,3437,548,653,2236,6852,3306,967,427,189,20,218,540,2339,1030,126,186,718,1309
ACSSF,2010e5,wv,000,0034,0006153,620,54,   ,62000US54030,"State House District 30 (2010), West Virginia",33020,24964,8528,1842,1541,5145,16436,8056,1672,768,137,102,529,904,6384,3462,822,574,2066,2922
ACSSF,2010e5,wv,000,0034,0006154,620,54,   ,62000US54031,"State House District 31 (2010), West Virginia",3287,1677,414,93,62,259,1263,1610,436,234,79,13,142,202,1174,701,295,130,276,473
ACSSF,2010e5,wv,000,0034,0006155,620,54,   ,62000US54032,"State House District 32 (2010), West Virginia",14757,11877,3801,816,810,2175,8076,2880,836,486,143,8,335,350,2044,1081,249,123,709,963
ACSSF,2010e5,wv,000,0034,0006156,620,54,   ,62000US54033,"State House District 33 (2010), West Virginia",4329,3265,1033,132,222,679,2232,1064,426,158,77,44,37,268,638,287,43,16,228,351
ACSSF,2010e5,wv,000,0034,0006157,620,54,   ,62000US54034,"State House District 34 (2010), West Virginia",4621,3704,1064,138,203,723,2640,917,243,101,0,9,92,142,674,351,92,74,185,323
ACSSF,2010e5,wv,000,0034,0006158,620,54,   ,62000US54035,"State House District 35 (2010), West Virginia",5327,4491,1516,236,164,1116,2975,836,366,214,58,0,156,152,470,98,0,0,98,372
ACSSF,2010e5,wv,000,0034,0006159,620,54,   ,62000US54036,"State House District 36 (2010), West Virginia",5014,4014,1409,305,317,787,2605,1000,373,209,75,0,134,164,627,313,156,61,96,314
ACSSF,2010e5,wv,000,0034,0006160,620,54,   ,62000US54037,"State House District 37 (2010), West Virginia",10394,8569,2791,409,511,1871,5778,1825,552,244,95,5,144,308,1273,768,151,182,435,505
ACSSF,2010e5,wv,000,0034,0006161,620,54,   ,62000US54038,"State House District 38 (2010), West Virginia",4519,3714,1116,118,253,745,2598,805,233,114,49,10,55,119,572,409,103,60,246,163
ACSSF,2010e5,wv,000,0034,0006162,620,54,   ,62000US54039,"State House District 39 (2010), West Virginia",4833,3837,1369,240,235,894,2468,996,332,122,44,31,47,210,664,299,21,177,101,365
ACSSF,2010e5,wv,000,0034,0006163,620,54,   ,62000US54040,"State House District 40 (2010), West Virginia",5332,4306,1319,302,265,752,2987,1026,350,128,21,35,72,222,676,392,49,106,237,284
ACSSF,2010e5,wv,000,0034,0006164,620,54,   ,62000US54041,"State House District 41 (2010), West Virginia",19600,14763,5236,1010,944,3282,9527,4837,1020,453,68,20,365,567,3817,1953,485,235,1233,1864
ACSSF,2010e5,wv,000,0034,0006165,620,54,   ,62000US54042,"State House District 42 (2010), West Virginia",5408,4188,1537,310,294,933,2651,1220,250,49,0,15,34,201,970,564,63,128,373,406
ACSSF,2010e5,wv,000,0034,0006166,620,54,   ,62000US54043,"State House District 43 (2010), West Virginia",14807,11226,4121,953,688,2480,7105,3581,1065,503,44,29,430,562,2516,1395,318,133,944,1121
ACSSF,2010e5,wv,000,0034,0006167,620,54,   ,62000US54044,"State House District 44 (2010), West Virginia",17229,13726,5276,1461,1080,2735,8450,3503,1087,474,180,72,222,613,2416,1283,355,113,815,1133
ACSSF,2010e5,wv,000,0034,0006168,620,54,   ,62000US54045,"State House District 45 (2010), West Virginia",5597,4561,1454,503,157,794,3107,1036,233,105,0,20,85,128,803,433,117,124,192,370
ACSSF,2010e5,wv,000,0034,0006169,620,54,   ,62000US54046,"State House District 46 (2010), West Virginia",5478,4471,1701,287,250,1164,2770,1007,335,167,111,0,56,168,672,297,90,49,158,375
ACSSF,2010e5,wv,000,0034,0006170,620,54,   ,62000US54047,"State House District 47 (2010), West Virginia",4691,3842,932,124,264,544,2910,849,222,107,38,0,69,115,627,334,64,113,157,293
ACSSF,2010e5,wv,000,0034,0006171,620,54,   ,62000US54048,"State House District 48 (2010), West Virginia",5553,4445,1364,418,199,747,3081,1108,308,159,70,12,77,149,800,593,153,48,392,207
ACSSF,2010e5,wv,000,0034,0006172,620,54,   ,62000US54049,"State House District 49 (2010), West Virginia",5208,3919,1164,234,276,654,2755,1289,347,245,84,62,99,102,942,599,88,49,462,343
ACSSF,2010e5,wv,000,0034,0006173,620,54,   ,62000US54050,"State House District 50 (2010), West Virginia",5037,3946,1328,209,269,850,2618,1091,159,62,16,0,46,97,932,553,41,94,418,379
ACSSF,2010e5,wv,000,0034,0006174,620,54,   ,62000US54051,"State House District 51 (2010), West Virginia",4823,3749,1270,133,325,812,2479,1074,465,279,59,10,210,186,609,378,39,6,333,231
ACSSF,2010e5,wv,000,0034,0006175,620,54,   ,62000US54052,"State House District 52 (2010), West Virginia",6431,5128,1830,356,391,1083,3298,1303,469,266,62,63,141,203,834,402,105,66,231,432
ACSSF,2010e5,wv,000,0034,0006176,620,54,   ,62000US54053,"State House District 53 (2010), West Virginia",6002,4566,1693,369,312,1012,2873,1436,602,383,127,57,199,219,834,355,123,0,232,479
ACSSF,2010e5,wv,000,0034,0006177,620,54,   ,62000US54054,"State House District 54 (2010), West Virginia",4788,3257,1115,337,240,538,2142,1531,430,310,92,116,102,120,1101,683,316,60,307,418
ACSSF,2010e5,wv,000,0034,0006178,620,54,   ,62000US54055,"State House District 55 (2010), West Virginia",6710,5433,2120,565,473,1082,3313,1277,290,148,34,14,100,142,987,595,189,148,258,392
ACSSF,2010e5,wv,000,0034,0006179,620,54,   ,62000US54056,"State House District 56 (2010), West Virginia",6259,4798,2202,544,416,1242,2596,1461,397,188,23,23,142,209,1064,636,148,136,352,428
ACSSF,2010e5,wv,000,0034,0006180,620,54,   ,62000US54057,"State House District 57 (2010), West Virginia",5189,4591,1864,509,401,954,2727,598,259,53,24,0,29,206,339,119,7,21,91,220
ACSSF,2010e5,wv,000,0034,0006181,620,54,   ,62000US54058,"State House District 58 (2010), West Virginia",5648,4352,2015,516,456,1043,2337,1296,446,245,123,17,105,201,850,502,117,37,348,348
ACSSF,2010e5,wv,000,0034,0006182,622,54,009,62200US54001009,"Brooke County (part), State House District 1 (2010), West Virginia",572,378,104,0,38,66,274,194,33,11,0,0,11,22,161,101,8,70,23,60
ACSSF,2010e5,wv,000,0034,0006183,622,54,029,62200US54001029,"Hancock County, State House District 1 (2010), West Virginia",8882,6766,2246,524,498,1224,4520,2116,640,354,126,16,212,286,1476,730,75,180,475,746
ACSSF,2010e5,wv,000,0034,0006184,622,54,009,62200US54002009,"Brooke County (part), State House District 2 (2010), West Virginia",6006,4601,1338,182,388,768,3263,1405,464,230,56,20,154,234,941,623,158,68,397,318
ACSSF,2010e5,wv,000,0034,0006185,622,54,069,62200US54002069,"Ohio County (part), State House District 2 (2010), West Virginia",3013,2556,814,128,194,492,1742,457,100,47,19,0,28,53,357,189,76,0,113,168
ACSSF,2010e5,wv,000,0034,0006186,622,54,069,62200US54003069,"Ohio County (part), State House District 3 (2010), West Virginia",8452,6318,2231,360,374,1497,4087,2134,350,170,77,0,93,180,1784,957,223,252,482,827
ACSSF,2010e5,wv,000,0034,0006187,622,54,051,62200US54004051,"Marshall County, State House District 4 (2010), West Virginia",9385,7314,2474,441,497,1536,4840,2071,614,307,134,0,173,307,1457,764,223,71,470,693
ACSSF,2010e5,wv,000,0034,0006188,622,54,069,62200US54004069,"Ohio County (part), State House District 4 (2010), West Virginia",21,14,0,0,0,0,14,7,0,0,0,0,0,0,7,0,0,0,0,7
ACSSF,2010e5,wv,000,0034,0006189,622,54,061,62200US54005061,"Monongalia County (part), State House District 5 (2010), West Virginia",324,310,109,15,10,84,201,14,14,14,14,0,0,0,0,0,0,0,0,0
ACSSF,2010e5,wv,000,0034,0006190,622,54,103,62200US54005103,"Wetzel County (part), State House District 5 (2010), West Virginia",4507,3683,1241,242,215,784,2442,824,191,97,31,13,53,94,633,323,54,74,195,310
ACSSF,2010e5,wv,000,0034,0006191,622,54,017,62200US54006017,"Doddridge County, State House District 6 (2010), West Virginia",1999,1482,441,34,69,338,1041,517,178,126,94,3,29,52,339,158,0,37,121,181
ACSSF,2010e5,wv,000,0034,0006192,622,54,095,62200US54006095,"Tyler County, State House District 6 (2010), West Virginia",2585,2074,664,128,121,415,1410,511,178,96,55,3,38,82,333,144,12,6,126,189
ACSSF,2010e5,wv,000,0034,0006193,622,54,103,62200US54006103,"Wetzel County (part), State House District 6 (2010), West Virginia",218,162,34,5,10,19,128,56,7,7,0,0,7,0,49,26,26,0,0,23
ACSSF,2010e5,wv,000,0034,0006194,622,54,073,62200US54007073,"Pleasants County, State House District 7 (2010), West Virginia",1674,1394,488,71,52,365,906,280,81,45,0,7,38,36,199,109,19,7,83,90
ACSSF,2010e5,wv,000,0034,0006195,622,54,085,62200US54007085,"Ritchie County, State House District 7 (2010), West Virginia",2924,2254,693,123,183,387,1561,670,230,93,48,2,43,137,440,243,39,27,177,197
ACSSF,2010e5,wv,000,0034,0006196,622,54,107,62200US54008107,"Wood County (part), State House District 8 (2010), West Virginia",5587,4528,1604,256,229,1119,2924,1059,323,178,63,0,115,145,736,451,124,75,252,285
ACSSF,2010e5,wv,000,0034,0006197,622,54,105,62200US54009105,"Wirt County, State House District 9 (2010), West Virginia",1697,1447,441,112,102,227,1006,250,64,31,14,0,17,33,186,129,17,12,100,57
ACSSF,2010e5,wv,000,0034,0006198,622,54,107,62200US54009107,"Wood County (part), State House District 9 (2010), West Virginia",3728,3173,1324,186,276,862,1849,555,129,44,5,0,39,85,426,292,78,64,150,134
ACSSF,2010e5,wv,000,0034,0006199,622,54,107,62200US54010107,"Wood County (part), State House District 10 (2010), West Virginia",14619,10940,3738,796,712,2230,7202,3679,948,566,185,107,274,382,2731,1425,448,139,838,1306
ACSSF,2010e5,wv,000,0034,0006200,622,54,035,62200US54011035,"Jackson County (part), State House District 11 (2010), West Virginia",800,715,353,70,19,264,362,85,0,0,0,0,0,0,85,59,0,0,59,26
ACSSF,2010e5,wv,000,0034,0006201,622,54,087,62200US54011087,"Roane County, State House District 11 (2010), West Virginia",4008,3273,1056,256,150,650,2217,735,139,33,0,0,33,106,596,222,62,116,44,374
ACSSF,2010e5,wv,000,0034,0006202,622,54,035,62200US54012035,"Jackson County (part), State House District 12 (2010), West Virginia",5699,4571,1568,358,399,811,3003,1128,483,372,119,36,217,111,645,375,88,36,251,270
ACSSF,2010e5,wv,000,0034,0006203,622,54,035,62200US54013035,"Jackson County (part), State House District 13 (2010), West Virginia",1915,1436,525,114,117,294,911,479,62,21,0,0,21,41,417,179,22,14,143,238
ACSSF,2010e5,wv,000,0034,0006204,622,54,053,62200US54013053,"Mason County (part), State House District 13 (2010), West Virginia",3721,2774,945,134,193,618,1829,947,209,102,27,6,69,107,738,517,193,33,291,221
ACSSF,2010e5,wv,000,0034,0006205,622,54,079,62200US54013079,"Putnam County (part), State House District 13 (2010), West Virginia",5585,4402,1690,313,180,1197,2712,1183,341,165,6,22,137,176,842,525,117,131,277,317
ACSSF,2010e5,wv,000,0034,0006206,622,54,053,62200US54014053,"Mason County (part), State House District 14 (2010), West Virginia",3873,2983,1005,157,288,560,1978,890,233,153,9,3,141,80,657,297,104,38,155,360
ACSSF,2010e5,wv,000,0034,0006207,622,54,079,62200US54014079,"Putnam County (part), State House District 14 (2010), West Virginia",7650,6465,2810,546,556,1708,3655,1185,395,151,6,15,130,244,790,420,104,67,249,370
ACSSF,2010e5,wv,000,0034,0006208,622,54,011,62200US54015011,"Cabell County (part), State House District 15 (2010), West Virginia",11699,8015,2675,657,534,1484,5340,3684,798,415,97,0,318,383,2886,1652,354,233,1065,1234
ACSSF,2010e5,wv,000,0034,0006209,622,54,043,62200US54015043,"Lincoln County (part), State House District 15 (2010), West Virginia",1092,809,275,49,33,193,534,283,85,53,8,0,45,32,198,155,29,28,98,43
ACSSF,2010e5,wv,000,0034,0006210,622,54,011,62200US54016011,"Cabell County (part), State House District 16 (2010), West Virginia",12996,10305,3477,850,643,1984,6828,2691,597,304,95,10,199,293,2094,1204,258,265,681,890
ACSSF,2010e5,wv,000,0034,0006211,622,54,099,62200US54016099,"Wayne County (part), State House District 16 (2010), West Virginia",1442,1066,331,72,115,144,735,376,65,44,13,0,31,21,311,159,58,21,80,152
ACSSF,2010e5,wv,000,0034,0006212,622,54,099,62200US54017099,"Wayne County (part), State House District 17 (2010), West Virginia",9814,7790,2810,692,477,1641,4980,2024,513,245,53,34,158,268,1511,751,141,70,540,760
ACSSF,2010e5,wv,000,0034,0006213,622,54,005,62200US54018005,"Boone County (part), State House District 18 (2010), West Virginia",5009,3874,1576,246,283,1047,2298,1135,376,120,37,0,83,256,759,284,40,58,186,475
ACSSF,2010e5,wv,000,0034,0006214,622,54,005,62200US54019005,"Boone County (part), State House District 19 (2010), West Virginia",2171,1823,561,121,150,290,1262,348,115,36,7,0,29,79,233,132,32,0,100,101
ACSSF,2010e5,wv,000,0034,0006215,622,54,043,62200US54019043,"Lincoln County (part), State House District 19 (2010), West Virginia",5460,4132,1747,522,200,1025,2385,1328,379,148,41,38,69,231,949,473,136,110,227,476
ACSSF,2010e5,wv,000,0034,0006216,622,54,045,62200US54019045,"Logan County, State House District 19 (2010), West Virginia",10514,7853,2800,500,612,1688,5053,2661,618,307,127,0,180,311,2043,692,176,105,411,1351
ACSSF,2010e5,wv,000,0034,0006217,622,54,079,62200US54019079,"Putnam County (part), State House District 19 (2010), West Virginia",2694,2254,918,233,264,421,1336,440,47,34,8,0,26,13,393,233,27,100,106,160
ACSSF,2010e5,wv,000,0034,0006218,622,54,059,62200US54020059,"Mingo County (part), State House District 20 (2010), West Virginia",4032,3000,1004,235,149,620,1996,1032,323,69,22,34,13,254,709,223,57,51,115,486
ACSSF,2010e5,wv,000,0034,0006219,622,54,099,62200US54020099,"Wayne County (part), State House District 20 (2010), West Virginia",500,403,199,14,69,116,204,97,59,13,0,13,0,46,38,11,0,0,11,27
ACSSF,2010e5,wv,000,0034,0006220,622,54,047,62200US54021047,"McDowell County (part), State House District 21 (2010), West Virginia",917,775,183,57,74,52,592,142,58,25,0,0,25,33,84,26,0,0,26,58
ACSSF,2010e5,wv,000,0034,0006221,622,54,059,62200US54021059,"Mingo County (part), State House District 21 (2010), West Virginia",3455,2598,913,232,88,593,1685,857,251,127,39,0,88,124,606,337,70,50,217,269
ACSSF,2010e5,wv,000,0034,0006222,622,54,109,62200US54021109,"Wyoming County (part), State House District 21 (2010), West Virginia",0,0,0,0,0,0,0,0,0,0,0,0,0,0,0,0,0,0,0,0
ACSSF,2010e5,wv,000,0034,0006223,622,54,047,62200US54022047,"McDowell County (part), State House District 22 (2010), West Virginia",927,779,199,35,37,127,580,148,43,0,0,0,0,43,105,82,6,25,51,23
ACSSF,2010e5,wv,000,0034,0006224,622,54,055,62200US54022055,"Mercer County (part), State House District 22 (2010), West Virginia",1487,1134,360,13,84,263,774,353,144,46,18,0,28,98,209,136,40,9,87,73
ACSSF,2010e5,wv,000,0034,0006225,622,54,109,62200US54022109,"Wyoming County (part), State House District 22 (2010), West Virginia",6565,5288,1843,346,288,1209,3445,1277,319,133,0,0,133,186,958,499,157,40,302,459
ACSSF,2010e5,wv,000,0034,0006226,622,54,047,62200US54023047,"McDowell County (part), State House District 23 (2010), West Virginia",3646,2588,819,79,115,625,1769,1058,233,76,2,20,54,157,825,413,24,65,324,412
ACSSF,2010e5,wv,000,0034,0006227,622,54,055,62200US54024055,"Mercer County (part), State House District 24 (2010), West Virginia",4303,3122,908,162,157,589,2214,1181,124,65,42,9,14,59,1057,579,166,93,320,478
ACSSF,2010e5,wv,000,0034,0006228,622,54,055,62200US54025055,"Mercer County (part), State House District 25 (2010), West Virginia",10221,8022,2511,640,426,1445,5511,2199,746,367,103,65,199,379,1453,734,242,25,467,719
ACSSF,2010e5,wv,000,0034,0006229,622,54,063,62200US54026063,"Monroe County, State House District 26 (2010), West Virginia",3922,3297,965,299,163,503,2332,625,198,71,0,0,71,127,427,151,61,11,79,276
ACSSF,2010e5,wv,000,0034,0006230,622,54,089,62200US54026089,"Summers County (part), State House District 26 (2010), West Virginia",786,666,152,6,44,102,514,120,37,0,0,0,0,37,83,30,0,14,16,53
ACSSF,2010e5,wv,000,0034,0006231,622,54,081,62200US54027081,"Raleigh County, State House District 27 (2010), West Virginia",21014,16081,5693,1226,1011,3456,10388,4933,1305,530,103,88,339,775,3628,1746,437,294,1015,1882
ACSSF,2010e5,wv,000,0034,0006232,622,54,089,62200US54027089,"Summers County (part), State House District 27 (2010), West Virginia",2410,1777,564,156,78,330,1213,633,229,116,19,0,97,113,404,153,0,0,153,251
ACSSF,2010e5,wv,000,0034,0006233,622,54,025,62200US54028025,"Greenbrier County, State House District 28 (2010), West Virginia",9977,7505,2479,658,518,1303,5026,2472,717,310,93,24,193,407,1755,905,194,124,587,850
ACSSF,2010e5,wv,000,0034,0006234,622,54,015,62200US54029015,"Clay County (part), State House District 29 (2010), West Virginia",994,851,414,27,57,330,437,143,44,20,0,0,20,24,99,45,0,27,18,54
ACSSF,2010e5,wv,000,0034,0006235,622,54,019,62200US54029019,"Fayette County, State House District 29 (2010), West Virginia",12344,9215,2911,521,574,1816,6304,3129,911,407,189,20,198,504,2218,977,126,159,692,1241
ACSSF,2010e5,wv,000,0034,0006236,622,54,067,62200US54029067,"Nicholas County (part), State House District 29 (2010), West Virginia",257,223,112,0,22,90,111,34,12,0,0,0,0,12,22,8,0,0,8,14
ACSSF,2010e5,wv,000,0034,0006237,622,54,039,62200US54030039,"Kanawha County (part), State House District 30 (2010), West Virginia",33020,24964,8528,1842,1541,5145,16436,8056,1672,768,137,102,529,904,6384,3462,822,574,2066,2922
ACSSF,2010e5,wv,000,0034,0006238,622,54,039,62200US54031039,"Kanawha County (part), State House District 31 (2010), West Virginia",3287,1677,414,93,62,259,1263,1610,436,234,79,13,142,202,1174,701,295,130,276,473
ACSSF,2010e5,wv,000,0034,0006239,622,54,039,62200US54032039,"Kanawha County (part), State House District 32 (2010), West Virginia",14757,11877,3801,816,810,2175,8076,2880,836,486,143,8,335,350,2044,1081,249,123,709,963
ACSSF,2010e5,wv,000,0034,0006240,622,54,013,62200US54033013,"Calhoun County, State House District 33 (2010), West Virginia",2063,1537,464,8,106,350,1073,526,238,120,63,44,13,118,288,97,23,0,74,191
ACSSF,2010e5,wv,000,0034,0006241,622,54,015,62200US54033015,"Clay County (part), State House District 33 (2010), West Virginia",1434,1079,357,72,97,188,722,355,130,32,14,0,18,98,225,103,10,16,77,122
ACSSF,2010e5,wv,000,0034,0006242,622,54,021,62200US54033021,"Gilmer County (part), State House District 33 (2010), West Virginia",832,649,212,52,19,141,437,183,58,6,0,0,6,52,125,87,10,0,77,38
ACSSF,2010e5,wv,000,0034,0006243,622,54,007,62200US54034007,"Braxton County, State House District 34 (2010), West Virginia",3904,3198,881,120,172,589,2317,706,213,88,0,4,84,125,493,297,81,46,170,196
ACSSF,2010e5,wv,000,0034,0006244,622,54,021,62200US54034021,"Gilmer County (part), State House District 34 (2010), West Virginia",717,506,183,18,31,134,323,211,30,13,0,5,8,17,181,54,11,28,15,127
ACSSF,2010e5,wv,000,0034,0006245,622,54,067,62200US54035067,"Nicholas County (part), State House District 35 (2010), West Virginia",5327,4491,1516,236,164,1116,2975,836,366,214,58,0,156,152,470,98,0,0,98,372
ACSSF,2010e5,wv,000,0034,0006246,622,54,067,62200US54036067,"Nicholas County (part), State House District 36 (2010), West Virginia",2087,1649,525,156,139,230,1124,438,157,86,18,0,68,71,281,131,37,51,43,150
ACSSF,2010e5,wv,000,0034,0006247,622,54,101,62200US54036101,"Webster County, State House District 36 (2010), West Virginia",2927,2365,884,149,178,557,1481,562,216,123,57,0,66,93,346,182,119,10,53,164
ACSSF,2010e5,wv,000,0034,0006248,622,54,075,62200US54037075,"Pocahontas County, State House District 37 (2010), West Virginia",2703,2274,757,131,121,505,1517,429,159,73,17,0,56,86,270,193,67,18,108,77
ACSSF,2010e5,wv,000,0034,0006249,622,54,083,62200US54037083,"Randolph County, State House District 37 (2010), West Virginia",7691,6295,2034,278,390,1366,4261,1396,393,171,78,5,88,222,1003,575,84,164,327,428
ACSSF,2010e5,wv,000,0034,0006250,622,54,041,62200US54038041,"Lewis County, State House District 38 (2010), West Virginia",4243,3446,1044,118,237,689,2402,797,225,106,49,10,47,119,572,409,103,60,246,163
ACSSF,2010e5,wv,000,0034,0006251,622,54,097,62200US54038097,"Upshur County (part), State House District 38 (2010), West Virginia",276,268,72,0,16,56,196,8,8,8,0,0,8,0,0,0,0,0,0,0
ACSSF,2010e5,wv,000,0034,0006252,622,54,097,62200US54039097,"Upshur County (part), State House District 39 (2010), West Virginia",4833,3837,1369,240,235,894,2468,996,332,122,44,31,47,210,664,299,21,177,101,365
ACSSF,2010e5,wv,000,0034,0006253,622,54,001,62200US54040001,"Barbour County, State House District 40 (2010), West Virginia",4245,3304,904,174,163,567,2400,941,341,128,21,35,72,213,600,342,34,106,202,258
ACSSF,2010e5,wv,000,0034,0006254,622,54,097,62200US54040097,"Upshur County (part), State House District 40 (2010), West Virginia",1087,1002,415,128,102,185,587,85,9,0,0,0,0,9,76,50,15,0,35,26
ACSSF,2010e5,wv,000,0034,0006255,622,54,033,62200US54041033,"Harrison County, State House District 41 (2010), West Virginia",18968,14266,5062,963,930,3169,9204,4702,1006,453,68,20,365,553,3696,1911,482,213,1216,1785
ACSSF,2010e5,wv,000,0034,0006256,622,54,049,62200US54041049,"Marion County (part), State House District 41 (2010), West Virginia",632,497,174,47,14,113,323,135,14,0,0,0,0,14,121,42,3,22,17,79
ACSSF,2010e5,wv,000,0034,0006257,622,54,049,62200US54042049,"Marion County (part), State House District 42 (2010), West Virginia",358,287,90,0,0,90,197,71,0,0,0,0,0,0,71,16,0,0,16,55
ACSSF,2010e5,wv,000,0034,0006258,622,54,061,62200US54042061,"Monongalia County (part), State House District 42 (2010), West Virginia",462,364,124,9,33,82,240,98,0,0,0,0,0,0,98,73,20,40,13,25
ACSSF,2010e5,wv,000,0034,0006259,622,54,091,62200US54042091,"Taylor County, State House District 42 (2010), West Virginia",4588,3537,1323,301,261,761,2214,1051,250,49,0,15,34,201,801,475,43,88,344,326
ACSSF,2010e5,wv,000,0034,0006260,622,54,049,62200US54043049,"Marion County (part), State House District 43 (2010), West Virginia",14037,10565,3847,872,643,2332,6718,3472,976,473,44,29,400,503,2496,1395,318,133,944,1101
ACSSF,2010e5,wv,000,0034,0006261,622,54,061,62200US54043061,"Monongalia County (part), State House District 43 (2010), West Virginia",770,661,274,81,45,148,387,109,89,30,0,0,30,59,20,0,0,0,0,20
ACSSF,2010e5,wv,000,0034,0006262,622,54,061,62200US54044061,"Monongalia County (part), State House District 44 (2010), West Virginia",17229,13726,5276,1461,1080,2735,8450,3503,1087,474,180,72,222,613,2416,1283,355,113,815,1133
ACSSF,2010e5,wv,000,0034,0006263,622,54,077,62200US54045077,"Preston County (part), State House District 45 (2010), West Virginia",5597,4561,1454,503,157,794,3107,1036,233,105,0,20,85,128,803,433,117,124,192,370
ACSSF,2010e5,wv,000,0034,0006264,622,54,077,62200US54046077,"Preston County (part), State House District 46 (2010), West Virginia",3406,2798,1151,188,179,784,1647,608,201,109,89,0,20,92,407,207,40,22,145,200
ACSSF,2010e5,wv,000,0034,0006265,622,54,093,62200US54046093,"Tucker County, State House District 46 (2010), West Virginia",2072,1673,550,99,71,380,1123,399,134,58,22,0,36,76,265,90,50,27,13,175
ACSSF,2010e5,wv,000,0034,0006266,622,54,031,62200US54047031,"Hardy County, State House District 47 (2010), West Virginia",3016,2437,495,68,115,312,1942,579,148,59,17,0,42,89,431,262,55,79,128,169
ACSSF,2010e5,wv,000,0034,0006267,622,54,071,62200US54047071,"Pendleton County (part), State House District 47 (2010), West Virginia",1675,1405,437,56,149,232,968,270,74,48,21,0,27,26,196,72,9,34,29,124
ACSSF,2010e5,wv,000,0034,0006268,622,54,023,62200US54048023,"Grant County, State House District 48 (2010), West Virginia",3451,2789,908,283,172,453,1881,662,184,108,50,0,58,76,478,321,111,14,196,157
ACSSF,2010e5,wv,000,0034,0006269,622,54,057,62200US54048057,"Mineral County (part), State House District 48 (2010), West Virginia",1566,1220,365,121,21,223,855,346,99,51,20,12,19,48,247,207,11,34,162,40
ACSSF,2010e5,wv,000,0034,0006270,622,54,071,62200US54048071,"Pendleton County (part), State House District 48 (2010), West Virginia",536,436,91,14,6,71,345,100,25,0,0,0,0,25,75,65,31,0,34,10
ACSSF,2010e5,wv,000,0034,0006271,622,54,057,62200US54049057,"Mineral County (part), State House District 49 (2010), West Virginia",5208,3919,1164,234,276,654,2755,1289,347,245,84,62,99,102,942,599,88,49,462,343
ACSSF,2010e5,wv,000,0034,0006272,622,54,027,62200US54050027,"Hampshire County (part), State House District 50 (2010), West Virginia",4101,3065,1010,168,191,651,2055,1036,159,62,16,0,46,97,877,498,24,94,380,379
ACSSF,2010e5,wv,000,0034,0006273,622,54,057,62200US54050057,"Mineral County (part), State House District 50 (2010), West Virginia",936,881,318,41,78,199,563,55,0,0,0,0,0,0,55,55,17,0,38,0
ACSSF,2010e5,wv,000,0034,0006274,622,54,027,62200US54051027,"Hampshire County (part), State House District 51 (2010), West Virginia",1703,1285,431,50,119,262,854,418,220,129,0,0,129,91,198,132,33,0,99,66
ACSSF,2010e5,wv,000,0034,0006275,622,54,065,62200US54051065,"Morgan County (part), State House District 51 (2010), West Virginia",3120,2464,839,83,206,550,1625,656,245,150,59,10,81,95,411,246,6,6,234,165
ACSSF,2010e5,wv,000,0034,0006276,622,54,003,62200US54052003,"Berkeley County (part), State House District 52 (2010), West Virginia",5469,4373,1704,313,367,1024,2669,1096,444,266,62,63,141,178,652,313,105,38,170,339
ACSSF,2010e5,wv,000,0034,0006277,622,54,065,62200US54052065,"Morgan County (part), State House District 52 (2010), West Virginia",962,755,126,43,24,59,629,207,25,0,0,0,0,25,182,89,0,28,61,93
ACSSF,2010e5,wv,000,0034,0006278,622,54,003,62200US54053003,"Berkeley County (part), State House District 53 (2010), West Virginia",6002,4566,1693,369,312,1012,2873,1436,602,383,127,57,199,219,834,355,123,0,232,479
ACSSF,2010e5,wv,000,0034,0006279,622,54,003,62200US54054003,"Berkeley County (part), State House District 54 (2010), West Virginia",4788,3257,1115,337,240,538,2142,1531,430,310,92,116,102,120,1101,683,316,60,307,418
ACSSF,2010e5,wv,000,0034,0006280,622,54,003,62200US54055003,"Berkeley County (part), State House District 55 (2010), West Virginia",6710,5433,2120,565,473,1082,3313,1277,290,148,34,14,100,142,987,595,189,148,258,392
ACSSF,2010e5,wv,000,0034,0006281,622,54,003,62200US54056003,"Berkeley County (part), State House District 56 (2010), West Virginia",3506,2594,1348,394,240,714,1246,912,252,132,23,23,86,120,660,417,90,57,270,243
ACSSF,2010e5,wv,000,0034,0006282,622,54,037,62200US54056037,"Jefferson County (part), State House District 56 (2010), West Virginia",2753,2204,854,150,176,528,1350,549,145,56,0,0,56,89,404,219,58,79,82,185
ACSSF,2010e5,wv,000,0034,0006283,622,54,037,62200US54057037,"Jefferson County (part), State House District 57 (2010), West Virginia",5189,4591,1864,509,401,954,2727,598,259,53,24,0,29,206,339,119,7,21,91,220
ACSSF,2010e5,wv,000,0034,0006284,622,54,037,62200US54058037,"Jefferson County (part), State House District 58 (2010), West Virginia",5648,4352,2015,516,456,1043,2337,1296,446,245,123,17,105,201,850,502,117,37,348,348
ACSSF,2010e5,wv,000,0034,0006285,795,54,   ,79500US5400100,"PUMA5 00100, West Virginia",41056,31792,10482,1882,2214,6386,21310,9264,2399,1223,443,49,731,1176,6865,3713,843,715,2155,3152
ACSSF,2010e5,wv,000,0034,0006286,795,54,   ,79500US5400200,"PUMA5 00200, West Virginia",40582,30634,10937,2217,1917,6803,19697,9948,2424,1101,206,67,828,1323,7524,3997,846,493,2658,3527
ACSSF,2010e5,wv,000,0034,0006287,795,54,   ,79500US5400300,"PUMA5 00300, West Virginia",27788,22420,8388,2257,1504,4627,14032,5368,1624,732,283,92,357,892,3744,1996,532,299,1165,1748
ACSSF,2010e5,wv,000,0034,0006288,795,54,   ,79500US5400400,"PUMA5 00400, West Virginia",66330,52017,18897,4314,4022,10561,33120,14313,4394,2445,752,374,1319,1949,9919,5749,1390,778,3581,4170
ACSSF,2010e5,wv,000,0034,0006289,795,54,   ,79500US5400500,"PUMA5 00500, West Virginia",29900,24178,7664,1227,1436,5001,16514,5722,1743,700,214,90,396,1043,3979,2203,409,608,1186,1776
ACSSF,2010e5,wv,000,0034,0006290,795,54,   ,79500US5400600,"PUMA5 00600, West Virginia",47308,37351,12918,2478,2466,7974,24433,9957,2875,1599,552,199,848,1276,7082,3725,932,496,2297,3357
ACSSF,2010e5,wv,000,0034,0006291,795,54,   ,79500US5400700,"PUMA5 00700, West Virginia",32289,24077,8102,1798,1658,4646,15975,8212,1837,974,228,19,727,863,6375,3670,909,569,2192,2705
ACSSF,2010e5,wv,000,0034,0006292,795,54,   ,79500US5400800,"PUMA5 00800, West Virginia",76601,59266,21069,4309,4000,12760,38197,17335,4392,2046,437,160,1449,2346,12943,6986,1696,1226,4064,5957
ACSSF,2010e5,wv,000,0034,0006293,795,54,   ,79500US5400900,"PUMA5 00900, West Virginia",35622,27722,9184,1851,1716,5617,18538,7900,2538,1213,432,44,737,1325,5362,2494,543,362,1589,2868
ACSSF,2010e5,wv,000,0034,0006294,795,54,   ,79500US5401000,"PUMA5 01000, West Virginia",28132,21821,7374,1687,1296,4391,14447,6311,1769,717,122,88,507,1052,4542,2080,498,319,1263,2462
ACSSF,2010e5,wv,000,0034,0006295,795,54,   ,79500US5401100,"PUMA5 01100, West Virginia",28066,21708,6823,1332,1181,4310,14885,6358,1667,712,165,94,453,955,4691,2469,635,257,1577,2222
ACSSF,2010e5,wv,000,0034,0006296,795,54,   ,79500US5401200,"PUMA5 01200, West Virginia",36309,27651,10079,2316,1743,6020,17572,8658,2293,1006,303,119,584,1287,6365,2801,667,435,1699,3564
ACSSF,2010e5,wv,000,0034,0006297,970,54,   ,97000US5400030,"Barbour County School District, West Virginia",4245,3304,904,174,163,567,2400,941,341,128,21,35,72,213,600,342,34,106,202,258
ACSSF,2010e5,wv,000,0034,0006298,970,54,   ,97000US5400060,"Berkeley County School District, West Virginia",26475,20223,7980,1978,1632,4370,12243,6252,2018,1239,338,273,628,779,4234,2363,823,303,1237,1871
ACSSF,2010e5,wv,000,0034,0006299,970,54,   ,97000US5400090,"Boone County School District, West Virginia",7180,5697,2137,367,433,1337,3560,1483,491,156,44,0,112,335,992,416,72,58,286,576
ACSSF,2010e5,wv,000,0034,0006300,970,54,   ,97000US5400120,"Braxton County School District, West Virginia",3904,3198,881,120,172,589,2317,706,213,88,0,4,84,125,493,297,81,46,170,196
ACSSF,2010e5,wv,000,0034,0006301,970,54,   ,97000US5400150,"Brooke County School District, West Virginia",6578,4979,1442,182,426,834,3537,1599,497,241,56,20,165,256,1102,724,166,138,420,378
ACSSF,2010e5,wv,000,0034,0006302,970,54,   ,97000US5400180,"Cabell County School District, West Virginia",24695,18320,6152,1507,1177,3468,12168,6375,1395,719,192,10,517,676,4980,2856,612,498,1746,2124
ACSSF,2010e5,wv,000,0034,0006303,970,54,   ,97000US5400210,"Calhoun County School District, West Virginia",2063,1537,464,8,106,350,1073,526,238,120,63,44,13,118,288,97,23,0,74,191
ACSSF,2010e5,wv,000,0034,0006304,970,54,   ,97000US5400240,"Clay County School District, West Virginia",2428,1930,771,99,154,518,1159,498,174,52,14,0,38,122,324,148,10,43,95,176
ACSSF,2010e5,wv,000,0034,0006305,970,54,   ,97000US5400270,"Doddridge County School District, West Virginia",1999,1482,441,34,69,338,1041,517,178,126,94,3,29,52,339,158,0,37,121,181
ACSSF,2010e5,wv,000,0034,0006306,970,54,   ,97000US5400300,"Fayette County School District, West Virginia",12344,9215,2911,521,574,1816,6304,3129,911,407,189,20,198,504,2218,977,126,159,692,1241
ACSSF,2010e5,wv,000,0034,0006307,970,54,   ,97000US5400330,"Gilmer County School District, West Virginia",1549,1155,395,70,50,275,760,394,88,19,0,5,14,69,306,141,21,28,92,165
ACSSF,2010e5,wv,000,0034,0006308,970,54,   ,97000US5400360,"Grant County School District, West Virginia",3451,2789,908,283,172,453,1881,662,184,108,50,0,58,76,478,321,111,14,196,157
ACSSF,2010e5,wv,000,0034,0006309,970,54,   ,97000US5400390,"Greenbrier County School District, West Virginia",9977,7505,2479,658,518,1303,5026,2472,717,310,93,24,193,407,1755,905,194,124,587,850
ACSSF,2010e5,wv,000,0034,0006310,970,54,   ,97000US5400420,"Hampshire County School District, West Virginia",5804,4350,1441,218,310,913,2909,1454,379,191,16,0,175,188,1075,630,57,94,479,445
ACSSF,2010e5,wv,000,0034,0006311,970,54,   ,97000US5400450,"Hancock County School District, West Virginia",8882,6766,2246,524,498,1224,4520,2116,640,354,126,16,212,286,1476,730,75,180,475,746
ACSSF,2010e5,wv,000,0034,0006312,970,54,   ,97000US5400480,"Hardy County School District, West Virginia",3016,2437,495,68,115,312,1942,579,148,59,17,0,42,89,431,262,55,79,128,169
ACSSF,2010e5,wv,000,0034,0006313,970,54,   ,97000US5400510,"Harrison County School District, West Virginia",18968,14266,5062,963,930,3169,9204,4702,1006,453,68,20,365,553,3696,1911,482,213,1216,1785
ACSSF,2010e5,wv,000,0034,0006314,970,54,   ,97000US5400540,"Jackson County School District, West Virginia",8414,6722,2446,542,535,1369,4276,1692,545,393,119,36,238,152,1147,613,110,50,453,534
ACSSF,2010e5,wv,000,0034,0006315,970,54,   ,97000US5400570,"Jefferson County School District, West Virginia",13590,11147,4733,1175,1033,2525,6414,2443,850,354,147,17,190,496,1593,840,182,137,521,753
ACSSF,2010e5,wv,000,0034,0006316,970,54,   ,97000US5400600,"Kanawha County School District, West Virginia",51064,38518,12743,2751,2413,7579,25775,12546,2944,1488,359,123,1006,1456,9602,5244,1366,827,3051,4358
ACSSF,2010e5,wv,000,0034,0006317,970,54,   ,97000US5400630,"Lewis County School District, West Virginia",4243,3446,1044,118,237,689,2402,797,225,106,49,10,47,119,572,409,103,60,246,163
ACSSF,2010e5,wv,000,0034,0006318,970,54,   ,97000US5400660,"Lincoln County School District, West Virginia",6552,4941,2022,571,233,1218,2919,1611,464,201,49,38,114,263,1147,628,165,138,325,519
ACSSF,2010e5,wv,000,0034,0006319,970,54,   ,97000US5400690,"Logan County School District, West Virginia",10514,7853,2800,500,612,1688,5053,2661,618,307,127,0,180,311,2043,692,176,105,411,1351
ACSSF,2010e5,wv,000,0034,0006320,970,54,   ,97000US5400720,"Marion County School District, West Virginia",15027,11349,4111,919,657,2535,7238,3678,990,473,44,29,400,517,2688,1453,321,155,977,1235
ACSSF,2010e5,wv,000,0034,0006321,970,54,   ,97000US5400750,"Marshall County School District, West Virginia",9385,7314,2474,441,497,1536,4840,2071,614,307,134,0,173,307,1457,764,223,71,470,693
ACSSF,2010e5,wv,000,0034,0006322,970,54,   ,97000US5400780,"Mason County School District, West Virginia",7594,5757,1950,291,481,1178,3807,1837,442,255,36,9,210,187,1395,814,297,71,446,581
ACSSF,2010e5,wv,000,0034,0006323,970,54,   ,97000US5400810,"McDowell County School District, West Virginia",5490,4142,1201,171,226,804,2941,1348,334,101,2,20,79,233,1014,521,30,90,401,493
ACSSF,2010e5,wv,000,0034,0006324,970,54,   ,97000US5400840,"Mercer County School District, West Virginia",16011,12278,3779,815,667,2297,8499,3733,1014,478,163,74,241,536,2719,1449,448,127,874,1270
ACSSF,2010e5,wv,000,0034,0006325,970,54,   ,97000US5400870,"Mineral County School District, West Virginia",7710,6020,1847,396,375,1076,4173,1690,446,296,104,74,118,150,1244,861,116,83,662,383
ACSSF,2010e5,wv,000,0034,0006326,970,54,   ,97000US5400900,"Mingo County School District, West Virginia",7487,5598,1917,467,237,1213,3681,1889,574,196,61,34,101,378,1315,560,127,101,332,755
ACSSF,2010e5,wv,000,0034,0006327,970,54,   ,97000US5400930,"Monongalia School District, West Virginia",18785,15061,5783,1566,1168,3049,9278,3724,1190,518,194,72,252,672,2534,1356,375,153,828,1178
ACSSF,2010e5,wv,000,0034,0006328,970,54,   ,97000US5400960,"Monroe County School District, West Virginia",3922,3297,965,299,163,503,2332,625,198,71,0,0,71,127,427,151,61,11,79,276
ACSSF,2010e5,wv,000,0034,0006329,970,54,   ,97000US5400990,"Morgan County School District, West Virginia",4082,3219,965,126,230,609,2254,863,270,150,59,10,81,120,593,335,6,34,295,258
ACSSF,2010e5,wv,000,0034,0006330,970,54,   ,97000US5401020,"Nicholas County School District, West Virginia",7671,6363,2153,392,325,1436,4210,1308,535,300,76,0,224,235,773,237,37,51,149,536
ACSSF,2010e5,wv,000,0034,0006331,970,54,   ,97000US5401050,"Ohio County School District, West Virginia",11486,8888,3045,488,568,1989,5843,2598,450,217,96,0,121,233,2148,1146,299,252,595,1002
ACSSF,2010e5,wv,000,0034,0006332,970,54,   ,97000US5401080,"Pendleton County School District, West Virginia",2211,1841,528,70,155,303,1313,370,99,48,21,0,27,51,271,137,40,34,63,134
ACSSF,2010e5,wv,000,0034,0006333,970,54,   ,97000US5401110,"Pleasants County School District, West Virginia",1674,1394,488,71,52,365,906,280,81,45,0,7,38,36,199,109,19,7,83,90
ACSSF,2010e5,wv,000,0034,0006334,970,54,   ,97000US5401140,"Pocahontas County School District, West Virginia",2703,2274,757,131,121,505,1517,429,159,73,17,0,56,86,270,193,67,18,108,77
ACSSF,2010e5,wv,000,0034,0006335,970,54,   ,97000US5401170,"Preston County School District, West Virginia",9003,7359,2605,691,336,1578,4754,1644,434,214,89,20,105,220,1210,640,157,146,337,570
ACSSF,2010e5,wv,000,0034,0006336,970,54,   ,97000US5401200,"Putnam County School District, West Virginia",15929,13121,5418,1092,1000,3326,7703,2808,783,350,20,37,293,433,2025,1178,248,298,632,847
ACSSF,2010e5,wv,000,0034,0006337,970,54,   ,97000US5401230,"Raleigh County School District, West Virginia",21014,16081,5693,1226,1011,3456,10388,4933,1305,530,103,88,339,775,3628,1746,437,294,1015,1882
ACSSF,2010e5,wv,000,0034,0006338,970,54,   ,97000US5401260,"Randolph County School District, West Virginia",7691,6295,2034,278,390,1366,4261,1396,393,171,78,5,88,222,1003,575,84,164,327,428
ACSSF,2010e5,wv,000,0034,0006339,970,54,   ,97000US5401290,"Ritchie County School District, West Virginia",2924,2254,693,123,183,387,1561,670,230,93,48,2,43,137,440,243,39,27,177,197
ACSSF,2010e5,wv,000,0034,0006340,970,54,   ,97000US5401320,"Roane County School District, West Virginia",4008,3273,1056,256,150,650,2217,735,139,33,0,0,33,106,596,222,62,116,44,374
ACSSF,2010e5,wv,000,0034,0006341,970,54,   ,97000US5401350,"Summers County School District, West Virginia",3196,2443,716,162,122,432,1727,753,266,116,19,0,97,150,487,183,0,14,169,304
ACSSF,2010e5,wv,000,0034,0006342,970,54,   ,97000US5401380,"Taylor County School District, West Virginia",4588,3537,1323,301,261,761,2214,1051,250,49,0,15,34,201,801,475,43,88,344,326
ACSSF,2010e5,wv,000,0034,0006343,970,54,   ,97000US5401410,"Tucker County School District, West Virginia",2072,1673,550,99,71,380,1123,399,134,58,22,0,36,76,265,90,50,27,13,175
ACSSF,2010e5,wv,000,0034,0006344,970,54,   ,97000US5401440,"Tyler County School District, West Virginia",2585,2074,664,128,121,415,1410,511,178,96,55,3,38,82,333,144,12,6,126,189
ACSSF,2010e5,wv,000,0034,0006345,970,54,   ,97000US5401470,"Upshur County School District, West Virginia",6196,5107,1856,368,353,1135,3251,1089,349,130,44,31,55,219,740,349,36,177,136,391
ACSSF,2010e5,wv,000,0034,0006346,970,54,   ,97000US5401500,"Wayne County School District, West Virginia",11756,9259,3340,778,661,1901,5919,2497,637,302,66,47,189,335,1860,921,199,91,631,939
ACSSF,2010e5,wv,000,0034,0006347,970,54,   ,97000US5401530,"Webster County School District, West Virginia",2927,2365,884,149,178,557,1481,562,216,123,57,0,66,93,346,182,119,10,53,164
ACSSF,2010e5,wv,000,0034,0006348,970,54,   ,97000US5401560,"Wetzel County School District, West Virginia",4725,3845,1275,247,225,803,2570,880,198,104,31,13,60,94,682,349,80,74,195,333
ACSSF,2010e5,wv,000,0034,0006349,970,54,   ,97000US5401590,"Wirt County School District, West Virginia",1697,1447,441,112,102,227,1006,250,64,31,14,0,17,33,186,129,17,12,100,57
ACSSF,2010e5,wv,000,0034,0006350,970,54,   ,97000US5401620,"Wood County School District, West Virginia",23934,18641,6666,1238,1217,4211,11975,5293,1400,788,253,107,428,612,3893,2168,650,278,1240,1725
ACSSF,2010e5,wv,000,0034,0006351,970,54,   ,97000US5401650,"Wyoming County School District, West Virginia",6565,5288,1843,346,288,1209,3445,1277,319,133,0,0,133,186,958,499,157,40,302,459
